PokerStars Hand #201500754327:  Hold'em No Limit ($0.05/$0.10 USD) - 2019/06/18 3:27:28 ET
Table 'Achird' 6-max Seat #3 is the button
Seat 1: kelvinmio ($15.15 in chips) 
Seat 2: hubertchen55 ($5.64 in chips) 
Seat 3: togl63amg ($12.27 in chips) 
Seat 5: dpv82 ($18.70 in chips) 
Seat 6: Johan25888 ($10 in chips) 
dpv82: posts small blind $0.05
Johan25888: posts big blind $0.10
*** HOLE CARDS ***
kelvinmio: folds 
hubertchen55: calls $0.10
togl63amg: raises $0.40 to $0.50
dpv82: folds 
Johan25888: folds 
hubertchen55: calls $0.40
*** FLOP *** [6h As 7h]
hubertchen55: checks 
togl63amg: bets $0.70
hubertchen55: raises $0.70 to $1.40
togl63amg: folds 
Uncalled bet ($0.70) returned to hubertchen55
hubertchen55 collected $2.44 from pot
hubertchen55: doesn't show hand 
*** SUMMARY ***
Total pot $2.55 | Rake $0.11 
Board [6h As 7h]
Seat 1: kelvinmio folded before Flop (didn't bet)
Seat 2: hubertchen55 collected ($2.44)
Seat 3: togl63amg (button) folded on the Flop
Seat 5: dpv82 (small blind) folded before Flop
Seat 6: Johan25888 (big blind) folded before Flop



PokerStars Hand #201500763533:  Hold'em No Limit ($0.05/$0.10 USD) - 2019/06/18 3:28:18 ET
Table 'Achird' 6-max Seat #5 is the button
Seat 1: kelvinmio ($15.15 in chips) 
Seat 2: hubertchen55 ($6.88 in chips) 
Seat 3: togl63amg ($11.07 in chips) 
Seat 5: dpv82 ($18.65 in chips) 
Seat 6: Johan25888 ($10 in chips) 
Johan25888: posts small blind $0.05
kelvinmio: posts big blind $0.10
NiceMeng: sits out 
*** HOLE CARDS ***
hubertchen55: folds 
togl63amg: folds 
dpv82: raises $0.10 to $0.20
Johan25888: folds 
kelvinmio: folds 
Uncalled bet ($0.10) returned to dpv82
dpv82 collected $0.25 from pot
dpv82: doesn't show hand 
*** SUMMARY ***
Total pot $0.25 | Rake $0 
Seat 1: kelvinmio (big blind) folded before Flop
Seat 2: hubertchen55 folded before Flop (didn't bet)
Seat 3: togl63amg folded before Flop (didn't bet)
Seat 5: dpv82 (button) collected ($0.25)
Seat 6: Johan25888 (small blind) folded before Flop



PokerStars Hand #201500766100:  Hold'em No Limit ($0.05/$0.10 USD) - 2019/06/18 3:28:33 ET
Table 'Achird' 6-max Seat #6 is the button
Seat 1: kelvinmio ($15.05 in chips) 
Seat 2: hubertchen55 ($6.88 in chips) 
Seat 3: togl63amg ($11.07 in chips) 
Seat 5: dpv82 ($18.80 in chips) 
Seat 6: Johan25888 ($10 in chips) 
kelvinmio: posts small blind $0.05
hubertchen55: posts big blind $0.10
NiceMeng: sits out 
*** HOLE CARDS ***
togl63amg: folds 
dpv82: folds 
Johan25888: raises $0.15 to $0.25
kelvinmio: folds 
hubertchen55: calls $0.15
*** FLOP *** [Jh 8h 4s]
hubertchen55: checks 
Johan25888: bets $0.37
hubertchen55: folds 
Uncalled bet ($0.37) returned to Johan25888
Johan25888 collected $0.53 from pot
Johan25888: doesn't show hand 
*** SUMMARY ***
Total pot $0.55 | Rake $0.02 
Board [Jh 8h 4s]
Seat 1: kelvinmio (small blind) folded before Flop
Seat 2: hubertchen55 (big blind) folded on the Flop
Seat 3: togl63amg folded before Flop (didn't bet)
Seat 5: dpv82 folded before Flop (didn't bet)
Seat 6: Johan25888 (button) collected ($0.53)



PokerStars Hand #201500769912:  Hold'em No Limit ($0.05/$0.10 USD) - 2019/06/18 3:28:53 ET
Table 'Achird' 6-max Seat #1 is the button
Seat 1: kelvinmio ($15 in chips) 
Seat 2: hubertchen55 ($6.63 in chips) 
Seat 3: togl63amg ($11.07 in chips) 
Seat 5: dpv82 ($18.80 in chips) 
Seat 6: Johan25888 ($10.28 in chips) 
hubertchen55: posts small blind $0.05
togl63amg: posts big blind $0.10
NiceMeng: sits out 
*** HOLE CARDS ***
dpv82: folds 
Johan25888: folds 
kelvinmio: folds 
hubertchen55: calls $0.05
togl63amg: checks 
*** FLOP *** [7d Th 5s]
hubertchen55: bets $0.10
togl63amg: folds 
Uncalled bet ($0.10) returned to hubertchen55
hubertchen55 collected $0.19 from pot
hubertchen55: doesn't show hand 
*** SUMMARY ***
Total pot $0.20 | Rake $0.01 
Board [7d Th 5s]
Seat 1: kelvinmio (button) folded before Flop (didn't bet)
Seat 2: hubertchen55 (small blind) collected ($0.19)
Seat 3: togl63amg (big blind) folded on the Flop
Seat 5: dpv82 folded before Flop (didn't bet)
Seat 6: Johan25888 folded before Flop (didn't bet)



PokerStars Hand #201500774327:  Hold'em No Limit ($0.05/$0.10 USD) - 2019/06/18 3:29:17 ET
Table 'Achird' 6-max Seat #2 is the button
Seat 1: kelvinmio ($15 in chips) 
Seat 2: hubertchen55 ($6.72 in chips) 
Seat 3: togl63amg ($10.97 in chips) 
Seat 4: NiceMeng ($10 in chips) 
Seat 5: dpv82 ($18.80 in chips) 
Seat 6: Johan25888 ($10.28 in chips) 
togl63amg: posts small blind $0.05
NiceMeng: posts big blind $0.10
*** HOLE CARDS ***
dpv82: folds 
Johan25888 has timed out
Johan25888: folds 
kelvinmio: raises $0.20 to $0.30
hubertchen55: folds 
togl63amg: raises $0.70 to $1
NiceMeng: folds 
kelvinmio: calls $0.70
*** FLOP *** [6h Ah 8c]
togl63amg: bets $1.13
kelvinmio: folds 
Uncalled bet ($1.13) returned to togl63amg
togl63amg collected $2.01 from pot
*** SUMMARY ***
Total pot $2.10 | Rake $0.09 
Board [6h Ah 8c]
Seat 1: kelvinmio folded on the Flop
Seat 2: hubertchen55 (button) folded before Flop (didn't bet)
Seat 3: togl63amg (small blind) collected ($2.01)
Seat 4: NiceMeng (big blind) folded before Flop
Seat 5: dpv82 folded before Flop (didn't bet)
Seat 6: Johan25888 folded before Flop (didn't bet)



PokerStars Hand #201500786212:  Hold'em No Limit ($0.05/$0.10 USD) - 2019/06/18 3:30:21 ET
Table 'Achird' 6-max Seat #3 is the button
Seat 1: kelvinmio ($14 in chips) 
Seat 2: hubertchen55 ($6.72 in chips) 
Seat 3: togl63amg ($11.98 in chips) 
Seat 4: NiceMeng ($9.90 in chips) 
NiceMeng: posts small blind $0.05
dpv82: is sitting out 
kelvinmio: posts big blind $0.10
*** HOLE CARDS ***
hubertchen55: calls $0.10
togl63amg: raises $0.35 to $0.45
NiceMeng: folds 
kelvinmio: folds 
dpv82 leaves the table
hubertchen55: calls $0.35
*** FLOP *** [2s 2d 6c]
hubertchen55: checks 
togl63amg: bets $0.40
hubertchen55: calls $0.40
*** TURN *** [2s 2d 6c] [8c]
hubertchen55: checks 
togl63amg: checks 
*** RIVER *** [2s 2d 6c 8c] [Js]
hubertchen55: bets $0.10
togl63amg: calls $0.10
*** SHOW DOWN ***
hubertchen55: shows [Kd Jd] (two pair, Jacks and Deuces)
togl63amg: mucks hand 
hubertchen55 collected $1.96 from pot
*** SUMMARY ***
Total pot $2.05 | Rake $0.09 
Board [2s 2d 6c 8c Js]
Seat 1: kelvinmio (big blind) folded before Flop
Seat 2: hubertchen55 showed [Kd Jd] and won ($1.96) with two pair, Jacks and Deuces
Seat 3: togl63amg (button) mucked
Seat 4: NiceMeng (small blind) folded before Flop



PokerStars Hand #201500793833:  Hold'em No Limit ($0.05/$0.10 USD) - 2019/06/18 3:31:02 ET
Table 'Achird' 6-max Seat #4 is the button
Seat 1: kelvinmio ($13.90 in chips) 
Seat 2: hubertchen55 ($7.73 in chips) 
Seat 3: togl63amg ($11.03 in chips) 
Seat 4: NiceMeng ($9.85 in chips) 
kelvinmio: posts small blind $0.05
hubertchen55: posts big blind $0.10
*** HOLE CARDS ***
togl63amg: folds 
NiceMeng: folds 
kelvinmio: folds 
Uncalled bet ($0.05) returned to hubertchen55
hubertchen55 collected $0.10 from pot
hubertchen55: doesn't show hand 
*** SUMMARY ***
Total pot $0.10 | Rake $0 
Seat 1: kelvinmio (small blind) folded before Flop
Seat 2: hubertchen55 (big blind) collected ($0.10)
Seat 3: togl63amg folded before Flop (didn't bet)
Seat 4: NiceMeng (button) folded before Flop (didn't bet)



PokerStars Hand #201500796217:  Hold'em No Limit ($0.05/$0.10 USD) - 2019/06/18 3:31:15 ET
Table 'Achird' 6-max Seat #1 is the button
Seat 1: kelvinmio ($13.85 in chips) 
Seat 2: hubertchen55 ($7.78 in chips) 
Seat 3: togl63amg ($11.03 in chips) 
Seat 4: NiceMeng ($9.85 in chips) 
hubertchen55: posts small blind $0.05
togl63amg: posts big blind $0.10
Johan25888: sits out 
*** HOLE CARDS ***
NiceMeng: folds 
kelvinmio: folds 
hubertchen55: calls $0.05
togl63amg: checks 
*** FLOP *** [6h 9s Kd]
hubertchen55: bets $0.19
togl63amg: folds 
Uncalled bet ($0.19) returned to hubertchen55
hubertchen55 collected $0.19 from pot
hubertchen55: doesn't show hand 
*** SUMMARY ***
Total pot $0.20 | Rake $0.01 
Board [6h 9s Kd]
Seat 1: kelvinmio (button) folded before Flop (didn't bet)
Seat 2: hubertchen55 (small blind) collected ($0.19)
Seat 3: togl63amg (big blind) folded on the Flop
Seat 4: NiceMeng folded before Flop (didn't bet)



PokerStars Hand #201500803055:  Hold'em No Limit ($0.05/$0.10 USD) - 2019/06/18 3:31:53 ET
Table 'Achird' 6-max Seat #2 is the button
Seat 1: kelvinmio ($13.85 in chips) 
Seat 2: hubertchen55 ($7.87 in chips) 
Seat 3: togl63amg ($10.93 in chips) 
Seat 4: NiceMeng ($9.85 in chips) 
togl63amg: posts small blind $0.05
NiceMeng: posts big blind $0.10
Johan25888: sits out 
*** HOLE CARDS ***
M0nzdrik joins the table at seat #5 
kelvinmio: folds 
hubertchen55: folds 
togl63amg: folds 
Uncalled bet ($0.05) returned to NiceMeng
NiceMeng collected $0.10 from pot
NiceMeng: doesn't show hand 
*** SUMMARY ***
Total pot $0.10 | Rake $0 
Seat 1: kelvinmio folded before Flop (didn't bet)
Seat 2: hubertchen55 (button) folded before Flop (didn't bet)
Seat 3: togl63amg (small blind) folded before Flop
Seat 4: NiceMeng (big blind) collected ($0.10)



PokerStars Hand #201500804794:  Hold'em No Limit ($0.05/$0.10 USD) - 2019/06/18 3:32:02 ET
Table 'Achird' 6-max Seat #3 is the button
Seat 1: kelvinmio ($13.85 in chips) 
Seat 2: hubertchen55 ($7.87 in chips) 
Seat 3: togl63amg ($10.88 in chips) 
Seat 4: NiceMeng ($9.90 in chips) 
Seat 5: M0nzdrik ($10 in chips) 
NiceMeng: posts small blind $0.05
M0nzdrik: posts big blind $0.10
Johan25888: sits out 
*** HOLE CARDS ***
kelvinmio: folds 
hubertchen55: folds 
togl63amg: raises $0.15 to $0.25
NiceMeng: calls $0.20
M0nzdrik: folds 
*** FLOP *** [8h 5c 3c]
NiceMeng: checks 
togl63amg: bets $0.23
NiceMeng: folds 
Uncalled bet ($0.23) returned to togl63amg
togl63amg collected $0.57 from pot
*** SUMMARY ***
Total pot $0.60 | Rake $0.03 
Board [8h 5c 3c]
Seat 1: kelvinmio folded before Flop (didn't bet)
Seat 2: hubertchen55 folded before Flop (didn't bet)
Seat 3: togl63amg (button) collected ($0.57)
Seat 4: NiceMeng (small blind) folded on the Flop
Seat 5: M0nzdrik (big blind) folded before Flop



PokerStars Hand #201500810041:  Hold'em No Limit ($0.05/$0.10 USD) - 2019/06/18 3:32:31 ET
Table 'Achird' 6-max Seat #4 is the button
Seat 1: kelvinmio ($13.85 in chips) 
Seat 2: hubertchen55 ($7.87 in chips) 
Seat 3: togl63amg ($11.20 in chips) 
Seat 4: NiceMeng ($9.65 in chips) 
Seat 5: M0nzdrik ($10 in chips) 
Seat 6: Johan25888 ($10.28 in chips) 
M0nzdrik: posts small blind $0.05
Johan25888: posts big blind $0.10
*** HOLE CARDS ***
kelvinmio: folds 
hubertchen55: calls $0.10
togl63amg: raises $0.35 to $0.45
NiceMeng: folds 
M0nzdrik: folds 
Johan25888: calls $0.35
hubertchen55: calls $0.35
*** FLOP *** [Ks Ah 8d]
Johan25888: checks 
hubertchen55: bets $0.67
togl63amg: folds 
Johan25888: folds 
Uncalled bet ($0.67) returned to hubertchen55
hubertchen55 collected $1.34 from pot
hubertchen55: doesn't show hand 
*** SUMMARY ***
Total pot $1.40 | Rake $0.06 
Board [Ks Ah 8d]
Seat 1: kelvinmio folded before Flop (didn't bet)
Seat 2: hubertchen55 collected ($1.34)
Seat 3: togl63amg folded on the Flop
Seat 4: NiceMeng (button) folded before Flop (didn't bet)
Seat 5: M0nzdrik (small blind) folded before Flop
Seat 6: Johan25888 (big blind) folded on the Flop



PokerStars Hand #201500818902:  Hold'em No Limit ($0.05/$0.10 USD) - 2019/06/18 3:33:20 ET
Table 'Achird' 6-max Seat #5 is the button
Seat 1: kelvinmio ($13.85 in chips) 
Seat 2: hubertchen55 ($8.76 in chips) 
Seat 3: togl63amg ($10.75 in chips) 
Seat 4: NiceMeng ($9.65 in chips) 
Seat 5: M0nzdrik ($10 in chips) 
Seat 6: Johan25888 ($10 in chips) 
Johan25888: posts small blind $0.05
kelvinmio: posts big blind $0.10
*** HOLE CARDS ***
hubertchen55: folds 
togl63amg: folds 
NiceMeng: folds 
M0nzdrik: folds 
Johan25888: raises $0.20 to $0.30
kelvinmio: folds 
Uncalled bet ($0.20) returned to Johan25888
Johan25888 collected $0.20 from pot
Johan25888: doesn't show hand 
*** SUMMARY ***
Total pot $0.20 | Rake $0 
Seat 1: kelvinmio (big blind) folded before Flop
Seat 2: hubertchen55 folded before Flop (didn't bet)
Seat 3: togl63amg folded before Flop (didn't bet)
Seat 4: NiceMeng folded before Flop (didn't bet)
Seat 5: M0nzdrik (button) folded before Flop (didn't bet)
Seat 6: Johan25888 (small blind) collected ($0.20)



PokerStars Hand #201500822472:  Hold'em No Limit ($0.05/$0.10 USD) - 2019/06/18 3:33:39 ET
Table 'Achird' 6-max Seat #6 is the button
Seat 1: kelvinmio ($13.75 in chips) 
Seat 2: hubertchen55 ($8.76 in chips) 
Seat 3: togl63amg ($10.75 in chips) 
Seat 4: NiceMeng ($9.65 in chips) 
Seat 5: M0nzdrik ($10 in chips) 
Seat 6: Johan25888 ($10.10 in chips) 
kelvinmio: posts small blind $0.05
hubertchen55: posts big blind $0.10
*** HOLE CARDS ***
togl63amg: folds 
NiceMeng: raises $0.20 to $0.30
M0nzdrik: folds 
Johan25888: folds 
kelvinmio: folds 
hubertchen55: folds 
Uncalled bet ($0.20) returned to NiceMeng
NiceMeng collected $0.25 from pot
NiceMeng: doesn't show hand 
*** SUMMARY ***
Total pot $0.25 | Rake $0 
Seat 1: kelvinmio (small blind) folded before Flop
Seat 2: hubertchen55 (big blind) folded before Flop
Seat 3: togl63amg folded before Flop (didn't bet)
Seat 4: NiceMeng collected ($0.25)
Seat 5: M0nzdrik folded before Flop (didn't bet)
Seat 6: Johan25888 (button) folded before Flop (didn't bet)



PokerStars Hand #201500826521:  Hold'em No Limit ($0.05/$0.10 USD) - 2019/06/18 3:34:01 ET
Table 'Achird' 6-max Seat #1 is the button
Seat 1: kelvinmio ($13.70 in chips) 
Seat 2: hubertchen55 ($8.66 in chips) 
Seat 3: togl63amg ($10.75 in chips) 
Seat 4: NiceMeng ($9.80 in chips) 
Seat 5: M0nzdrik ($10 in chips) 
Seat 6: Johan25888 ($10.10 in chips) 
hubertchen55: posts small blind $0.05
togl63amg: posts big blind $0.10
*** HOLE CARDS ***
NiceMeng: folds 
M0nzdrik: folds 
Johan25888: raises $0.15 to $0.25
kelvinmio: folds 
hubertchen55: calls $0.20
togl63amg: calls $0.15
*** FLOP *** [8h 7s Qs]
hubertchen55: checks 
togl63amg: checks 
Johan25888: bets $0.37
hubertchen55: folds 
togl63amg: folds 
Uncalled bet ($0.37) returned to Johan25888
Johan25888 collected $0.72 from pot
Johan25888: doesn't show hand 
*** SUMMARY ***
Total pot $0.75 | Rake $0.03 
Board [8h 7s Qs]
Seat 1: kelvinmio (button) folded before Flop (didn't bet)
Seat 2: hubertchen55 (small blind) folded on the Flop
Seat 3: togl63amg (big blind) folded on the Flop
Seat 4: NiceMeng folded before Flop (didn't bet)
Seat 5: M0nzdrik folded before Flop (didn't bet)
Seat 6: Johan25888 collected ($0.72)



PokerStars Hand #201500833365:  Hold'em No Limit ($0.05/$0.10 USD) - 2019/06/18 3:34:39 ET
Table 'Achird' 6-max Seat #2 is the button
Seat 1: kelvinmio ($13.70 in chips) 
Seat 2: hubertchen55 ($8.41 in chips) 
Seat 3: togl63amg ($10.50 in chips) 
Seat 4: NiceMeng ($9.80 in chips) 
Seat 5: M0nzdrik ($10 in chips) 
Seat 6: Johan25888 ($10.57 in chips) 
togl63amg: posts small blind $0.05
NiceMeng: posts big blind $0.10
*** HOLE CARDS ***
M0nzdrik: folds 
Johan25888: folds 
kelvinmio: folds 
hubertchen55: calls $0.10
togl63amg: folds 
NiceMeng: checks 
*** FLOP *** [6h Js Ah]
NiceMeng: checks 
hubertchen55: checks 
*** TURN *** [6h Js Ah] [3h]
NiceMeng: checks 
hubertchen55: bets $0.24
NiceMeng: folds 
Uncalled bet ($0.24) returned to hubertchen55
hubertchen55 collected $0.24 from pot
hubertchen55: doesn't show hand 
*** SUMMARY ***
Total pot $0.25 | Rake $0.01 
Board [6h Js Ah 3h]
Seat 1: kelvinmio folded before Flop (didn't bet)
Seat 2: hubertchen55 (button) collected ($0.24)
Seat 3: togl63amg (small blind) folded before Flop
Seat 4: NiceMeng (big blind) folded on the Turn
Seat 5: M0nzdrik folded before Flop (didn't bet)
Seat 6: Johan25888 folded before Flop (didn't bet)



PokerStars Hand #201500841910:  Hold'em No Limit ($0.05/$0.10 USD) - 2019/06/18 3:35:25 ET
Table 'Achird' 6-max Seat #3 is the button
Seat 1: kelvinmio ($13.70 in chips) 
Seat 2: hubertchen55 ($8.55 in chips) 
Seat 3: togl63amg ($10.45 in chips) 
Seat 4: NiceMeng ($9.70 in chips) 
Seat 5: M0nzdrik ($10 in chips) 
Seat 6: Johan25888 ($10.57 in chips) 
NiceMeng: posts small blind $0.05
M0nzdrik: posts big blind $0.10
*** HOLE CARDS ***
Johan25888: folds 
kelvinmio: raises $0.20 to $0.30
hubertchen55: folds 
togl63amg: folds 
NiceMeng: folds 
M0nzdrik: folds 
Uncalled bet ($0.20) returned to kelvinmio
kelvinmio collected $0.25 from pot
kelvinmio: doesn't show hand 
*** SUMMARY ***
Total pot $0.25 | Rake $0 
Seat 1: kelvinmio collected ($0.25)
Seat 2: hubertchen55 folded before Flop (didn't bet)
Seat 3: togl63amg (button) folded before Flop (didn't bet)
Seat 4: NiceMeng (small blind) folded before Flop
Seat 5: M0nzdrik (big blind) folded before Flop
Seat 6: Johan25888 folded before Flop (didn't bet)



PokerStars Hand #201500844528:  Hold'em No Limit ($0.05/$0.10 USD) - 2019/06/18 3:35:39 ET
Table 'Achird' 6-max Seat #4 is the button
Seat 1: kelvinmio ($13.85 in chips) 
Seat 2: hubertchen55 ($8.55 in chips) 
Seat 3: togl63amg ($10.45 in chips) 
Seat 4: NiceMeng ($9.65 in chips) 
Seat 5: M0nzdrik ($10 in chips) 
Seat 6: Johan25888 ($10.57 in chips) 
M0nzdrik: posts small blind $0.05
Johan25888: posts big blind $0.10
*** HOLE CARDS ***
kelvinmio: raises $0.20 to $0.30
hubertchen55: folds 
togl63amg: folds 
NiceMeng: folds 
M0nzdrik: folds 
Johan25888: folds 
Uncalled bet ($0.20) returned to kelvinmio
kelvinmio collected $0.25 from pot
kelvinmio: doesn't show hand 
*** SUMMARY ***
Total pot $0.25 | Rake $0 
Seat 1: kelvinmio collected ($0.25)
Seat 2: hubertchen55 folded before Flop (didn't bet)
Seat 3: togl63amg folded before Flop (didn't bet)
Seat 4: NiceMeng (button) folded before Flop (didn't bet)
Seat 5: M0nzdrik (small blind) folded before Flop
Seat 6: Johan25888 (big blind) folded before Flop



PokerStars Hand #201500848381:  Hold'em No Limit ($0.05/$0.10 USD) - 2019/06/18 3:36:00 ET
Table 'Achird' 6-max Seat #5 is the button
Seat 1: kelvinmio ($14 in chips) 
Seat 2: hubertchen55 ($8.55 in chips) 
Seat 3: togl63amg ($10.45 in chips) 
Seat 4: NiceMeng ($9.65 in chips) 
Seat 5: M0nzdrik ($10 in chips) 
Seat 6: Johan25888 ($10.47 in chips) 
Johan25888: posts small blind $0.05
kelvinmio: posts big blind $0.10
*** HOLE CARDS ***
hubertchen55: calls $0.10
togl63amg: folds 
NiceMeng: folds 
M0nzdrik: folds 
Johan25888: folds 
kelvinmio: checks 
*** FLOP *** [3h Kc Qs]
kelvinmio: checks 
hubertchen55: checks 
*** TURN *** [3h Kc Qs] [9s]
kelvinmio: checks 
hubertchen55: bets $0.24
kelvinmio: calls $0.24
*** RIVER *** [3h Kc Qs 9s] [8s]
kelvinmio: checks 
hubertchen55: checks 
*** SHOW DOWN ***
kelvinmio: shows [Qc 7d] (a pair of Queens)
hubertchen55: mucks hand 
kelvinmio collected $0.70 from pot
*** SUMMARY ***
Total pot $0.73 | Rake $0.03 
Board [3h Kc Qs 9s 8s]
Seat 1: kelvinmio (big blind) showed [Qc 7d] and won ($0.70) with a pair of Queens
Seat 2: hubertchen55 mucked
Seat 3: togl63amg folded before Flop (didn't bet)
Seat 4: NiceMeng folded before Flop (didn't bet)
Seat 5: M0nzdrik (button) folded before Flop (didn't bet)
Seat 6: Johan25888 (small blind) folded before Flop



PokerStars Hand #201500854626:  Hold'em No Limit ($0.05/$0.10 USD) - 2019/06/18 3:36:34 ET
Table 'Achird' 6-max Seat #6 is the button
Seat 1: kelvinmio ($14.36 in chips) 
Seat 2: hubertchen55 ($8.21 in chips) 
Seat 3: togl63amg ($10.45 in chips) 
Seat 4: NiceMeng ($9.65 in chips) 
Seat 5: M0nzdrik ($10 in chips) 
Seat 6: Johan25888 ($10.42 in chips) 
kelvinmio: posts small blind $0.05
hubertchen55: posts big blind $0.10
*** HOLE CARDS ***
togl63amg: raises $0.20 to $0.30
NiceMeng: folds 
M0nzdrik: folds 
Johan25888: folds 
kelvinmio: calls $0.25
hubertchen55: calls $0.20
*** FLOP *** [Qd Qh Ah]
kelvinmio: checks 
hubertchen55: checks 
togl63amg: checks 
*** TURN *** [Qd Qh Ah] [Ad]
kelvinmio: checks 
hubertchen55: checks 
togl63amg: bets $0.48
kelvinmio: folds 
hubertchen55: calls $0.48
*** RIVER *** [Qd Qh Ah Ad] [9c]
hubertchen55: bets $0.89
togl63amg: raises $0.89 to $1.78
hubertchen55: calls $0.89
*** SHOW DOWN ***
togl63amg: shows [Tc As] (a full house, Aces full of Queens)
hubertchen55: shows [4h Ac] (a full house, Aces full of Queens)
hubertchen55 collected $2.59 from pot
togl63amg collected $2.59 from pot
*** SUMMARY ***
Total pot $5.42 | Rake $0.24 
Board [Qd Qh Ah Ad 9c]
Seat 1: kelvinmio (small blind) folded on the Turn
Seat 2: hubertchen55 (big blind) showed [4h Ac] and won ($2.59) with a full house, Aces full of Queens
Seat 3: togl63amg showed [Tc As] and won ($2.59) with a full house, Aces full of Queens
Seat 4: NiceMeng folded before Flop (didn't bet)
Seat 5: M0nzdrik folded before Flop (didn't bet)
Seat 6: Johan25888 (button) folded before Flop (didn't bet)



PokerStars Hand #201500866377:  Hold'em No Limit ($0.05/$0.10 USD) - 2019/06/18 3:37:38 ET
Table 'Achird' 6-max Seat #1 is the button
Seat 1: kelvinmio ($14.06 in chips) 
Seat 2: hubertchen55 ($8.24 in chips) 
Seat 3: togl63amg ($10.48 in chips) 
Seat 4: NiceMeng ($9.65 in chips) 
Seat 5: M0nzdrik ($10 in chips) 
Seat 6: Johan25888 ($10.42 in chips) 
hubertchen55: posts small blind $0.05
togl63amg: posts big blind $0.10
*** HOLE CARDS ***
NiceMeng: folds 
M0nzdrik: folds 
Johan25888: folds 
kelvinmio: raises $0.20 to $0.30
hubertchen55: folds 
togl63amg: calls $0.20
*** FLOP *** [5c Ah Kh]
togl63amg: checks 
kelvinmio: bets $0.40
togl63amg: calls $0.40
*** TURN *** [5c Ah Kh] [8h]
togl63amg: checks 
kelvinmio: bets $0.90
togl63amg: folds 
Uncalled bet ($0.90) returned to kelvinmio
kelvinmio collected $1.38 from pot
*** SUMMARY ***
Total pot $1.45 | Rake $0.07 
Board [5c Ah Kh 8h]
Seat 1: kelvinmio (button) collected ($1.38)
Seat 2: hubertchen55 (small blind) folded before Flop
Seat 3: togl63amg (big blind) folded on the Turn
Seat 4: NiceMeng folded before Flop (didn't bet)
Seat 5: M0nzdrik folded before Flop (didn't bet)
Seat 6: Johan25888 folded before Flop (didn't bet)



PokerStars Hand #201500877252:  Hold'em No Limit ($0.05/$0.10 USD) - 2019/06/18 3:38:36 ET
Table 'Achird' 6-max Seat #2 is the button
Seat 1: kelvinmio ($14.74 in chips) 
Seat 2: hubertchen55 ($8.19 in chips) 
Seat 3: togl63amg ($10 in chips) 
Seat 4: NiceMeng ($9.65 in chips) 
Seat 5: M0nzdrik ($10 in chips) 
Seat 6: Johan25888 ($10.42 in chips) 
togl63amg: posts small blind $0.05
NiceMeng: posts big blind $0.10
*** HOLE CARDS ***
M0nzdrik: folds 
Johan25888: folds 
kelvinmio: raises $0.20 to $0.30
hubertchen55: calls $0.30
togl63amg: folds 
NiceMeng: folds 
*** FLOP *** [Kh 7d As]
kelvinmio: checks 
hubertchen55: checks 
*** TURN *** [Kh 7d As] [Jd]
kelvinmio: bets $0.50
hubertchen55: folds 
Uncalled bet ($0.50) returned to kelvinmio
kelvinmio collected $0.72 from pot
*** SUMMARY ***
Total pot $0.75 | Rake $0.03 
Board [Kh 7d As Jd]
Seat 1: kelvinmio collected ($0.72)
Seat 2: hubertchen55 (button) folded on the Turn
Seat 3: togl63amg (small blind) folded before Flop
Seat 4: NiceMeng (big blind) folded before Flop
Seat 5: M0nzdrik folded before Flop (didn't bet)
Seat 6: Johan25888 folded before Flop (didn't bet)



PokerStars Hand #201500886995:  Hold'em No Limit ($0.05/$0.10 USD) - 2019/06/18 3:39:28 ET
Table 'Achird' 6-max Seat #3 is the button
Seat 1: kelvinmio ($15.16 in chips) 
Seat 2: hubertchen55 ($7.89 in chips) 
Seat 3: togl63amg ($10 in chips) 
Seat 4: NiceMeng ($9.55 in chips) 
Seat 5: M0nzdrik ($10 in chips) 
Seat 6: Johan25888 ($10.42 in chips) 
NiceMeng: posts small blind $0.05
M0nzdrik: posts big blind $0.10
*** HOLE CARDS ***
Johan25888: folds 
kelvinmio: raises $0.20 to $0.30
hubertchen55: folds 
togl63amg: folds 
NiceMeng: folds 
M0nzdrik: folds 
Uncalled bet ($0.20) returned to kelvinmio
kelvinmio collected $0.25 from pot
kelvinmio: doesn't show hand 
*** SUMMARY ***
Total pot $0.25 | Rake $0 
Seat 1: kelvinmio collected ($0.25)
Seat 2: hubertchen55 folded before Flop (didn't bet)
Seat 3: togl63amg (button) folded before Flop (didn't bet)
Seat 4: NiceMeng (small blind) folded before Flop
Seat 5: M0nzdrik (big blind) folded before Flop
Seat 6: Johan25888 folded before Flop (didn't bet)



PokerStars Hand #201500889565:  Hold'em No Limit ($0.05/$0.10 USD) - 2019/06/18 3:39:42 ET
Table 'Achird' 6-max Seat #4 is the button
Seat 1: kelvinmio ($15.31 in chips) 
Seat 2: hubertchen55 ($7.89 in chips) 
Seat 3: togl63amg ($10 in chips) 
Seat 4: NiceMeng ($9.50 in chips) 
Seat 5: M0nzdrik ($10 in chips) 
Seat 6: Johan25888 ($10.42 in chips) 
M0nzdrik: posts small blind $0.05
Johan25888: posts big blind $0.10
*** HOLE CARDS ***
kelvinmio: raises $0.20 to $0.30
hubertchen55: calls $0.30
togl63amg: calls $0.30
NiceMeng: folds 
M0nzdrik: calls $0.25
Johan25888: folds 
*** FLOP *** [2h Ad 7d]
M0nzdrik: checks 
kelvinmio: bets $0.70
hubertchen55: folds 
togl63amg: folds 
M0nzdrik: folds 
Uncalled bet ($0.70) returned to kelvinmio
kelvinmio collected $1.24 from pot
kelvinmio: doesn't show hand 
*** SUMMARY ***
Total pot $1.30 | Rake $0.06 
Board [2h Ad 7d]
Seat 1: kelvinmio collected ($1.24)
Seat 2: hubertchen55 folded on the Flop
Seat 3: togl63amg folded on the Flop
Seat 4: NiceMeng (button) folded before Flop (didn't bet)
Seat 5: M0nzdrik (small blind) folded on the Flop
Seat 6: Johan25888 (big blind) folded before Flop



PokerStars Hand #201500903191:  Hold'em No Limit ($0.05/$0.10 USD) - 2019/06/18 3:40:53 ET
Table 'Achird' 6-max Seat #5 is the button
Seat 1: kelvinmio ($16.25 in chips) 
Seat 2: hubertchen55 ($7.59 in chips) 
Seat 3: togl63amg ($10 in chips) 
Seat 4: NiceMeng ($9.50 in chips) 
Seat 5: M0nzdrik ($10 in chips) 
Seat 6: Johan25888 ($10.32 in chips) 
Johan25888: posts small blind $0.05
kelvinmio: posts big blind $0.10
*** HOLE CARDS ***
hubertchen55: folds 
togl63amg: folds 
NiceMeng: folds 
M0nzdrik: folds 
Johan25888: raises $0.20 to $0.30
kelvinmio: folds 
Uncalled bet ($0.20) returned to Johan25888
Johan25888 collected $0.20 from pot
Johan25888: doesn't show hand 
*** SUMMARY ***
Total pot $0.20 | Rake $0 
Seat 1: kelvinmio (big blind) folded before Flop
Seat 2: hubertchen55 folded before Flop (didn't bet)
Seat 3: togl63amg folded before Flop (didn't bet)
Seat 4: NiceMeng folded before Flop (didn't bet)
Seat 5: M0nzdrik (button) folded before Flop (didn't bet)
Seat 6: Johan25888 (small blind) collected ($0.20)



PokerStars Hand #201500909187:  Hold'em No Limit ($0.05/$0.10 USD) - 2019/06/18 3:41:25 ET
Table 'Achird' 6-max Seat #6 is the button
Seat 1: kelvinmio ($16.15 in chips) 
Seat 2: hubertchen55 ($7.59 in chips) 
Seat 3: togl63amg ($10 in chips) 
Seat 4: NiceMeng ($9.50 in chips) 
Seat 5: M0nzdrik ($10 in chips) 
Seat 6: Johan25888 ($10.42 in chips) 
kelvinmio: posts small blind $0.05
hubertchen55: posts big blind $0.10
*** HOLE CARDS ***
togl63amg: folds 
NiceMeng: folds 
M0nzdrik: folds 
Johan25888: folds 
kelvinmio: raises $0.20 to $0.30
hubertchen55: calls $0.20
*** FLOP *** [2s Ac Qd]
kelvinmio: checks 
hubertchen55: bets $0.29
kelvinmio: calls $0.29
*** TURN *** [2s Ac Qd] [Ts]
kelvinmio: checks 
hubertchen55: bets $0.30
kelvinmio: calls $0.30
*** RIVER *** [2s Ac Qd Ts] [Js]
kelvinmio: checks 
hubertchen55: checks 
*** SHOW DOWN ***
kelvinmio: shows [Jc Qc] (two pair, Queens and Jacks)
hubertchen55: mucks hand 
kelvinmio collected $1.70 from pot
*** SUMMARY ***
Total pot $1.78 | Rake $0.08 
Board [2s Ac Qd Ts Js]
Seat 1: kelvinmio (small blind) showed [Jc Qc] and won ($1.70) with two pair, Queens and Jacks
Seat 2: hubertchen55 (big blind) mucked
Seat 3: togl63amg folded before Flop (didn't bet)
Seat 4: NiceMeng folded before Flop (didn't bet)
Seat 5: M0nzdrik folded before Flop (didn't bet)
Seat 6: Johan25888 (button) folded before Flop (didn't bet)



PokerStars Hand #201500917470:  Hold'em No Limit ($0.05/$0.10 USD) - 2019/06/18 3:42:09 ET
Table 'Achird' 6-max Seat #1 is the button
Seat 1: kelvinmio ($16.96 in chips) 
Seat 2: hubertchen55 ($6.70 in chips) 
Seat 3: togl63amg ($10 in chips) 
Seat 4: NiceMeng ($9.50 in chips) 
Seat 5: M0nzdrik ($10 in chips) 
Seat 6: Johan25888 ($10.42 in chips) 
hubertchen55: posts small blind $0.05
togl63amg: posts big blind $0.10
*** HOLE CARDS ***
NiceMeng: folds 
M0nzdrik: folds 
Johan25888: folds 
kelvinmio: raises $0.20 to $0.30
hubertchen55: calls $0.25
togl63amg: folds 
*** FLOP *** [9h 8d Ts]
hubertchen55: bets $0.10
kelvinmio: calls $0.10
*** TURN *** [9h 8d Ts] [Ac]
hubertchen55: checks 
kelvinmio: bets $0.43
hubertchen55: calls $0.43
*** RIVER *** [9h 8d Ts Ac] [2s]
hubertchen55: checks 
kelvinmio: checks 
*** SHOW DOWN ***
hubertchen55: shows [9s 6s] (a pair of Nines)
kelvinmio: mucks hand 
hubertchen55 collected $1.68 from pot
*** SUMMARY ***
Total pot $1.76 | Rake $0.08 
Board [9h 8d Ts Ac 2s]
Seat 1: kelvinmio (button) mucked
Seat 2: hubertchen55 (small blind) showed [9s 6s] and won ($1.68) with a pair of Nines
Seat 3: togl63amg (big blind) folded before Flop
Seat 4: NiceMeng folded before Flop (didn't bet)
Seat 5: M0nzdrik folded before Flop (didn't bet)
Seat 6: Johan25888 folded before Flop (didn't bet)



PokerStars Hand #201500926629:  Hold'em No Limit ($0.05/$0.10 USD) - 2019/06/18 3:42:57 ET
Table 'Achird' 6-max Seat #2 is the button
Seat 1: kelvinmio ($16.13 in chips) 
Seat 2: hubertchen55 ($7.55 in chips) 
Seat 3: togl63amg ($10 in chips) 
Seat 4: NiceMeng ($9.50 in chips) 
Seat 5: M0nzdrik ($10 in chips) 
Seat 6: Johan25888 ($10.42 in chips) 
togl63amg: posts small blind $0.05
NiceMeng: posts big blind $0.10
*** HOLE CARDS ***
M0nzdrik: folds 
Johan25888: folds 
kelvinmio: folds 
hubertchen55: calls $0.10
togl63amg: folds 
NiceMeng: checks 
*** FLOP *** [Qs Ks Ts]
NiceMeng: checks 
hubertchen55: checks 
*** TURN *** [Qs Ks Ts] [9s]
NiceMeng: checks 
hubertchen55: bets $0.10
NiceMeng: folds 
Uncalled bet ($0.10) returned to hubertchen55
hubertchen55 collected $0.24 from pot
hubertchen55: doesn't show hand 
*** SUMMARY ***
Total pot $0.25 | Rake $0.01 
Board [Qs Ks Ts 9s]
Seat 1: kelvinmio folded before Flop (didn't bet)
Seat 2: hubertchen55 (button) collected ($0.24)
Seat 3: togl63amg (small blind) folded before Flop
Seat 4: NiceMeng (big blind) folded on the Turn
Seat 5: M0nzdrik folded before Flop (didn't bet)
Seat 6: Johan25888 folded before Flop (didn't bet)



PokerStars Hand #201500938073:  Hold'em No Limit ($0.05/$0.10 USD) - 2019/06/18 3:43:57 ET
Table 'Achird' 6-max Seat #3 is the button
Seat 1: kelvinmio ($16.13 in chips) 
Seat 2: hubertchen55 ($7.69 in chips) 
Seat 3: togl63amg ($10 in chips) 
Seat 4: NiceMeng ($9.40 in chips) 
Seat 5: M0nzdrik ($10 in chips) 
Seat 6: Johan25888 ($10.42 in chips) 
NiceMeng: posts small blind $0.05
M0nzdrik: posts big blind $0.10
*** HOLE CARDS ***
Johan25888: folds 
kelvinmio: raises $0.20 to $0.30
hubertchen55: folds 
togl63amg: folds 
NiceMeng: folds 
M0nzdrik: folds 
Uncalled bet ($0.20) returned to kelvinmio
kelvinmio collected $0.25 from pot
kelvinmio: doesn't show hand 
*** SUMMARY ***
Total pot $0.25 | Rake $0 
Seat 1: kelvinmio collected ($0.25)
Seat 2: hubertchen55 folded before Flop (didn't bet)
Seat 3: togl63amg (button) folded before Flop (didn't bet)
Seat 4: NiceMeng (small blind) folded before Flop
Seat 5: M0nzdrik (big blind) folded before Flop
Seat 6: Johan25888 folded before Flop (didn't bet)



PokerStars Hand #201500940274:  Hold'em No Limit ($0.05/$0.10 USD) - 2019/06/18 3:44:09 ET
Table 'Achird' 6-max Seat #4 is the button
Seat 1: kelvinmio ($16.28 in chips) 
Seat 2: hubertchen55 ($7.69 in chips) 
Seat 3: togl63amg ($10 in chips) 
Seat 4: NiceMeng ($9.35 in chips) 
Seat 5: M0nzdrik ($10 in chips) 
Seat 6: Johan25888 ($10.42 in chips) 
M0nzdrik: posts small blind $0.05
Johan25888: posts big blind $0.10
*** HOLE CARDS ***
kelvinmio: folds 
hubertchen55: folds 
togl63amg: folds 
NiceMeng: raises $0.20 to $0.30
M0nzdrik: folds 
Johan25888: folds 
Uncalled bet ($0.20) returned to NiceMeng
NiceMeng collected $0.25 from pot
NiceMeng: doesn't show hand 
*** SUMMARY ***
Total pot $0.25 | Rake $0 
Seat 1: kelvinmio folded before Flop (didn't bet)
Seat 2: hubertchen55 folded before Flop (didn't bet)
Seat 3: togl63amg folded before Flop (didn't bet)
Seat 4: NiceMeng (button) collected ($0.25)
Seat 5: M0nzdrik (small blind) folded before Flop
Seat 6: Johan25888 (big blind) folded before Flop



PokerStars Hand #201500942689:  Hold'em No Limit ($0.05/$0.10 USD) - 2019/06/18 3:44:22 ET
Table 'Achird' 6-max Seat #5 is the button
Seat 1: kelvinmio ($16.28 in chips) 
Seat 2: hubertchen55 ($7.69 in chips) 
Seat 3: togl63amg ($10 in chips) 
Seat 4: NiceMeng ($9.50 in chips) 
Seat 5: M0nzdrik ($10 in chips) 
Seat 6: Johan25888 ($10.32 in chips) 
Johan25888: posts small blind $0.05
kelvinmio: posts big blind $0.10
*** HOLE CARDS ***
hubertchen55: folds 
togl63amg: raises $0.20 to $0.30
NiceMeng: folds 
M0nzdrik: folds 
Johan25888: folds 
kelvinmio: folds 
Uncalled bet ($0.20) returned to togl63amg
togl63amg collected $0.25 from pot
*** SUMMARY ***
Total pot $0.25 | Rake $0 
Seat 1: kelvinmio (big blind) folded before Flop
Seat 2: hubertchen55 folded before Flop (didn't bet)
Seat 3: togl63amg collected ($0.25)
Seat 4: NiceMeng folded before Flop (didn't bet)
Seat 5: M0nzdrik (button) folded before Flop (didn't bet)
Seat 6: Johan25888 (small blind) folded before Flop



PokerStars Hand #201500946906:  Hold'em No Limit ($0.05/$0.10 USD) - 2019/06/18 3:44:44 ET
Table 'Achird' 6-max Seat #6 is the button
Seat 1: kelvinmio ($16.18 in chips) 
Seat 2: hubertchen55 ($7.69 in chips) 
Seat 3: togl63amg ($10.15 in chips) 
Seat 4: NiceMeng ($9.50 in chips) 
Seat 5: M0nzdrik ($10 in chips) 
Seat 6: Johan25888 ($10.27 in chips) 
kelvinmio: posts small blind $0.05
hubertchen55: posts big blind $0.10
*** HOLE CARDS ***
togl63amg: folds 
NiceMeng: folds 
M0nzdrik: folds 
Johan25888: folds 
kelvinmio: raises $0.20 to $0.30
hubertchen55: folds 
Uncalled bet ($0.20) returned to kelvinmio
kelvinmio collected $0.20 from pot
kelvinmio: doesn't show hand 
*** SUMMARY ***
Total pot $0.20 | Rake $0 
Seat 1: kelvinmio (small blind) collected ($0.20)
Seat 2: hubertchen55 (big blind) folded before Flop
Seat 3: togl63amg folded before Flop (didn't bet)
Seat 4: NiceMeng folded before Flop (didn't bet)
Seat 5: M0nzdrik folded before Flop (didn't bet)
Seat 6: Johan25888 (button) folded before Flop (didn't bet)



PokerStars Hand #201500949651:  Hold'em No Limit ($0.05/$0.10 USD) - 2019/06/18 3:44:59 ET
Table 'Achird' 6-max Seat #1 is the button
Seat 1: kelvinmio ($16.28 in chips) 
Seat 2: hubertchen55 ($7.59 in chips) 
Seat 3: togl63amg ($10.15 in chips) 
Seat 4: NiceMeng ($9.50 in chips) 
Seat 5: M0nzdrik ($10 in chips) 
Seat 6: Johan25888 ($10.27 in chips) 
hubertchen55: posts small blind $0.05
togl63amg: posts big blind $0.10
*** HOLE CARDS ***
NiceMeng: folds 
M0nzdrik: folds 
Johan25888: folds 
kelvinmio: raises $0.20 to $0.30
hubertchen55: folds 
togl63amg: calls $0.20
*** FLOP *** [Qs Td 6c]
togl63amg: checks 
kelvinmio: checks 
*** TURN *** [Qs Td 6c] [8s]
togl63amg: checks 
kelvinmio: checks 
*** RIVER *** [Qs Td 6c 8s] [9h]
togl63amg: checks 
kelvinmio: bets $0.62
togl63amg: folds 
Uncalled bet ($0.62) returned to kelvinmio
kelvinmio collected $0.62 from pot
kelvinmio: doesn't show hand 
*** SUMMARY ***
Total pot $0.65 | Rake $0.03 
Board [Qs Td 6c 8s 9h]
Seat 1: kelvinmio (button) collected ($0.62)
Seat 2: hubertchen55 (small blind) folded before Flop
Seat 3: togl63amg (big blind) folded on the River
Seat 4: NiceMeng folded before Flop (didn't bet)
Seat 5: M0nzdrik folded before Flop (didn't bet)
Seat 6: Johan25888 folded before Flop (didn't bet)



PokerStars Hand #201500957731:  Hold'em No Limit ($0.05/$0.10 USD) - 2019/06/18 3:45:40 ET
Table 'Achird' 6-max Seat #2 is the button
Seat 1: kelvinmio ($16.60 in chips) 
Seat 2: hubertchen55 ($7.54 in chips) 
Seat 3: togl63amg ($10 in chips) 
Seat 4: NiceMeng ($9.50 in chips) 
Seat 5: M0nzdrik ($10 in chips) 
Seat 6: Johan25888 ($10.27 in chips) 
togl63amg: posts small blind $0.05
NiceMeng: posts big blind $0.10
*** HOLE CARDS ***
M0nzdrik: folds 
Johan25888: folds 
kelvinmio: raises $0.20 to $0.30
hubertchen55: folds 
togl63amg: folds 
NiceMeng: calls $0.20
*** FLOP *** [3d 8c 9c]
NiceMeng: checks 
kelvinmio: bets $0.31
NiceMeng: folds 
Uncalled bet ($0.31) returned to kelvinmio
kelvinmio collected $0.62 from pot
kelvinmio: doesn't show hand 
*** SUMMARY ***
Total pot $0.65 | Rake $0.03 
Board [3d 8c 9c]
Seat 1: kelvinmio collected ($0.62)
Seat 2: hubertchen55 (button) folded before Flop (didn't bet)
Seat 3: togl63amg (small blind) folded before Flop
Seat 4: NiceMeng (big blind) folded on the Flop
Seat 5: M0nzdrik folded before Flop (didn't bet)
Seat 6: Johan25888 folded before Flop (didn't bet)



PokerStars Hand #201500965465:  Hold'em No Limit ($0.05/$0.10 USD) - 2019/06/18 3:46:21 ET
Table 'Achird' 6-max Seat #3 is the button
Seat 1: kelvinmio ($16.92 in chips) 
Seat 2: hubertchen55 ($7.54 in chips) 
Seat 3: togl63amg ($10 in chips) 
Seat 4: NiceMeng ($9.20 in chips) 
Seat 5: M0nzdrik ($10 in chips) 
Seat 6: Johan25888 ($10.27 in chips) 
NiceMeng: posts small blind $0.05
M0nzdrik: posts big blind $0.10
*** HOLE CARDS ***
Johan25888: folds 
kelvinmio: raises $0.20 to $0.30
hubertchen55: folds 
togl63amg: raises $0.60 to $0.90
NiceMeng: folds 
M0nzdrik: folds 
kelvinmio: folds 
Uncalled bet ($0.60) returned to togl63amg
togl63amg collected $0.75 from pot
*** SUMMARY ***
Total pot $0.75 | Rake $0 
Seat 1: kelvinmio folded before Flop
Seat 2: hubertchen55 folded before Flop (didn't bet)
Seat 3: togl63amg (button) collected ($0.75)
Seat 4: NiceMeng (small blind) folded before Flop
Seat 5: M0nzdrik (big blind) folded before Flop
Seat 6: Johan25888 folded before Flop (didn't bet)



PokerStars Hand #201500970640:  Hold'em No Limit ($0.05/$0.10 USD) - 2019/06/18 3:46:48 ET
Table 'Achird' 6-max Seat #4 is the button
Seat 1: kelvinmio ($16.62 in chips) 
Seat 2: hubertchen55 ($7.54 in chips) 
Seat 3: togl63amg ($10.45 in chips) 
Seat 4: NiceMeng ($9.15 in chips) 
Seat 5: M0nzdrik ($10 in chips) 
Seat 6: Johan25888 ($10.27 in chips) 
M0nzdrik: posts small blind $0.05
Johan25888: posts big blind $0.10
*** HOLE CARDS ***
kelvinmio: folds 
hubertchen55: folds 
togl63amg: folds 
NiceMeng: folds 
M0nzdrik: raises $0.15 to $0.25
Johan25888: folds 
Uncalled bet ($0.15) returned to M0nzdrik
M0nzdrik collected $0.20 from pot
M0nzdrik: doesn't show hand 
*** SUMMARY ***
Total pot $0.20 | Rake $0 
Seat 1: kelvinmio folded before Flop (didn't bet)
Seat 2: hubertchen55 folded before Flop (didn't bet)
Seat 3: togl63amg folded before Flop (didn't bet)
Seat 4: NiceMeng (button) folded before Flop (didn't bet)
Seat 5: M0nzdrik (small blind) collected ($0.20)
Seat 6: Johan25888 (big blind) folded before Flop



PokerStars Hand #201500974565:  Hold'em No Limit ($0.05/$0.10 USD) - 2019/06/18 3:47:09 ET
Table 'Achird' 6-max Seat #5 is the button
Seat 1: kelvinmio ($16.62 in chips) 
Seat 2: hubertchen55 ($7.54 in chips) 
Seat 3: togl63amg ($10.45 in chips) 
Seat 4: NiceMeng ($9.15 in chips) 
Seat 5: M0nzdrik ($10.10 in chips) 
Seat 6: Johan25888 ($10.17 in chips) 
Johan25888: posts small blind $0.05
kelvinmio: posts big blind $0.10
*** HOLE CARDS ***
hubertchen55: calls $0.10
togl63amg: folds 
NiceMeng: folds 
M0nzdrik: folds 
Johan25888: calls $0.05
kelvinmio: raises $0.30 to $0.40
hubertchen55: calls $0.30
Johan25888: folds 
*** FLOP *** [Ks Ts 3s]
kelvinmio: bets $0.60
hubertchen55: calls $0.60
*** TURN *** [Ks Ts 3s] [Ad]
kelvinmio: bets $1.50
hubertchen55: raises $1.50 to $3
kelvinmio: folds 
Uncalled bet ($1.50) returned to hubertchen55
hubertchen55 collected $4.87 from pot
hubertchen55: doesn't show hand 
*** SUMMARY ***
Total pot $5.10 | Rake $0.23 
Board [Ks Ts 3s Ad]
Seat 1: kelvinmio (big blind) folded on the Turn
Seat 2: hubertchen55 collected ($4.87)
Seat 3: togl63amg folded before Flop (didn't bet)
Seat 4: NiceMeng folded before Flop (didn't bet)
Seat 5: M0nzdrik (button) folded before Flop (didn't bet)
Seat 6: Johan25888 (small blind) folded before Flop



PokerStars Hand #201500995231:  Hold'em No Limit ($0.05/$0.10 USD) - 2019/06/18 3:48:54 ET
Table 'Achird' 6-max Seat #6 is the button
Seat 1: kelvinmio ($14.12 in chips) 
Seat 2: hubertchen55 ($9.91 in chips) 
Seat 3: togl63amg ($10.45 in chips) 
Seat 4: NiceMeng ($9.15 in chips) 
Seat 5: M0nzdrik ($10.10 in chips) 
Seat 6: Johan25888 ($10.07 in chips) 
kelvinmio: posts small blind $0.05
hubertchen55: posts big blind $0.10
*** HOLE CARDS ***
togl63amg: folds 
NiceMeng: folds 
M0nzdrik: folds 
Johan25888: raises $0.15 to $0.25
kelvinmio: folds 
hubertchen55: calls $0.15
*** FLOP *** [Ts 5s 4c]
hubertchen55: bets $0.10
Johan25888: folds 
Uncalled bet ($0.10) returned to hubertchen55
hubertchen55 collected $0.53 from pot
hubertchen55: doesn't show hand 
*** SUMMARY ***
Total pot $0.55 | Rake $0.02 
Board [Ts 5s 4c]
Seat 1: kelvinmio (small blind) folded before Flop
Seat 2: hubertchen55 (big blind) collected ($0.53)
Seat 3: togl63amg folded before Flop (didn't bet)
Seat 4: NiceMeng folded before Flop (didn't bet)
Seat 5: M0nzdrik folded before Flop (didn't bet)
Seat 6: Johan25888 (button) folded on the Flop



PokerStars Hand #201500064889:  Hold'em No Limit ($0.05/$0.10 USD) - 2019/06/18 2:20:35 ET
Table 'Achird' 6-max Seat #4 is the button
Seat 1: vassartem ($9.90 in chips) 
Seat 2: Bebabcsinya ($10.03 in chips) 
Seat 3: bartux363 ($1.87 in chips) 
Seat 4: Y2K-17 ($11.99 in chips) 
Seat 5: GabrielCH88 ($12.50 in chips) 
Seat 6: plumiy ($4.91 in chips) 
GabrielCH88: posts small blind $0.05
plumiy: posts big blind $0.10
*** HOLE CARDS ***
vassartem: folds 
Bebabcsinya: raises $0.15 to $0.25
bartux363: folds 
Y2K-17: folds 
GabrielCH88: folds 
plumiy: calls $0.15
*** FLOP *** [5h 2s 2h]
plumiy: checks 
vassartem is disconnected 
Bebabcsinya: bets $0.30
plumiy: calls $0.30
*** TURN *** [5h 2s 2h] [8d]
plumiy: checks 
Bebabcsinya: checks 
*** RIVER *** [5h 2s 2h 8d] [6c]
plumiy: checks 
Bebabcsinya: checks 
*** SHOW DOWN ***
plumiy: shows [Qs Kh] (a pair of Deuces)
Bebabcsinya: shows [3h 3d] (two pair, Threes and Deuces)
Bebabcsinya collected $1.10 from pot
*** SUMMARY ***
Total pot $1.15 | Rake $0.05 
Board [5h 2s 2h 8d 6c]
Seat 1: vassartem folded before Flop (didn't bet)
Seat 2: Bebabcsinya showed [3h 3d] and won ($1.10) with two pair, Threes and Deuces
Seat 3: bartux363 folded before Flop (didn't bet)
Seat 4: Y2K-17 (button) folded before Flop (didn't bet)
Seat 5: GabrielCH88 (small blind) folded before Flop
Seat 6: plumiy (big blind) showed [Qs Kh] and lost with a pair of Deuces



PokerStars Hand #201500262659:  Hold'em No Limit ($0.05/$0.10 USD) - 2019/06/18 2:40:09 ET
Table 'Achird' 6-max Seat #6 is the button
Seat 2: Bebabcsinya ($14.38 in chips) 
Seat 3: bartux363 ($4.83 in chips) 
Seat 4: Y2K-17 ($19.97 in chips) 
Seat 5: reeqar ($10.60 in chips) 
Seat 6: plumiy ($4.49 in chips) 
Bebabcsinya: posts small blind $0.05
bartux363: posts big blind $0.10
*** HOLE CARDS ***
Y2K-17: folds 
reeqar: folds 
plumiy: folds 
Bebabcsinya: folds 
Uncalled bet ($0.05) returned to bartux363
bartux363 collected $0.10 from pot
*** SUMMARY ***
Total pot $0.10 | Rake $0 
Seat 2: Bebabcsinya (small blind) folded before Flop
Seat 3: bartux363 (big blind) collected ($0.10)
Seat 4: Y2K-17 folded before Flop (didn't bet)
Seat 5: reeqar folded before Flop (didn't bet)
Seat 6: plumiy (button) folded before Flop (didn't bet)



PokerStars Hand #201501019852:  Hold'em No Limit ($0.05/$0.10 USD) - 2019/06/18 3:50:59 ET
Table 'Achird' 6-max Seat #3 is the button
Seat 1: kelvinmio ($13.32 in chips) 
Seat 2: hubertchen55 ($10.33 in chips) 
Seat 3: togl63amg ($10.25 in chips) 
Seat 4: NiceMeng ($9.05 in chips) 
Seat 5: M0nzdrik ($10.10 in chips) 
Seat 6: Johan25888 ($10.90 in chips) 
NiceMeng: posts small blind $0.05
M0nzdrik: posts big blind $0.10
*** HOLE CARDS ***
Johan25888: folds 
kelvinmio: folds 
hubertchen55: folds 
togl63amg: folds 
NiceMeng: raises $0.20 to $0.30
M0nzdrik: folds 
Uncalled bet ($0.20) returned to NiceMeng
NiceMeng collected $0.20 from pot
*** SUMMARY ***
Total pot $0.20 | Rake $0 
Seat 1: kelvinmio folded before Flop (didn't bet)
Seat 2: hubertchen55 folded before Flop (didn't bet)
Seat 3: togl63amg (button) folded before Flop (didn't bet)
Seat 4: NiceMeng (small blind) collected ($0.20)
Seat 5: M0nzdrik (big blind) folded before Flop
Seat 6: Johan25888 folded before Flop (didn't bet)



PokerStars Hand #201500578798:  Hold'em No Limit ($0.05/$0.10 USD) - 2019/06/18 3:11:16 ET
Table 'Achird' 6-max Seat #2 is the button
Seat 1: kelvinmio ($15.40 in chips) 
Seat 2: Seif_NOB ($10.73 in chips) 
Seat 3: Alinyr ($10 in chips) 
Seat 4: Y2K-17 ($18.05 in chips) 
Seat 5: dpv82 ($12.53 in chips) 
Seat 6: Johan25888 ($10.33 in chips) 
Alinyr: posts small blind $0.05
Y2K-17: posts big blind $0.10
*** HOLE CARDS ***
dpv82: folds 
Johan25888: folds 
kelvinmio: folds 
Seif_NOB: raises $0.10 to $0.20
Alinyr: folds 
Y2K-17: calls $0.10
*** FLOP *** [5d 5h Qd]
Y2K-17: checks 
Seif_NOB: bets $0.20
Y2K-17: folds 
Uncalled bet ($0.20) returned to Seif_NOB
Seif_NOB collected $0.43 from pot
Seif_NOB: doesn't show hand 
*** SUMMARY ***
Total pot $0.45 | Rake $0.02 
Board [5d 5h Qd]
Seat 1: kelvinmio folded before Flop (didn't bet)
Seat 2: Seif_NOB (button) collected ($0.43)
Seat 3: Alinyr (small blind) folded before Flop
Seat 4: Y2K-17 (big blind) folded on the Flop
Seat 5: dpv82 folded before Flop (didn't bet)
Seat 6: Johan25888 folded before Flop (didn't bet)



PokerStars Hand #201500585966:  Hold'em No Limit ($0.05/$0.10 USD) - 2019/06/18 3:11:57 ET
Table 'Achird' 6-max Seat #3 is the button
Seat 1: kelvinmio ($15.40 in chips) 
Seat 2: Seif_NOB ($10.96 in chips) 
Seat 3: Alinyr ($10 in chips) 
Seat 4: Y2K-17 ($17.85 in chips) 
Seat 5: dpv82 ($12.53 in chips) 
Seat 6: Johan25888 ($10.33 in chips) 
Y2K-17: posts small blind $0.05
dpv82: posts big blind $0.10
*** HOLE CARDS ***
Johan25888: folds 
kelvinmio: folds 
Seif_NOB: folds 
Alinyr: raises $0.15 to $0.25
Y2K-17: folds 
dpv82: calls $0.15
*** FLOP *** [7s Ks 6c]
dpv82: checks 
Alinyr: bets $0.18
dpv82: folds 
Uncalled bet ($0.18) returned to Alinyr
Alinyr collected $0.53 from pot
Alinyr: doesn't show hand 
*** SUMMARY ***
Total pot $0.55 | Rake $0.02 
Board [7s Ks 6c]
Seat 1: kelvinmio folded before Flop (didn't bet)
Seat 2: Seif_NOB folded before Flop (didn't bet)
Seat 3: Alinyr (button) collected ($0.53)
Seat 4: Y2K-17 (small blind) folded before Flop
Seat 5: dpv82 (big blind) folded on the Flop
Seat 6: Johan25888 folded before Flop (didn't bet)



PokerStars Hand #201500593292:  Hold'em No Limit ($0.05/$0.10 USD) - 2019/06/18 3:12:38 ET
Table 'Achird' 6-max Seat #4 is the button
Seat 1: kelvinmio ($15.40 in chips) 
Seat 2: Seif_NOB ($10.96 in chips) 
Seat 3: Alinyr ($10.28 in chips) 
Seat 4: Y2K-17 ($17.80 in chips) 
Seat 5: dpv82 ($12.28 in chips) 
Seat 6: Johan25888 ($10.33 in chips) 
dpv82: posts small blind $0.05
Johan25888: posts big blind $0.10
*** HOLE CARDS ***
kelvinmio: folds 
Seif_NOB: raises $0.15 to $0.25
Alinyr: folds 
Y2K-17: folds 
dpv82: folds 
Johan25888: folds 
Uncalled bet ($0.15) returned to Seif_NOB
Seif_NOB collected $0.25 from pot
Seif_NOB: doesn't show hand 
*** SUMMARY ***
Total pot $0.25 | Rake $0 
Seat 1: kelvinmio folded before Flop (didn't bet)
Seat 2: Seif_NOB collected ($0.25)
Seat 3: Alinyr folded before Flop (didn't bet)
Seat 4: Y2K-17 (button) folded before Flop (didn't bet)
Seat 5: dpv82 (small blind) folded before Flop
Seat 6: Johan25888 (big blind) folded before Flop



PokerStars Hand #201500596279:  Hold'em No Limit ($0.05/$0.10 USD) - 2019/06/18 3:12:55 ET
Table 'Achird' 6-max Seat #5 is the button
Seat 1: kelvinmio ($15.40 in chips) 
Seat 2: Seif_NOB ($11.11 in chips) 
Seat 3: Alinyr ($10.28 in chips) 
Seat 4: Y2K-17 ($17.80 in chips) 
Seat 5: dpv82 ($12.23 in chips) 
Seat 6: Johan25888 ($10.23 in chips) 
Johan25888: posts small blind $0.05
kelvinmio: posts big blind $0.10
*** HOLE CARDS ***
Seif_NOB: raises $0.15 to $0.25
Alinyr: folds 
Y2K-17: folds 
dpv82: folds 
Johan25888: folds 
kelvinmio: folds 
Uncalled bet ($0.15) returned to Seif_NOB
Seif_NOB collected $0.25 from pot
Seif_NOB: doesn't show hand 
*** SUMMARY ***
Total pot $0.25 | Rake $0 
Seat 1: kelvinmio (big blind) folded before Flop
Seat 2: Seif_NOB collected ($0.25)
Seat 3: Alinyr folded before Flop (didn't bet)
Seat 4: Y2K-17 folded before Flop (didn't bet)
Seat 5: dpv82 (button) folded before Flop (didn't bet)
Seat 6: Johan25888 (small blind) folded before Flop



PokerStars Hand #201500599720:  Hold'em No Limit ($0.05/$0.10 USD) - 2019/06/18 3:13:14 ET
Table 'Achird' 6-max Seat #6 is the button
Seat 1: kelvinmio ($15.30 in chips) 
Seat 2: Seif_NOB ($11.26 in chips) 
Seat 3: Alinyr ($10.28 in chips) 
Seat 4: Y2K-17 ($17.80 in chips) 
Seat 5: dpv82 ($12.23 in chips) 
Seat 6: Johan25888 ($10.18 in chips) 
kelvinmio: posts small blind $0.05
Seif_NOB: posts big blind $0.10
*** HOLE CARDS ***
Alinyr: folds 
Y2K-17: folds 
dpv82: folds 
Johan25888: folds 
kelvinmio: folds 
Uncalled bet ($0.05) returned to Seif_NOB
Seif_NOB collected $0.10 from pot
Seif_NOB: doesn't show hand 
*** SUMMARY ***
Total pot $0.10 | Rake $0 
Seat 1: kelvinmio (small blind) folded before Flop
Seat 2: Seif_NOB (big blind) collected ($0.10)
Seat 3: Alinyr folded before Flop (didn't bet)
Seat 4: Y2K-17 folded before Flop (didn't bet)
Seat 5: dpv82 folded before Flop (didn't bet)
Seat 6: Johan25888 (button) folded before Flop (didn't bet)



PokerStars Hand #201500601816:  Hold'em No Limit ($0.05/$0.10 USD) - 2019/06/18 3:13:26 ET
Table 'Achird' 6-max Seat #1 is the button
Seat 1: kelvinmio ($15.25 in chips) 
Seat 2: Seif_NOB ($11.31 in chips) 
Seat 3: Alinyr ($10.28 in chips) 
Seat 4: Y2K-17 ($17.80 in chips) 
Seat 5: dpv82 ($12.23 in chips) 
Seat 6: Johan25888 ($10.18 in chips) 
Seif_NOB: posts small blind $0.05
Alinyr: posts big blind $0.10
*** HOLE CARDS ***
Y2K-17: raises $0.25 to $0.35
dpv82: folds 
Johan25888: folds 
kelvinmio: raises $0.90 to $1.25
Seif_NOB: folds 
Alinyr: folds 
Y2K-17: folds 
Uncalled bet ($0.90) returned to kelvinmio
kelvinmio collected $0.85 from pot
kelvinmio: doesn't show hand 
*** SUMMARY ***
Total pot $0.85 | Rake $0 
Seat 1: kelvinmio (button) collected ($0.85)
Seat 2: Seif_NOB (small blind) folded before Flop
Seat 3: Alinyr (big blind) folded before Flop
Seat 4: Y2K-17 folded before Flop
Seat 5: dpv82 folded before Flop (didn't bet)
Seat 6: Johan25888 folded before Flop (didn't bet)



PokerStars Hand #201500607626:  Hold'em No Limit ($0.05/$0.10 USD) - 2019/06/18 3:13:58 ET
Table 'Achird' 6-max Seat #2 is the button
Seat 1: kelvinmio ($15.75 in chips) 
Seat 2: Seif_NOB ($11.26 in chips) 
Seat 3: Alinyr ($10.18 in chips) 
Seat 4: Y2K-17 ($17.45 in chips) 
Seat 5: dpv82 ($12.23 in chips) 
Seat 6: Johan25888 ($10.18 in chips) 
Alinyr: posts small blind $0.05
Y2K-17: posts big blind $0.10
*** HOLE CARDS ***
dpv82: folds 
Johan25888: folds 
kelvinmio: folds 
Seif_NOB: raises $0.10 to $0.20
Alinyr: folds 
Y2K-17: calls $0.10
*** FLOP *** [Kh 4s Qs]
Y2K-17: checks 
Seif_NOB: bets $0.40
Y2K-17: calls $0.40
*** TURN *** [Kh 4s Qs] [4c]
Y2K-17: checks 
Seif_NOB: bets $0.89
Y2K-17: folds 
Uncalled bet ($0.89) returned to Seif_NOB
Seif_NOB collected $1.19 from pot
Seif_NOB: doesn't show hand 
*** SUMMARY ***
Total pot $1.25 | Rake $0.06 
Board [Kh 4s Qs 4c]
Seat 1: kelvinmio folded before Flop (didn't bet)
Seat 2: Seif_NOB (button) collected ($1.19)
Seat 3: Alinyr (small blind) folded before Flop
Seat 4: Y2K-17 (big blind) folded on the Turn
Seat 5: dpv82 folded before Flop (didn't bet)
Seat 6: Johan25888 folded before Flop (didn't bet)



PokerStars Hand #201500617961:  Hold'em No Limit ($0.05/$0.10 USD) - 2019/06/18 3:14:55 ET
Table 'Achird' 6-max Seat #3 is the button
Seat 1: kelvinmio ($15.75 in chips) 
Seat 2: Seif_NOB ($11.85 in chips) 
Seat 3: Alinyr ($10.13 in chips) 
Seat 4: Y2K-17 ($16.85 in chips) 
Seat 5: dpv82 ($12.23 in chips) 
Seat 6: Johan25888 ($10.18 in chips) 
Y2K-17: posts small blind $0.05
dpv82: posts big blind $0.10
*** HOLE CARDS ***
Johan25888: folds 
kelvinmio: folds 
Seif_NOB has timed out
Seif_NOB: folds 
Alinyr: raises $0.15 to $0.25
Y2K-17: calls $0.20
dpv82: folds 
*** FLOP *** [9h 3c Jd]
Y2K-17: checks 
Alinyr: checks 
*** TURN *** [9h 3c Jd] [Kd]
Y2K-17: checks 
Alinyr: checks 
*** RIVER *** [9h 3c Jd Kd] [Ad]
Y2K-17: checks 
Alinyr: bets $0.19
Y2K-17: calls $0.19
*** SHOW DOWN ***
Alinyr: shows [Ac 8s] (a pair of Aces)
Y2K-17: shows [7h Ah] (a pair of Aces)
Y2K-17 collected $0.47 from pot
Alinyr collected $0.47 from pot
*** SUMMARY ***
Total pot $0.98 | Rake $0.04 
Board [9h 3c Jd Kd Ad]
Seat 1: kelvinmio folded before Flop (didn't bet)
Seat 2: Seif_NOB folded before Flop (didn't bet)
Seat 3: Alinyr (button) showed [Ac 8s] and won ($0.47) with a pair of Aces
Seat 4: Y2K-17 (small blind) showed [7h Ah] and won ($0.47) with a pair of Aces
Seat 5: dpv82 (big blind) folded before Flop
Seat 6: Johan25888 folded before Flop (didn't bet)



PokerStars Hand #201500629683:  Hold'em No Limit ($0.05/$0.10 USD) - 2019/06/18 3:16:01 ET
Table 'Achird' 6-max Seat #4 is the button
Seat 1: kelvinmio ($15.75 in chips) 
Seat 2: Seif_NOB ($11.85 in chips) 
Seat 3: Alinyr ($10.16 in chips) 
Seat 4: Y2K-17 ($16.88 in chips) 
Seat 5: dpv82 ($12.13 in chips) 
Seat 6: Johan25888 ($10.18 in chips) 
dpv82: posts small blind $0.05
Johan25888: posts big blind $0.10
*** HOLE CARDS ***
kelvinmio: folds 
Seif_NOB: folds 
Alinyr: folds 
Y2K-17: folds 
dpv82: raises $0.20 to $0.30
Johan25888: folds 
Uncalled bet ($0.20) returned to dpv82
dpv82 collected $0.20 from pot
dpv82: doesn't show hand 
*** SUMMARY ***
Total pot $0.20 | Rake $0 
Seat 1: kelvinmio folded before Flop (didn't bet)
Seat 2: Seif_NOB folded before Flop (didn't bet)
Seat 3: Alinyr folded before Flop (didn't bet)
Seat 4: Y2K-17 (button) folded before Flop (didn't bet)
Seat 5: dpv82 (small blind) collected ($0.20)
Seat 6: Johan25888 (big blind) folded before Flop



PokerStars Hand #201500632432:  Hold'em No Limit ($0.05/$0.10 USD) - 2019/06/18 3:16:17 ET
Table 'Achird' 6-max Seat #5 is the button
Seat 1: kelvinmio ($15.75 in chips) 
Seat 2: Seif_NOB ($11.85 in chips) 
Seat 3: Alinyr ($10.16 in chips) 
Seat 4: Y2K-17 ($16.88 in chips) 
Seat 5: dpv82 ($12.23 in chips) 
Seat 6: Johan25888 ($10.08 in chips) 
Johan25888: posts small blind $0.05
kelvinmio: posts big blind $0.10
*** HOLE CARDS ***
Seif_NOB: folds 
Alinyr: raises $0.20 to $0.30
Y2K-17: folds 
dpv82: folds 
Johan25888: folds 
kelvinmio: folds 
Uncalled bet ($0.20) returned to Alinyr
Alinyr collected $0.25 from pot
Alinyr: doesn't show hand 
*** SUMMARY ***
Total pot $0.25 | Rake $0 
Seat 1: kelvinmio (big blind) folded before Flop
Seat 2: Seif_NOB folded before Flop (didn't bet)
Seat 3: Alinyr collected ($0.25)
Seat 4: Y2K-17 folded before Flop (didn't bet)
Seat 5: dpv82 (button) folded before Flop (didn't bet)
Seat 6: Johan25888 (small blind) folded before Flop



PokerStars Hand #201500635937:  Hold'em No Limit ($0.05/$0.10 USD) - 2019/06/18 3:16:37 ET
Table 'Achird' 6-max Seat #6 is the button
Seat 1: kelvinmio ($15.65 in chips) 
Seat 3: Alinyr ($10.31 in chips) 
Seat 4: Y2K-17 ($16.88 in chips) 
Seat 5: dpv82 ($12.23 in chips) 
Seat 6: Johan25888 ($10.03 in chips) 
kelvinmio: posts small blind $0.05
Seif_NOB: is sitting out 
Alinyr: posts big blind $0.10
*** HOLE CARDS ***
Y2K-17: folds 
Seif_NOB leaves the table
dpv82: folds 
Johan25888: folds 
kelvinmio: raises $0.20 to $0.30
Alinyr: raises $0.60 to $0.90
kelvinmio: folds 
Uncalled bet ($0.60) returned to Alinyr
Alinyr collected $0.60 from pot
Alinyr: doesn't show hand 
*** SUMMARY ***
Total pot $0.60 | Rake $0 
Seat 1: kelvinmio (small blind) folded before Flop
Seat 3: Alinyr (big blind) collected ($0.60)
Seat 4: Y2K-17 folded before Flop (didn't bet)
Seat 5: dpv82 folded before Flop (didn't bet)
Seat 6: Johan25888 (button) folded before Flop (didn't bet)



PokerStars Hand #201500644345:  Hold'em No Limit ($0.05/$0.10 USD) - 2019/06/18 3:17:24 ET
Table 'Achird' 6-max Seat #1 is the button
Seat 1: kelvinmio ($15.35 in chips) 
Seat 3: Alinyr ($10.61 in chips) 
Seat 4: Y2K-17 ($16.88 in chips) 
Seat 5: dpv82 ($12.23 in chips) 
Seat 6: Johan25888 ($10.03 in chips) 
Alinyr: posts small blind $0.05
Y2K-17: posts big blind $0.10
*** HOLE CARDS ***
dpv82: folds 
Johan25888: folds 
kelvinmio: folds 
Alinyr: folds 
Uncalled bet ($0.05) returned to Y2K-17
Y2K-17 collected $0.10 from pot
Y2K-17: doesn't show hand 
*** SUMMARY ***
Total pot $0.10 | Rake $0 
Seat 1: kelvinmio (button) folded before Flop (didn't bet)
Seat 3: Alinyr (small blind) folded before Flop
Seat 4: Y2K-17 (big blind) collected ($0.10)
Seat 5: dpv82 folded before Flop (didn't bet)
Seat 6: Johan25888 folded before Flop (didn't bet)



PokerStars Hand #201500646200:  Hold'em No Limit ($0.05/$0.10 USD) - 2019/06/18 3:17:35 ET
Table 'Achird' 6-max Seat #3 is the button
Seat 1: kelvinmio ($15.35 in chips) 
Seat 3: Alinyr ($10.56 in chips) 
Seat 4: Y2K-17 ($16.93 in chips) 
Seat 5: dpv82 ($12.23 in chips) 
Seat 6: Johan25888 ($10.03 in chips) 
Y2K-17: posts small blind $0.05
dpv82: posts big blind $0.10
*** HOLE CARDS ***
Johan25888: folds 
hubertchen55 joins the table at seat #2 
kelvinmio: folds 
Alinyr: folds 
Y2K-17: calls $0.05
dpv82: raises $0.20 to $0.30
Y2K-17: folds 
Uncalled bet ($0.20) returned to dpv82
dpv82 collected $0.20 from pot
dpv82: doesn't show hand 
*** SUMMARY ***
Total pot $0.20 | Rake $0 
Seat 1: kelvinmio folded before Flop (didn't bet)
Seat 3: Alinyr (button) folded before Flop (didn't bet)
Seat 4: Y2K-17 (small blind) folded before Flop
Seat 5: dpv82 (big blind) collected ($0.20)
Seat 6: Johan25888 folded before Flop (didn't bet)



PokerStars Hand #201500649236:  Hold'em No Limit ($0.05/$0.10 USD) - 2019/06/18 3:17:52 ET
Table 'Achird' 6-max Seat #4 is the button
Seat 1: kelvinmio ($15.35 in chips) 
Seat 3: Alinyr ($10.56 in chips) 
Seat 4: Y2K-17 ($16.83 in chips) 
Seat 5: dpv82 ($12.33 in chips) 
Seat 6: Johan25888 ($10.03 in chips) 
dpv82: posts small blind $0.05
Johan25888: posts big blind $0.10
hubertchen55: sits out 
*** HOLE CARDS ***
kelvinmio: raises $0.20 to $0.30
Alinyr: folds 
Y2K-17: folds 
dpv82: folds 
Johan25888: folds 
Uncalled bet ($0.20) returned to kelvinmio
kelvinmio collected $0.25 from pot
kelvinmio: doesn't show hand 
*** SUMMARY ***
Total pot $0.25 | Rake $0 
Seat 1: kelvinmio collected ($0.25)
Seat 3: Alinyr folded before Flop (didn't bet)
Seat 4: Y2K-17 (button) folded before Flop (didn't bet)
Seat 5: dpv82 (small blind) folded before Flop
Seat 6: Johan25888 (big blind) folded before Flop



PokerStars Hand #201500651545:  Hold'em No Limit ($0.05/$0.10 USD) - 2019/06/18 3:18:05 ET
Table 'Achird' 6-max Seat #5 is the button
Seat 1: kelvinmio ($15.50 in chips) 
Seat 3: Alinyr ($10.56 in chips) 
Seat 4: Y2K-17 ($16.83 in chips) 
Seat 5: dpv82 ($12.28 in chips) 
Seat 6: Johan25888 ($10 in chips) 
Johan25888: posts small blind $0.05
kelvinmio: posts big blind $0.10
hubertchen55: sits out 
*** HOLE CARDS ***
Alinyr: folds 
Y2K-17: folds 
dpv82: folds 
Johan25888: raises $0.20 to $0.30
kelvinmio: folds 
Uncalled bet ($0.20) returned to Johan25888
Johan25888 collected $0.20 from pot
Johan25888: doesn't show hand 
*** SUMMARY ***
Total pot $0.20 | Rake $0 
Seat 1: kelvinmio (big blind) folded before Flop
Seat 3: Alinyr folded before Flop (didn't bet)
Seat 4: Y2K-17 folded before Flop (didn't bet)
Seat 5: dpv82 (button) folded before Flop (didn't bet)
Seat 6: Johan25888 (small blind) collected ($0.20)



PokerStars Hand #201500654144:  Hold'em No Limit ($0.05/$0.10 USD) - 2019/06/18 3:18:19 ET
Table 'Achird' 6-max Seat #6 is the button
Seat 1: kelvinmio ($15.40 in chips) 
Seat 2: hubertchen55 ($6.10 in chips) 
Seat 3: Alinyr ($10.56 in chips) 
Seat 4: Y2K-17 ($16.83 in chips) 
Seat 5: dpv82 ($12.28 in chips) 
Seat 6: Johan25888 ($10.10 in chips) 
kelvinmio: posts small blind $0.05
hubertchen55: posts big blind $0.10
*** HOLE CARDS ***
Alinyr: folds 
Y2K-17: folds 
dpv82: folds 
Johan25888: folds 
kelvinmio: folds 
Uncalled bet ($0.05) returned to hubertchen55
hubertchen55 collected $0.10 from pot
hubertchen55: doesn't show hand 
*** SUMMARY ***
Total pot $0.10 | Rake $0 
Seat 1: kelvinmio (small blind) folded before Flop
Seat 2: hubertchen55 (big blind) collected ($0.10)
Seat 3: Alinyr folded before Flop (didn't bet)
Seat 4: Y2K-17 folded before Flop (didn't bet)
Seat 5: dpv82 folded before Flop (didn't bet)
Seat 6: Johan25888 (button) folded before Flop (didn't bet)



PokerStars Hand #201500656252:  Hold'em No Limit ($0.05/$0.10 USD) - 2019/06/18 3:18:31 ET
Table 'Achird' 6-max Seat #1 is the button
Seat 1: kelvinmio ($15.35 in chips) 
Seat 2: hubertchen55 ($6.15 in chips) 
Seat 4: Y2K-17 ($16.83 in chips) 
Seat 5: dpv82 ($12.28 in chips) 
Seat 6: Johan25888 ($10.10 in chips) 
hubertchen55: posts small blind $0.05
Alinyr: is sitting out 
Y2K-17: posts big blind $0.10
*** HOLE CARDS ***
Alinyr leaves the table
dpv82: folds 
TuMyP_797 joins the table at seat #3 
Johan25888: folds 
kelvinmio: folds 
hubertchen55: calls $0.05
Y2K-17: checks 
*** FLOP *** [7c 6c 6h]
hubertchen55: checks 
Y2K-17: checks 
*** TURN *** [7c 6c 6h] [Qs]
hubertchen55: bets $0.20
Y2K-17: folds 
Uncalled bet ($0.20) returned to hubertchen55
hubertchen55 collected $0.19 from pot
hubertchen55: doesn't show hand 
*** SUMMARY ***
Total pot $0.20 | Rake $0.01 
Board [7c 6c 6h Qs]
Seat 1: kelvinmio (button) folded before Flop (didn't bet)
Seat 2: hubertchen55 (small blind) collected ($0.19)
Seat 4: Y2K-17 (big blind) folded on the Turn
Seat 5: dpv82 folded before Flop (didn't bet)
Seat 6: Johan25888 folded before Flop (didn't bet)



PokerStars Hand #201500662157:  Hold'em No Limit ($0.05/$0.10 USD) - 2019/06/18 3:19:04 ET
Table 'Achird' 6-max Seat #2 is the button
Seat 1: kelvinmio ($15.35 in chips) 
Seat 2: hubertchen55 ($6.24 in chips) 
Seat 4: Y2K-17 ($16.73 in chips) 
Seat 5: dpv82 ($12.28 in chips) 
Seat 6: Johan25888 ($10.10 in chips) 
Y2K-17: posts small blind $0.05
dpv82: posts big blind $0.10
*** HOLE CARDS ***
Johan25888: folds 
kelvinmio: folds 
hubertchen55: folds 
Y2K-17: raises $0.20 to $0.30
dpv82: folds 
Uncalled bet ($0.20) returned to Y2K-17
Y2K-17 collected $0.20 from pot
Y2K-17: doesn't show hand 
TuMyP_797 leaves the table
*** SUMMARY ***
Total pot $0.20 | Rake $0 
Seat 1: kelvinmio folded before Flop (didn't bet)
Seat 2: hubertchen55 (button) folded before Flop (didn't bet)
Seat 4: Y2K-17 (small blind) collected ($0.20)
Seat 5: dpv82 (big blind) folded before Flop
Seat 6: Johan25888 folded before Flop (didn't bet)



PokerStars Hand #201500664930:  Hold'em No Limit ($0.05/$0.10 USD) - 2019/06/18 3:19:19 ET
Table 'Achird' 6-max Seat #4 is the button
Seat 1: kelvinmio ($15.35 in chips) 
Seat 2: hubertchen55 ($6.24 in chips) 
Seat 4: Y2K-17 ($16.83 in chips) 
Seat 5: dpv82 ($12.18 in chips) 
Seat 6: Johan25888 ($10.10 in chips) 
dpv82: posts small blind $0.05
Johan25888: posts big blind $0.10
*** HOLE CARDS ***
togl63amg joins the table at seat #3 
kelvinmio: raises $0.20 to $0.30
hubertchen55: folds 
Y2K-17: folds 
dpv82: folds 
Johan25888: folds 
Uncalled bet ($0.20) returned to kelvinmio
kelvinmio collected $0.25 from pot
kelvinmio: doesn't show hand 
*** SUMMARY ***
Total pot $0.25 | Rake $0 
Seat 1: kelvinmio collected ($0.25)
Seat 2: hubertchen55 folded before Flop (didn't bet)
Seat 4: Y2K-17 (button) folded before Flop (didn't bet)
Seat 5: dpv82 (small blind) folded before Flop
Seat 6: Johan25888 (big blind) folded before Flop



PokerStars Hand #201500668188:  Hold'em No Limit ($0.05/$0.10 USD) - 2019/06/18 3:19:37 ET
Table 'Achird' 6-max Seat #5 is the button
Seat 1: kelvinmio ($15.50 in chips) 
Seat 2: hubertchen55 ($6.24 in chips) 
Seat 4: Y2K-17 ($16.83 in chips) 
Seat 5: dpv82 ($12.13 in chips) 
Seat 6: Johan25888 ($10 in chips) 
Johan25888: posts small blind $0.05
kelvinmio: posts big blind $0.10
togl63amg: sits out 
*** HOLE CARDS ***
hubertchen55: calls $0.10
Y2K-17: calls $0.10
dpv82: raises $0.20 to $0.30
Johan25888: folds 
kelvinmio: calls $0.20
hubertchen55: calls $0.20
Y2K-17: calls $0.20
*** FLOP *** [Ks 8c 4h]
kelvinmio: checks 
hubertchen55: bets $0.60
Y2K-17: folds 
dpv82: calls $0.60
kelvinmio: folds 
*** TURN *** [Ks 8c 4h] [2d]
hubertchen55: checks 
dpv82: bets $1.47
hubertchen55: calls $1.47
*** RIVER *** [Ks 8c 4h 2d] [7h]
hubertchen55: checks 
dpv82: bets $3.97
hubertchen55: calls $3.87 and is all-in
Uncalled bet ($0.10) returned to dpv82
*** SHOW DOWN ***
dpv82: shows [Ah As] (a pair of Aces)
hubertchen55: shows [Kh Qs] (a pair of Kings)
dpv82 collected $12.54 from pot
*** SUMMARY ***
Total pot $13.13 | Rake $0.59 
Board [Ks 8c 4h 2d 7h]
Seat 1: kelvinmio (big blind) folded on the Flop
Seat 2: hubertchen55 showed [Kh Qs] and lost with a pair of Kings
Seat 4: Y2K-17 folded on the Flop
Seat 5: dpv82 (button) showed [Ah As] and won ($12.54) with a pair of Aces
Seat 6: Johan25888 (small blind) folded before Flop



PokerStars Hand #201500684601:  Hold'em No Limit ($0.05/$0.10 USD) - 2019/06/18 3:21:06 ET
Table 'Achird' 6-max Seat #6 is the button
Seat 1: kelvinmio ($15.20 in chips) 
Seat 3: togl63amg ($10 in chips) 
Seat 4: Y2K-17 ($16.53 in chips) 
Seat 5: dpv82 ($18.43 in chips) 
Seat 6: Johan25888 ($10 in chips) 
kelvinmio: posts small blind $0.05
togl63amg: posts big blind $0.10
*** HOLE CARDS ***
Y2K-17: calls $0.10
dpv82: folds 
Johan25888: folds 
kelvinmio: folds 
togl63amg: checks 
*** FLOP *** [Ac 2d 6h]
togl63amg: checks 
Y2K-17: checks 
*** TURN *** [Ac 2d 6h] [8s]
togl63amg: bets $0.17
Y2K-17: folds 
Uncalled bet ($0.17) returned to togl63amg
togl63amg collected $0.24 from pot
*** SUMMARY ***
Total pot $0.25 | Rake $0.01 
Board [Ac 2d 6h 8s]
Seat 1: kelvinmio (small blind) folded before Flop
Seat 3: togl63amg (big blind) collected ($0.24)
Seat 4: Y2K-17 folded on the Turn
Seat 5: dpv82 folded before Flop (didn't bet)
Seat 6: Johan25888 (button) folded before Flop (didn't bet)



PokerStars Hand #201500689031:  Hold'em No Limit ($0.05/$0.10 USD) - 2019/06/18 3:21:31 ET
Table 'Achird' 6-max Seat #1 is the button
Seat 1: kelvinmio ($15.15 in chips) 
Seat 3: togl63amg ($10.14 in chips) 
Seat 4: Y2K-17 ($16.43 in chips) 
Seat 5: dpv82 ($18.43 in chips) 
Seat 6: Johan25888 ($10 in chips) 
togl63amg: posts small blind $0.05
Y2K-17: posts big blind $0.10
*** HOLE CARDS ***
dpv82: raises $0.10 to $0.20
Johan25888: folds 
kelvinmio: folds 
togl63amg: calls $0.15
Y2K-17: calls $0.10
*** FLOP *** [3d 5c Ah]
togl63amg: checks 
Y2K-17: checks 
dpv82: bets $0.35
togl63amg: folds 
Y2K-17: folds 
Uncalled bet ($0.35) returned to dpv82
dpv82 collected $0.57 from pot
dpv82: doesn't show hand 
*** SUMMARY ***
Total pot $0.60 | Rake $0.03 
Board [3d 5c Ah]
Seat 1: kelvinmio (button) folded before Flop (didn't bet)
Seat 3: togl63amg (small blind) folded on the Flop
Seat 4: Y2K-17 (big blind) folded on the Flop
Seat 5: dpv82 collected ($0.57)
Seat 6: Johan25888 folded before Flop (didn't bet)



PokerStars Hand #201500696146:  Hold'em No Limit ($0.05/$0.10 USD) - 2019/06/18 3:22:09 ET
Table 'Achird' 6-max Seat #3 is the button
Seat 1: kelvinmio ($15.15 in chips) 
Seat 2: hubertchen55 ($6.58 in chips) 
Seat 3: togl63amg ($10 in chips) 
Seat 4: Y2K-17 ($16.23 in chips) 
Seat 5: dpv82 ($18.80 in chips) 
Seat 6: Johan25888 ($10 in chips) 
Y2K-17: posts small blind $0.05
dpv82: posts big blind $0.10
hubertchen55: posts small & big blinds $0.15
*** HOLE CARDS ***
Johan25888: folds 
kelvinmio: folds 
hubertchen55: checks 
togl63amg: folds 
Y2K-17: calls $0.05
dpv82: checks 
*** FLOP *** [7h Jc Th]
Y2K-17: checks 
dpv82: checks 
hubertchen55: checks 
*** TURN *** [7h Jc Th] [Jd]
Y2K-17: checks 
dpv82: checks 
hubertchen55: checks 
*** RIVER *** [7h Jc Th Jd] [Tc]
Y2K-17: checks 
dpv82: checks 
hubertchen55: bets $0.33
Y2K-17: folds 
dpv82: folds 
Uncalled bet ($0.33) returned to hubertchen55
hubertchen55 collected $0.33 from pot
hubertchen55: doesn't show hand 
*** SUMMARY ***
Total pot $0.35 | Rake $0.02 
Board [7h Jc Th Jd Tc]
Seat 1: kelvinmio folded before Flop (didn't bet)
Seat 2: hubertchen55 collected ($0.33)
Seat 3: togl63amg (button) folded before Flop (didn't bet)
Seat 4: Y2K-17 (small blind) folded on the River
Seat 5: dpv82 (big blind) folded on the River
Seat 6: Johan25888 folded before Flop (didn't bet)



PokerStars Hand #201500705629:  Hold'em No Limit ($0.05/$0.10 USD) - 2019/06/18 3:23:01 ET
Table 'Achird' 6-max Seat #4 is the button
Seat 1: kelvinmio ($15.15 in chips) 
Seat 2: hubertchen55 ($6.76 in chips) 
Seat 3: togl63amg ($10 in chips) 
Seat 4: Y2K-17 ($16.13 in chips) 
Seat 5: dpv82 ($18.70 in chips) 
Seat 6: Johan25888 ($10 in chips) 
dpv82: posts small blind $0.05
Johan25888: posts big blind $0.10
*** HOLE CARDS ***
kelvinmio: folds 
hubertchen55: calls $0.10
togl63amg: folds 
Y2K-17: calls $0.10
dpv82: folds 
Johan25888: checks 
*** FLOP *** [7d 7s 8c]
Johan25888: checks 
hubertchen55: checks 
Y2K-17: checks 
*** TURN *** [7d 7s 8c] [4s]
Johan25888: checks 
hubertchen55: checks 
Y2K-17: checks 
*** RIVER *** [7d 7s 8c 4s] [Qc]
Johan25888: checks 
hubertchen55: bets $0.17
Y2K-17: folds 
Johan25888: folds 
Uncalled bet ($0.17) returned to hubertchen55
hubertchen55 collected $0.33 from pot
hubertchen55: doesn't show hand 
*** SUMMARY ***
Total pot $0.35 | Rake $0.02 
Board [7d 7s 8c 4s Qc]
Seat 1: kelvinmio folded before Flop (didn't bet)
Seat 2: hubertchen55 collected ($0.33)
Seat 3: togl63amg folded before Flop (didn't bet)
Seat 4: Y2K-17 (button) folded on the River
Seat 5: dpv82 (small blind) folded before Flop
Seat 6: Johan25888 (big blind) folded on the River



PokerStars Hand #201500716730:  Hold'em No Limit ($0.05/$0.10 USD) - 2019/06/18 3:24:02 ET
Table 'Achird' 6-max Seat #5 is the button
Seat 1: kelvinmio ($15.15 in chips) 
Seat 2: hubertchen55 ($6.99 in chips) 
Seat 3: togl63amg ($10 in chips) 
Seat 4: Y2K-17 ($16.03 in chips) 
Seat 5: dpv82 ($18.65 in chips) 
Seat 6: Johan25888 ($10 in chips) 
Johan25888: posts small blind $0.05
kelvinmio: posts big blind $0.10
*** HOLE CARDS ***
hubertchen55: folds 
togl63amg: folds 
Y2K-17: folds 
dpv82: folds 
Johan25888: folds 
Uncalled bet ($0.05) returned to kelvinmio
kelvinmio collected $0.10 from pot
kelvinmio: doesn't show hand 
*** SUMMARY ***
Total pot $0.10 | Rake $0 
Seat 1: kelvinmio (big blind) collected ($0.10)
Seat 2: hubertchen55 folded before Flop (didn't bet)
Seat 3: togl63amg folded before Flop (didn't bet)
Seat 4: Y2K-17 folded before Flop (didn't bet)
Seat 5: dpv82 (button) folded before Flop (didn't bet)
Seat 6: Johan25888 (small blind) folded before Flop



PokerStars Hand #201500720656:  Hold'em No Limit ($0.05/$0.10 USD) - 2019/06/18 3:24:23 ET
Table 'Achird' 6-max Seat #6 is the button
Seat 1: kelvinmio ($15.20 in chips) 
Seat 2: hubertchen55 ($6.99 in chips) 
Seat 3: togl63amg ($10 in chips) 
Seat 4: Y2K-17 ($16.03 in chips) 
Seat 5: dpv82 ($18.65 in chips) 
Seat 6: Johan25888 ($10 in chips) 
kelvinmio: posts small blind $0.05
hubertchen55: posts big blind $0.10
*** HOLE CARDS ***
togl63amg: raises $0.20 to $0.30
Y2K-17: folds 
dpv82: folds 
Johan25888: folds 
kelvinmio: folds 
hubertchen55: folds 
Uncalled bet ($0.20) returned to togl63amg
togl63amg collected $0.25 from pot
*** SUMMARY ***
Total pot $0.25 | Rake $0 
Seat 1: kelvinmio (small blind) folded before Flop
Seat 2: hubertchen55 (big blind) folded before Flop
Seat 3: togl63amg collected ($0.25)
Seat 4: Y2K-17 folded before Flop (didn't bet)
Seat 5: dpv82 folded before Flop (didn't bet)
Seat 6: Johan25888 (button) folded before Flop (didn't bet)



PokerStars Hand #201500723727:  Hold'em No Limit ($0.05/$0.10 USD) - 2019/06/18 3:24:40 ET
Table 'Achird' 6-max Seat #1 is the button
Seat 1: kelvinmio ($15.15 in chips) 
Seat 2: hubertchen55 ($6.89 in chips) 
Seat 3: togl63amg ($10.15 in chips) 
Seat 4: Y2K-17 ($16.03 in chips) 
Seat 5: dpv82 ($18.65 in chips) 
Seat 6: Johan25888 ($10 in chips) 
hubertchen55: posts small blind $0.05
togl63amg: posts big blind $0.10
*** HOLE CARDS ***
Y2K-17: folds 
dpv82: folds 
Johan25888: folds 
kelvinmio: folds 
hubertchen55: calls $0.05
Y2K-17 leaves the table
togl63amg: raises $0.30 to $0.40
hubertchen55: folds 
Uncalled bet ($0.30) returned to togl63amg
togl63amg collected $0.20 from pot
*** SUMMARY ***
Total pot $0.20 | Rake $0 
Seat 1: kelvinmio (button) folded before Flop (didn't bet)
Seat 2: hubertchen55 (small blind) folded before Flop
Seat 3: togl63amg (big blind) collected ($0.20)
Seat 4: Y2K-17 folded before Flop (didn't bet)
Seat 5: dpv82 folded before Flop (didn't bet)
Seat 6: Johan25888 folded before Flop (didn't bet)



PokerStars Hand #201500727183:  Hold'em No Limit ($0.05/$0.10 USD) - 2019/06/18 3:24:59 ET
Table 'Achird' 6-max Seat #2 is the button
Seat 1: kelvinmio ($15.15 in chips) 
Seat 2: hubertchen55 ($6.79 in chips) 
Seat 3: togl63amg ($10.25 in chips) 
Seat 5: dpv82 ($18.65 in chips) 
Seat 6: Johan25888 ($10 in chips) 
togl63amg: posts small blind $0.05
dpv82: posts big blind $0.10
*** HOLE CARDS ***
Johan25888: folds 
kelvinmio: folds 
hubertchen55: folds 
togl63amg: folds 
Uncalled bet ($0.05) returned to dpv82
dpv82 collected $0.10 from pot
dpv82: doesn't show hand 
*** SUMMARY ***
Total pot $0.10 | Rake $0 
Seat 1: kelvinmio folded before Flop (didn't bet)
Seat 2: hubertchen55 (button) folded before Flop (didn't bet)
Seat 3: togl63amg (small blind) folded before Flop
Seat 5: dpv82 (big blind) collected ($0.10)
Seat 6: Johan25888 folded before Flop (didn't bet)



PokerStars Hand #201500728850:  Hold'em No Limit ($0.05/$0.10 USD) - 2019/06/18 3:25:08 ET
Table 'Achird' 6-max Seat #3 is the button
Seat 1: kelvinmio ($15.15 in chips) 
Seat 2: hubertchen55 ($6.79 in chips) 
Seat 3: togl63amg ($10.20 in chips) 
Seat 5: dpv82 ($18.70 in chips) 
Seat 6: Johan25888 ($10 in chips) 
dpv82: posts small blind $0.05
Johan25888: posts big blind $0.10
*** HOLE CARDS ***
kelvinmio: folds 
hubertchen55: calls $0.10
togl63amg: raises $0.30 to $0.40
dpv82: folds 
Johan25888: folds 
hubertchen55: calls $0.30
*** FLOP *** [Qs 2h As]
hubertchen55: checks 
togl63amg: bets $0.36
hubertchen55: folds 
Uncalled bet ($0.36) returned to togl63amg
togl63amg collected $0.91 from pot
*** SUMMARY ***
Total pot $0.95 | Rake $0.04 
Board [Qs 2h As]
Seat 1: kelvinmio folded before Flop (didn't bet)
Seat 2: hubertchen55 folded on the Flop
Seat 3: togl63amg (button) collected ($0.91)
Seat 5: dpv82 (small blind) folded before Flop
Seat 6: Johan25888 (big blind) folded before Flop



PokerStars Hand #201500733431:  Hold'em No Limit ($0.05/$0.10 USD) - 2019/06/18 3:25:34 ET
Table 'Achird' 6-max Seat #5 is the button
Seat 1: kelvinmio ($15.15 in chips) 
Seat 2: hubertchen55 ($6.39 in chips) 
Seat 3: togl63amg ($10.71 in chips) 
Seat 5: dpv82 ($18.65 in chips) 
Seat 6: Johan25888 ($10 in chips) 
Johan25888: posts small blind $0.05
kelvinmio: posts big blind $0.10
*** HOLE CARDS ***
hubertchen55: folds 
togl63amg: folds 
dpv82: raises $0.10 to $0.20
Johan25888: folds 
kelvinmio: folds 
Uncalled bet ($0.10) returned to dpv82
dpv82 collected $0.25 from pot
dpv82: doesn't show hand 
*** SUMMARY ***
Total pot $0.25 | Rake $0 
Seat 1: kelvinmio (big blind) folded before Flop
Seat 2: hubertchen55 folded before Flop (didn't bet)
Seat 3: togl63amg folded before Flop (didn't bet)
Seat 5: dpv82 (button) collected ($0.25)
Seat 6: Johan25888 (small blind) folded before Flop



PokerStars Hand #201500736927:  Hold'em No Limit ($0.05/$0.10 USD) - 2019/06/18 3:25:53 ET
Table 'Achird' 6-max Seat #6 is the button
Seat 1: kelvinmio ($15.05 in chips) 
Seat 2: hubertchen55 ($6.39 in chips) 
Seat 3: togl63amg ($10.71 in chips) 
Seat 5: dpv82 ($18.80 in chips) 
Seat 6: Johan25888 ($10 in chips) 
kelvinmio: posts small blind $0.05
hubertchen55: posts big blind $0.10
*** HOLE CARDS ***
togl63amg: folds 
dpv82: folds 
Johan25888: raises $0.15 to $0.25
kelvinmio: folds 
hubertchen55: calls $0.15
*** FLOP *** [As 8h Qd]
hubertchen55: bets $0.27
Johan25888: calls $0.27
*** TURN *** [As 8h Qd] [2d]
hubertchen55: bets $0.20
Johan25888: calls $0.20
*** RIVER *** [As 8h Qd 2d] [4d]
hubertchen55: bets $0.20
Johan25888: folds 
Uncalled bet ($0.20) returned to hubertchen55
hubertchen55 collected $1.42 from pot
hubertchen55: doesn't show hand 
*** SUMMARY ***
Total pot $1.49 | Rake $0.07 
Board [As 8h Qd 2d 4d]
Seat 1: kelvinmio (small blind) folded before Flop
Seat 2: hubertchen55 (big blind) collected ($1.42)
Seat 3: togl63amg folded before Flop (didn't bet)
Seat 5: dpv82 folded before Flop (didn't bet)
Seat 6: Johan25888 (button) folded on the River



PokerStars Hand #201500745228:  Hold'em No Limit ($0.05/$0.10 USD) - 2019/06/18 3:26:38 ET
Table 'Achird' 6-max Seat #1 is the button
Seat 1: kelvinmio ($15 in chips) 
Seat 2: hubertchen55 ($7.09 in chips) 
Seat 3: togl63amg ($10.71 in chips) 
Seat 5: dpv82 ($18.80 in chips) 
Seat 6: Johan25888 ($10 in chips) 
hubertchen55: posts small blind $0.05
togl63amg: posts big blind $0.10
*** HOLE CARDS ***
dpv82: folds 
Johan25888: folds 
kelvinmio: raises $0.20 to $0.30
hubertchen55: folds 
togl63amg: folds 
Uncalled bet ($0.20) returned to kelvinmio
kelvinmio collected $0.25 from pot
*** SUMMARY ***
Total pot $0.25 | Rake $0 
Seat 1: kelvinmio (button) collected ($0.25)
Seat 2: hubertchen55 (small blind) folded before Flop
Seat 3: togl63amg (big blind) folded before Flop
Seat 5: dpv82 folded before Flop (didn't bet)
Seat 6: Johan25888 folded before Flop (didn't bet)



PokerStars Hand #201500749286:  Hold'em No Limit ($0.05/$0.10 USD) - 2019/06/18 3:27:01 ET
Table 'Achird' 6-max Seat #2 is the button
Seat 1: kelvinmio ($15.15 in chips) 
Seat 2: hubertchen55 ($7.04 in chips) 
Seat 3: togl63amg ($10.61 in chips) 
Seat 5: dpv82 ($18.80 in chips) 
Seat 6: Johan25888 ($10 in chips) 
togl63amg: posts small blind $0.05
dpv82: posts big blind $0.10
*** HOLE CARDS ***
NiceMeng joins the table at seat #4 
Johan25888: raises $0.20 to $0.30
kelvinmio: folds 
hubertchen55: calls $0.30
togl63amg: raises $1.10 to $1.40
dpv82: folds 
Johan25888: folds 
hubertchen55: calls $1.10
*** FLOP *** [5h 2d Kh]
togl63amg: bets $1.01
hubertchen55: folds 
Uncalled bet ($1.01) returned to togl63amg
togl63amg collected $3.06 from pot
*** SUMMARY ***
Total pot $3.20 | Rake $0.14 
Board [5h 2d Kh]
Seat 1: kelvinmio folded before Flop (didn't bet)
Seat 2: hubertchen55 (button) folded on the Flop
Seat 3: togl63amg (small blind) collected ($3.06)
Seat 5: dpv82 (big blind) folded before Flop
Seat 6: Johan25888 folded before Flop



PokerStars Hand #201501001564:  Hold'em No Limit ($0.05/$0.10 USD) - 2019/06/18 3:49:27 ET
Table 'Achird' 6-max Seat #1 is the button
Seat 1: kelvinmio ($14.07 in chips) 
Seat 2: hubertchen55 ($10.19 in chips) 
Seat 3: togl63amg ($10.45 in chips) 
Seat 4: NiceMeng ($9.15 in chips) 
Seat 5: M0nzdrik ($10.10 in chips) 
Seat 6: Johan25888 ($10 in chips) 
hubertchen55: posts small blind $0.05
togl63amg: posts big blind $0.10
*** HOLE CARDS ***
NiceMeng: folds 
M0nzdrik: folds 
Johan25888: raises $0.15 to $0.25
kelvinmio: raises $0.50 to $0.75
hubertchen55: folds 
togl63amg: folds 
Johan25888: raises $1.35 to $2.10
kelvinmio: folds 
Uncalled bet ($1.35) returned to Johan25888
Johan25888 collected $1.65 from pot
Johan25888: doesn't show hand 
*** SUMMARY ***
Total pot $1.65 | Rake $0 
Seat 1: kelvinmio (button) folded before Flop
Seat 2: hubertchen55 (small blind) folded before Flop
Seat 3: togl63amg (big blind) folded before Flop
Seat 4: NiceMeng folded before Flop (didn't bet)
Seat 5: M0nzdrik folded before Flop (didn't bet)
Seat 6: Johan25888 collected ($1.65)



PokerStars Hand #201501014318:  Hold'em No Limit ($0.05/$0.10 USD) - 2019/06/18 3:50:31 ET
Table 'Achird' 6-max Seat #2 is the button
Seat 1: kelvinmio ($13.32 in chips) 
Seat 2: hubertchen55 ($10.14 in chips) 
Seat 3: togl63amg ($10.35 in chips) 
Seat 4: NiceMeng ($9.15 in chips) 
Seat 5: M0nzdrik ($10.10 in chips) 
Seat 6: Johan25888 ($10.90 in chips) 
togl63amg: posts small blind $0.05
NiceMeng: posts big blind $0.10
*** HOLE CARDS ***
M0nzdrik: folds 
Johan25888: folds 
kelvinmio: folds 
hubertchen55: calls $0.10
togl63amg: calls $0.05
NiceMeng: checks 
*** FLOP *** [Jd 2h 8h]
togl63amg: checks 
NiceMeng: checks 
hubertchen55: bets $0.29
togl63amg: folds 
NiceMeng: folds 
Uncalled bet ($0.29) returned to hubertchen55
hubertchen55 collected $0.29 from pot
hubertchen55: doesn't show hand 
*** SUMMARY ***
Total pot $0.30 | Rake $0.01 
Board [Jd 2h 8h]
Seat 1: kelvinmio folded before Flop (didn't bet)
Seat 2: hubertchen55 (button) collected ($0.29)
Seat 3: togl63amg (small blind) folded on the Flop
Seat 4: NiceMeng (big blind) folded on the Flop
Seat 5: M0nzdrik folded before Flop (didn't bet)
Seat 6: Johan25888 folded before Flop (didn't bet)



PokerStars Hand #201501022666:  Hold'em No Limit ($0.05/$0.10 USD) - 2019/06/18 3:51:14 ET
Table 'Achird' 6-max Seat #4 is the button
Seat 1: kelvinmio ($13.32 in chips) 
Seat 2: hubertchen55 ($10.33 in chips) 
Seat 3: togl63amg ($10.25 in chips) 
Seat 4: NiceMeng ($9.15 in chips) 
Seat 5: M0nzdrik ($10 in chips) 
M0nzdrik: posts small blind $0.05
Johan25888: is sitting out 
kelvinmio: posts big blind $0.10
*** HOLE CARDS ***
hubertchen55: folds 
togl63amg: folds 
NiceMeng: folds 
M0nzdrik: folds 
Uncalled bet ($0.05) returned to kelvinmio
kelvinmio collected $0.10 from pot
kelvinmio: doesn't show hand 
*** SUMMARY ***
Total pot $0.10 | Rake $0 
Seat 1: kelvinmio (big blind) collected ($0.10)
Seat 2: hubertchen55 folded before Flop (didn't bet)
Seat 3: togl63amg folded before Flop (didn't bet)
Seat 4: NiceMeng (button) folded before Flop (didn't bet)
Seat 5: M0nzdrik (small blind) folded before Flop



PokerStars Hand #201501024393:  Hold'em No Limit ($0.05/$0.10 USD) - 2019/06/18 3:51:22 ET
Table 'Achird' 6-max Seat #5 is the button
Seat 1: kelvinmio ($13.37 in chips) 
Seat 2: hubertchen55 ($10.33 in chips) 
Seat 3: togl63amg ($10.25 in chips) 
Seat 4: NiceMeng ($9.15 in chips) 
Seat 5: M0nzdrik ($10 in chips) 
kelvinmio: posts small blind $0.05
hubertchen55: posts big blind $0.10
*** HOLE CARDS ***
togl63amg: folds 
NiceMeng: folds 
M0nzdrik: folds 
kelvinmio: folds 
Uncalled bet ($0.05) returned to hubertchen55
hubertchen55 collected $0.10 from pot
hubertchen55: doesn't show hand 
*** SUMMARY ***
Total pot $0.10 | Rake $0 
Seat 1: kelvinmio (small blind) folded before Flop
Seat 2: hubertchen55 (big blind) collected ($0.10)
Seat 3: togl63amg folded before Flop (didn't bet)
Seat 4: NiceMeng folded before Flop (didn't bet)
Seat 5: M0nzdrik (button) folded before Flop (didn't bet)



PokerStars Hand #201501026366:  Hold'em No Limit ($0.05/$0.10 USD) - 2019/06/18 3:51:32 ET
Table 'Achird' 6-max Seat #1 is the button
Seat 1: kelvinmio ($13.32 in chips) 
Seat 2: hubertchen55 ($10.38 in chips) 
Seat 3: togl63amg ($10.25 in chips) 
Seat 4: NiceMeng ($9.15 in chips) 
Seat 5: M0nzdrik ($10 in chips) 
hubertchen55: posts small blind $0.05
togl63amg: posts big blind $0.10
*** HOLE CARDS ***
NiceMeng: folds 
M0nzdrik: folds 
kelvinmio: raises $0.20 to $0.30
hubertchen55: folds 
togl63amg: folds 
Uncalled bet ($0.20) returned to kelvinmio
kelvinmio collected $0.25 from pot
*** SUMMARY ***
Total pot $0.25 | Rake $0 
Seat 1: kelvinmio (button) collected ($0.25)
Seat 2: hubertchen55 (small blind) folded before Flop
Seat 3: togl63amg (big blind) folded before Flop
Seat 4: NiceMeng folded before Flop (didn't bet)
Seat 5: M0nzdrik folded before Flop (didn't bet)



PokerStars Hand #201501029150:  Hold'em No Limit ($0.05/$0.10 USD) - 2019/06/18 3:51:46 ET
Table 'Achird' 6-max Seat #2 is the button
Seat 1: kelvinmio ($13.47 in chips) 
Seat 2: hubertchen55 ($10.33 in chips) 
Seat 3: togl63amg ($10.15 in chips) 
Seat 4: NiceMeng ($9.15 in chips) 
Seat 5: M0nzdrik ($10 in chips) 
togl63amg: posts small blind $0.05
NiceMeng: posts big blind $0.10
*** HOLE CARDS ***
M0nzdrik: folds 
kelvinmio: raises $0.20 to $0.30
hubertchen55: raises $0.20 to $0.50
togl63amg: folds 
NiceMeng: folds 
kelvinmio: calls $0.20
*** FLOP *** [Jh Ts Jd]
kelvinmio: checks 
hubertchen55: bets $0.55
kelvinmio: folds 
Uncalled bet ($0.55) returned to hubertchen55
hubertchen55 collected $1.10 from pot
hubertchen55: doesn't show hand 
*** SUMMARY ***
Total pot $1.15 | Rake $0.05 
Board [Jh Ts Jd]
Seat 1: kelvinmio folded on the Flop
Seat 2: hubertchen55 (button) collected ($1.10)
Seat 3: togl63amg (small blind) folded before Flop
Seat 4: NiceMeng (big blind) folded before Flop
Seat 5: M0nzdrik folded before Flop (didn't bet)



PokerStars Hand #201501037514:  Hold'em No Limit ($0.05/$0.10 USD) - 2019/06/18 3:52:29 ET
Table 'Achird' 6-max Seat #3 is the button
Seat 1: kelvinmio ($12.97 in chips) 
Seat 2: hubertchen55 ($10.93 in chips) 
Seat 3: togl63amg ($10.10 in chips) 
Seat 4: NiceMeng ($9.05 in chips) 
Seat 5: M0nzdrik ($10 in chips) 
NiceMeng: posts small blind $0.05
M0nzdrik: posts big blind $0.10
*** HOLE CARDS ***
kelvinmio: folds 
hubertchen55: calls $0.10
togl63amg: raises $0.35 to $0.45
NiceMeng: folds 
M0nzdrik: folds 
hubertchen55: calls $0.35
*** FLOP *** [Jc As 5d]
hubertchen55: bets $0.50
togl63amg: folds 
Uncalled bet ($0.50) returned to hubertchen55
hubertchen55 collected $1 from pot
hubertchen55: doesn't show hand 
*** SUMMARY ***
Total pot $1.05 | Rake $0.05 
Board [Jc As 5d]
Seat 1: kelvinmio folded before Flop (didn't bet)
Seat 2: hubertchen55 collected ($1)
Seat 3: togl63amg (button) folded on the Flop
Seat 4: NiceMeng (small blind) folded before Flop
Seat 5: M0nzdrik (big blind) folded before Flop



PokerStars Hand #201501044243:  Hold'em No Limit ($0.05/$0.10 USD) - 2019/06/18 3:53:03 ET
Table 'Achird' 6-max Seat #4 is the button
Seat 1: kelvinmio ($12.97 in chips) 
Seat 2: hubertchen55 ($11.48 in chips) 
Seat 3: togl63amg ($10 in chips) 
Seat 4: NiceMeng ($9 in chips) 
Seat 5: M0nzdrik ($10 in chips) 
M0nzdrik: posts small blind $0.05
kelvinmio: posts big blind $0.10
*** HOLE CARDS ***
hubertchen55: folds 
togl63amg: folds 
NiceMeng: raises $0.20 to $0.30
M0nzdrik: folds 
kelvinmio: folds 
Uncalled bet ($0.20) returned to NiceMeng
NiceMeng collected $0.25 from pot
NiceMeng: doesn't show hand 
*** SUMMARY ***
Total pot $0.25 | Rake $0 
Seat 1: kelvinmio (big blind) folded before Flop
Seat 2: hubertchen55 folded before Flop (didn't bet)
Seat 3: togl63amg folded before Flop (didn't bet)
Seat 4: NiceMeng (button) collected ($0.25)
Seat 5: M0nzdrik (small blind) folded before Flop



PokerStars Hand #201501048160:  Hold'em No Limit ($0.05/$0.10 USD) - 2019/06/18 3:53:23 ET
Table 'Achird' 6-max Seat #5 is the button
Seat 1: kelvinmio ($12.87 in chips) 
Seat 2: hubertchen55 ($11.48 in chips) 
Seat 3: togl63amg ($10 in chips) 
Seat 4: NiceMeng ($9.15 in chips) 
Seat 5: M0nzdrik ($10 in chips) 
kelvinmio: posts small blind $0.05
hubertchen55: posts big blind $0.10
*** HOLE CARDS ***
togl63amg: raises $0.20 to $0.30
NiceMeng: folds 
M0nzdrik: folds 
kelvinmio: folds 
hubertchen55: folds 
Uncalled bet ($0.20) returned to togl63amg
togl63amg collected $0.25 from pot
*** SUMMARY ***
Total pot $0.25 | Rake $0 
Seat 1: kelvinmio (small blind) folded before Flop
Seat 2: hubertchen55 (big blind) folded before Flop
Seat 3: togl63amg collected ($0.25)
Seat 4: NiceMeng folded before Flop (didn't bet)
Seat 5: M0nzdrik (button) folded before Flop (didn't bet)



PokerStars Hand #201501051858:  Hold'em No Limit ($0.05/$0.10 USD) - 2019/06/18 3:53:41 ET
Table 'Achird' 6-max Seat #1 is the button
Seat 1: kelvinmio ($12.82 in chips) 
Seat 2: hubertchen55 ($11.38 in chips) 
Seat 3: togl63amg ($10.15 in chips) 
Seat 4: NiceMeng ($9.15 in chips) 
Seat 5: M0nzdrik ($10 in chips) 
hubertchen55: posts small blind $0.05
togl63amg: posts big blind $0.10
*** HOLE CARDS ***
NiceMeng: raises $0.20 to $0.30
M0nzdrik: folds 
kelvinmio: folds 
hubertchen55: folds 
togl63amg: calls $0.20
*** FLOP *** [3s Ad 8s]
togl63amg: checks 
NiceMeng: checks 
*** TURN *** [3s Ad 8s] [6d]
togl63amg: checks 
NiceMeng: bets $0.31
togl63amg: folds 
Uncalled bet ($0.31) returned to NiceMeng
NiceMeng collected $0.62 from pot
NiceMeng: doesn't show hand 
*** SUMMARY ***
Total pot $0.65 | Rake $0.03 
Board [3s Ad 8s 6d]
Seat 1: kelvinmio (button) folded before Flop (didn't bet)
Seat 2: hubertchen55 (small blind) folded before Flop
Seat 3: togl63amg (big blind) folded on the Turn
Seat 4: NiceMeng collected ($0.62)
Seat 5: M0nzdrik folded before Flop (didn't bet)



PokerStars Hand #201501059830:  Hold'em No Limit ($0.05/$0.10 USD) - 2019/06/18 3:54:22 ET
Table 'Achird' 6-max Seat #2 is the button
Seat 1: kelvinmio ($12.82 in chips) 
Seat 2: hubertchen55 ($11.33 in chips) 
Seat 3: togl63amg ($10 in chips) 
Seat 4: NiceMeng ($9.47 in chips) 
Seat 5: M0nzdrik ($10 in chips) 
togl63amg: posts small blind $0.05
NiceMeng: posts big blind $0.10
*** HOLE CARDS ***
M0nzdrik: folds 
kelvinmio: raises $0.20 to $0.30
hubertchen55: folds 
togl63amg: folds 
NiceMeng: calls $0.20
*** FLOP *** [Qd 6h 3s]
NiceMeng: checks 
kelvinmio: checks 
*** TURN *** [Qd 6h 3s] [3c]
NiceMeng: checks 
kelvinmio: bets $0.40
NiceMeng: raises $0.80 to $1.20
kelvinmio: calls $0.80
*** RIVER *** [Qd 6h 3s 3c] [2s]
NiceMeng: bets $1.94
kelvinmio: raises $2.86 to $4.80
NiceMeng: folds 
Uncalled bet ($2.86) returned to kelvinmio
kelvinmio collected $6.62 from pot
kelvinmio: doesn't show hand 
*** SUMMARY ***
Total pot $6.93 | Rake $0.31 
Board [Qd 6h 3s 3c 2s]
Seat 1: kelvinmio collected ($6.62)
Seat 2: hubertchen55 (button) folded before Flop (didn't bet)
Seat 3: togl63amg (small blind) folded before Flop
Seat 4: NiceMeng (big blind) folded on the River
Seat 5: M0nzdrik folded before Flop (didn't bet)



PokerStars Hand #201501077079:  Hold'em No Limit ($0.05/$0.10 USD) - 2019/06/18 3:55:54 ET
Table 'Achird' 6-max Seat #3 is the button
Seat 1: kelvinmio ($16 in chips) 
Seat 2: hubertchen55 ($11.33 in chips) 
Seat 3: togl63amg ($10 in chips) 
Seat 4: NiceMeng ($6.03 in chips) 
Seat 5: M0nzdrik ($10 in chips) 
NiceMeng: posts small blind $0.05
M0nzdrik: posts big blind $0.10
Johan25888: sits out 
*** HOLE CARDS ***
kelvinmio: folds 
hubertchen55: calls $0.10
togl63amg: folds 
NiceMeng: folds 
M0nzdrik: checks 
*** FLOP *** [Tc 8s 4h]
kelvinmio leaves the table
M0nzdrik: checks 
DoC.LemOn joins the table at seat #1 
hubertchen55: bets $0.12
M0nzdrik: folds 
Uncalled bet ($0.12) returned to hubertchen55
DoC.LemOn leaves the table
hubertchen55 collected $0.24 from pot
hubertchen55: doesn't show hand 
*** SUMMARY ***
Total pot $0.25 | Rake $0.01 
Board [Tc 8s 4h]
Seat 1: kelvinmio folded before Flop (didn't bet)
Seat 2: hubertchen55 collected ($0.24)
Seat 3: togl63amg (button) folded before Flop (didn't bet)
Seat 4: NiceMeng (small blind) folded before Flop
Seat 5: M0nzdrik (big blind) folded on the Flop



PokerStars Hand #201501080174:  Hold'em No Limit ($0.05/$0.10 USD) - 2019/06/18 3:56:12 ET
Table 'Achird' 6-max Seat #4 is the button
Seat 2: hubertchen55 ($11.47 in chips) 
Seat 3: togl63amg ($10 in chips) 
Seat 4: NiceMeng ($9.98 in chips) 
Seat 5: M0nzdrik ($10 in chips) 
Seat 6: Johan25888 ($10.90 in chips) 
M0nzdrik: posts small blind $0.05
Johan25888: posts big blind $0.10
*** HOLE CARDS ***
hubertchen55: folds 
togl63amg: raises $0.15 to $0.25
NiceMeng: folds 
M0nzdrik: folds 
Johan25888: calls $0.15
*** FLOP *** [Kh 7s 9h]
Johan25888: checks 
togl63amg: bets $0.30
Frol4ik joins the table at seat #1 
Johan25888: raises $0.78 to $1.08
togl63amg: calls $0.78
*** TURN *** [Kh 7s 9h] [8s]
Johan25888: bets $1.89
togl63amg: folds 
Uncalled bet ($1.89) returned to Johan25888
Johan25888 collected $2.59 from pot
Johan25888: doesn't show hand 
*** SUMMARY ***
Total pot $2.71 | Rake $0.12 
Board [Kh 7s 9h 8s]
Seat 2: hubertchen55 folded before Flop (didn't bet)
Seat 3: togl63amg folded on the Turn
Seat 4: NiceMeng (button) folded before Flop (didn't bet)
Seat 5: M0nzdrik (small blind) folded before Flop
Seat 6: Johan25888 (big blind) collected ($2.59)



PokerStars Hand #201501089672:  Hold'em No Limit ($0.05/$0.10 USD) - 2019/06/18 3:57:07 ET
Table 'Achird' 6-max Seat #5 is the button
Seat 1: Frol4ik ($10 in chips) 
Seat 2: hubertchen55 ($11.47 in chips) 
Seat 3: togl63amg ($10 in chips) 
Seat 4: NiceMeng ($9.98 in chips) 
Seat 5: M0nzdrik ($10 in chips) 
Seat 6: Johan25888 ($12.16 in chips) 
Johan25888: posts small blind $0.05
Frol4ik: posts big blind $0.10
*** HOLE CARDS ***
hubertchen55: calls $0.10
togl63amg: folds 
NiceMeng: folds 
M0nzdrik: folds 
Johan25888: folds 
Frol4ik: raises $0.10 to $0.20
hubertchen55: calls $0.10
*** FLOP *** [6d Jc 6c]
Frol4ik: checks 
hubertchen55: bets $0.22
Frol4ik: folds 
Uncalled bet ($0.22) returned to hubertchen55
hubertchen55 collected $0.43 from pot
hubertchen55: doesn't show hand 
*** SUMMARY ***
Total pot $0.45 | Rake $0.02 
Board [6d Jc 6c]
Seat 1: Frol4ik (big blind) folded on the Flop
Seat 2: hubertchen55 collected ($0.43)
Seat 3: togl63amg folded before Flop (didn't bet)
Seat 4: NiceMeng folded before Flop (didn't bet)
Seat 5: M0nzdrik (button) folded before Flop (didn't bet)
Seat 6: Johan25888 (small blind) folded before Flop



PokerStars Hand #201501098043:  Hold'em No Limit ($0.05/$0.10 USD) - 2019/06/18 3:57:54 ET
Table 'Achird' 6-max Seat #6 is the button
Seat 1: Frol4ik ($10 in chips) 
Seat 2: hubertchen55 ($11.70 in chips) 
Seat 3: togl63amg ($10 in chips) 
Seat 4: NiceMeng ($9.98 in chips) 
Seat 5: M0nzdrik ($10 in chips) 
Seat 6: Johan25888 ($12.11 in chips) 
Frol4ik: posts small blind $0.05
hubertchen55: posts big blind $0.10
*** HOLE CARDS ***
togl63amg: folds 
NiceMeng: folds 
M0nzdrik: folds 
Johan25888: raises $0.15 to $0.25
Frol4ik: folds 
hubertchen55: folds 
Uncalled bet ($0.15) returned to Johan25888
Johan25888 collected $0.25 from pot
Johan25888: doesn't show hand 
*** SUMMARY ***
Total pot $0.25 | Rake $0 
Seat 1: Frol4ik (small blind) folded before Flop
Seat 2: hubertchen55 (big blind) folded before Flop
Seat 3: togl63amg folded before Flop (didn't bet)
Seat 4: NiceMeng folded before Flop (didn't bet)
Seat 5: M0nzdrik folded before Flop (didn't bet)
Seat 6: Johan25888 (button) collected ($0.25)



PokerStars Hand #201501100263:  Hold'em No Limit ($0.05/$0.10 USD) - 2019/06/18 3:58:07 ET
Table 'Achird' 6-max Seat #1 is the button
Seat 1: Frol4ik ($10 in chips) 
Seat 2: hubertchen55 ($11.60 in chips) 
Seat 3: togl63amg ($10 in chips) 
Seat 4: NiceMeng ($9.98 in chips) 
Seat 5: M0nzdrik ($10 in chips) 
Seat 6: Johan25888 ($12.26 in chips) 
hubertchen55: posts small blind $0.05
togl63amg: posts big blind $0.10
*** HOLE CARDS ***
NiceMeng: raises $0.20 to $0.30
M0nzdrik: folds 
Johan25888: folds 
Frol4ik: folds 
hubertchen55: folds 
togl63amg: folds 
Uncalled bet ($0.20) returned to NiceMeng
NiceMeng collected $0.25 from pot
NiceMeng: doesn't show hand 
*** SUMMARY ***
Total pot $0.25 | Rake $0 
Seat 1: Frol4ik (button) folded before Flop (didn't bet)
Seat 2: hubertchen55 (small blind) folded before Flop
Seat 3: togl63amg (big blind) folded before Flop
Seat 4: NiceMeng collected ($0.25)
Seat 5: M0nzdrik folded before Flop (didn't bet)
Seat 6: Johan25888 folded before Flop (didn't bet)



PokerStars Hand #201501103953:  Hold'em No Limit ($0.05/$0.10 USD) - 2019/06/18 3:58:28 ET
Table 'Achird' 6-max Seat #2 is the button
Seat 1: Frol4ik ($10 in chips) 
Seat 2: hubertchen55 ($11.55 in chips) 
Seat 3: togl63amg ($10 in chips) 
Seat 4: NiceMeng ($10.13 in chips) 
Seat 5: M0nzdrik ($10 in chips) 
Seat 6: Johan25888 ($12.26 in chips) 
togl63amg: posts small blind $0.05
NiceMeng: posts big blind $0.10
*** HOLE CARDS ***
M0nzdrik: raises $0.20 to $0.30
Johan25888: folds 
Frol4ik: folds 
hubertchen55: folds 
togl63amg: folds 
NiceMeng: folds 
Uncalled bet ($0.20) returned to M0nzdrik
M0nzdrik collected $0.25 from pot
*** SUMMARY ***
Total pot $0.25 | Rake $0 
Seat 1: Frol4ik folded before Flop (didn't bet)
Seat 2: hubertchen55 (button) folded before Flop (didn't bet)
Seat 3: togl63amg (small blind) folded before Flop
Seat 4: NiceMeng (big blind) folded before Flop
Seat 5: M0nzdrik collected ($0.25)
Seat 6: Johan25888 folded before Flop (didn't bet)



PokerStars Hand #201501106412:  Hold'em No Limit ($0.05/$0.10 USD) - 2019/06/18 3:58:42 ET
Table 'Achird' 6-max Seat #3 is the button
Seat 1: Frol4ik ($10 in chips) 
Seat 2: hubertchen55 ($11.55 in chips) 
Seat 3: togl63amg ($10 in chips) 
Seat 4: NiceMeng ($10.03 in chips) 
Seat 5: M0nzdrik ($10.15 in chips) 
Seat 6: Johan25888 ($12.26 in chips) 
NiceMeng: posts small blind $0.05
M0nzdrik: posts big blind $0.10
*** HOLE CARDS ***
Johan25888: folds 
Frol4ik: folds 
hubertchen55: folds 
togl63amg: raises $0.15 to $0.25
NiceMeng: folds 
M0nzdrik: folds 
Uncalled bet ($0.15) returned to togl63amg
togl63amg collected $0.25 from pot
*** SUMMARY ***
Total pot $0.25 | Rake $0 
Seat 1: Frol4ik folded before Flop (didn't bet)
Seat 2: hubertchen55 folded before Flop (didn't bet)
Seat 3: togl63amg (button) collected ($0.25)
Seat 4: NiceMeng (small blind) folded before Flop
Seat 5: M0nzdrik (big blind) folded before Flop
Seat 6: Johan25888 folded before Flop (didn't bet)



PokerStars Hand #201501112500:  Hold'em No Limit ($0.05/$0.10 USD) - 2019/06/18 3:59:15 ET
Table 'Achird' 6-max Seat #4 is the button
Seat 1: Frol4ik ($10 in chips) 
Seat 2: hubertchen55 ($11.55 in chips) 
Seat 3: togl63amg ($10.15 in chips) 
Seat 4: NiceMeng ($9.98 in chips) 
Seat 5: M0nzdrik ($10.05 in chips) 
Seat 6: Johan25888 ($12.26 in chips) 
M0nzdrik: posts small blind $0.05
Johan25888: posts big blind $0.10
*** HOLE CARDS ***
Frol4ik: folds 
hubertchen55: folds 
togl63amg: folds 
NiceMeng: folds 
Frol4ik leaves the table
M0nzdrik: folds 
Uncalled bet ($0.05) returned to Johan25888
Demokhrit joins the table at seat #1 
Johan25888 collected $0.10 from pot
Johan25888: doesn't show hand 
*** SUMMARY ***
Total pot $0.10 | Rake $0 
Seat 1: Frol4ik folded before Flop (didn't bet)
Seat 2: hubertchen55 folded before Flop (didn't bet)
Seat 3: togl63amg folded before Flop (didn't bet)
Seat 4: NiceMeng (button) folded before Flop (didn't bet)
Seat 5: M0nzdrik (small blind) folded before Flop
Seat 6: Johan25888 (big blind) collected ($0.10)



PokerStars Hand #201501115205:  Hold'em No Limit ($0.05/$0.10 USD) - 2019/06/18 3:59:31 ET
Table 'Achird' 6-max Seat #5 is the button
Seat 2: hubertchen55 ($11.55 in chips) 
Seat 3: togl63amg ($10.15 in chips) 
Seat 4: NiceMeng ($9.98 in chips) 
Seat 5: M0nzdrik ($10 in chips) 
Seat 6: Johan25888 ($12.31 in chips) 
Johan25888: posts small blind $0.05
hubertchen55: posts big blind $0.10
*** HOLE CARDS ***
togl63amg: folds 
NiceMeng: folds 
M0nzdrik: raises $0.13 to $0.23
Johan25888: folds 
Demokhrit leaves the table
hubertchen55: calls $0.13
*** FLOP *** [Jd As 4s]
hubertchen55: bets $0.10
M0nzdrik: calls $0.10
*** TURN *** [Jd As 4s] [Qd]
hubertchen55: bets $0.10
M0nzdrik: calls $0.10
*** RIVER *** [Jd As 4s Qd] [3d]
hubertchen55: bets $0.10
M0nzdrik: folds 
Uncalled bet ($0.10) returned to hubertchen55
hubertchen55 collected $0.87 from pot
hubertchen55: doesn't show hand 
*** SUMMARY ***
Total pot $0.91 | Rake $0.04 
Board [Jd As 4s Qd 3d]
Seat 2: hubertchen55 (big blind) collected ($0.87)
Seat 3: togl63amg folded before Flop (didn't bet)
Seat 4: NiceMeng folded before Flop (didn't bet)
Seat 5: M0nzdrik (button) folded on the River
Seat 6: Johan25888 (small blind) folded before Flop



PokerStars Hand #201501123354:  Hold'em No Limit ($0.05/$0.10 USD) - 2019/06/18 4:00:16 ET
Table 'Achird' 6-max Seat #6 is the button
Seat 2: hubertchen55 ($11.99 in chips) 
Seat 3: togl63amg ($10.15 in chips) 
Seat 4: NiceMeng ($9.98 in chips) 
Seat 5: M0nzdrik ($10 in chips) 
Seat 6: Johan25888 ($12.26 in chips) 
hubertchen55: posts small blind $0.05
togl63amg: posts big blind $0.10
*** HOLE CARDS ***
ray691027 joins the table at seat #1 
NiceMeng: folds 
M0nzdrik: raises $0.20 to $0.30
Johan25888: folds 
hubertchen55: folds 
togl63amg: folds 
Uncalled bet ($0.20) returned to M0nzdrik
M0nzdrik collected $0.25 from pot
M0nzdrik: doesn't show hand 
*** SUMMARY ***
Total pot $0.25 | Rake $0 
Seat 2: hubertchen55 (small blind) folded before Flop
Seat 3: togl63amg (big blind) folded before Flop
Seat 4: NiceMeng folded before Flop (didn't bet)
Seat 5: M0nzdrik collected ($0.25)
Seat 6: Johan25888 (button) folded before Flop (didn't bet)



PokerStars Hand #201501127508:  Hold'em No Limit ($0.05/$0.10 USD) - 2019/06/18 4:00:39 ET
Table 'Achird' 6-max Seat #2 is the button
Seat 2: hubertchen55 ($11.94 in chips) 
Seat 3: togl63amg ($10.05 in chips) 
Seat 4: NiceMeng ($9.98 in chips) 
Seat 5: M0nzdrik ($10.15 in chips) 
Seat 6: Johan25888 ($12.26 in chips) 
togl63amg: posts small blind $0.05
NiceMeng: posts big blind $0.10
ray691027: sits out 
*** HOLE CARDS ***
M0nzdrik: folds 
Johan25888: folds 
hubertchen55: folds 
togl63amg: folds 
Uncalled bet ($0.05) returned to NiceMeng
NiceMeng collected $0.10 from pot
NiceMeng: doesn't show hand 
*** SUMMARY ***
Total pot $0.10 | Rake $0 
Seat 2: hubertchen55 (button) folded before Flop (didn't bet)
Seat 3: togl63amg (small blind) folded before Flop
Seat 4: NiceMeng (big blind) collected ($0.10)
Seat 5: M0nzdrik folded before Flop (didn't bet)
Seat 6: Johan25888 folded before Flop (didn't bet)



PokerStars Hand #201501128906:  Hold'em No Limit ($0.05/$0.10 USD) - 2019/06/18 4:00:46 ET
Table 'Achird' 6-max Seat #3 is the button
Seat 2: hubertchen55 ($11.94 in chips) 
Seat 3: togl63amg ($10 in chips) 
Seat 4: NiceMeng ($10.03 in chips) 
Seat 5: M0nzdrik ($10.15 in chips) 
Seat 6: Johan25888 ($12.26 in chips) 
NiceMeng: posts small blind $0.05
M0nzdrik: posts big blind $0.10
ray691027: sits out 
*** HOLE CARDS ***
Johan25888: folds 
hubertchen55: folds 
togl63amg: folds 
NiceMeng: raises $0.20 to $0.30
M0nzdrik: folds 
Uncalled bet ($0.20) returned to NiceMeng
NiceMeng collected $0.20 from pot
NiceMeng: doesn't show hand 
*** SUMMARY ***
Total pot $0.20 | Rake $0 
Seat 2: hubertchen55 folded before Flop (didn't bet)
Seat 3: togl63amg (button) folded before Flop (didn't bet)
Seat 4: NiceMeng (small blind) collected ($0.20)
Seat 5: M0nzdrik (big blind) folded before Flop
Seat 6: Johan25888 folded before Flop (didn't bet)



PokerStars Hand #201501133677:  Hold'em No Limit ($0.05/$0.10 USD) - 2019/06/18 4:01:11 ET
Table 'Achird' 6-max Seat #4 is the button
Seat 2: hubertchen55 ($11.94 in chips) 
Seat 3: togl63amg ($10 in chips) 
Seat 4: NiceMeng ($10.13 in chips) 
Seat 5: M0nzdrik ($10.05 in chips) 
Seat 6: Johan25888 ($12.26 in chips) 
M0nzdrik: posts small blind $0.05
Johan25888: posts big blind $0.10
ray691027: sits out 
*** HOLE CARDS ***
hubertchen55: folds 
togl63amg: folds 
NiceMeng: folds 
M0nzdrik: folds 
Uncalled bet ($0.05) returned to Johan25888
Johan25888 collected $0.10 from pot
Johan25888: doesn't show hand 
*** SUMMARY ***
Total pot $0.10 | Rake $0 
Seat 2: hubertchen55 folded before Flop (didn't bet)
Seat 3: togl63amg folded before Flop (didn't bet)
Seat 4: NiceMeng (button) folded before Flop (didn't bet)
Seat 5: M0nzdrik (small blind) folded before Flop
Seat 6: Johan25888 (big blind) collected ($0.10)



PokerStars Hand #201501137119:  Hold'em No Limit ($0.05/$0.10 USD) - 2019/06/18 4:01:28 ET
Table 'Achird' 6-max Seat #5 is the button
Seat 1: ray691027 ($10 in chips) 
Seat 2: hubertchen55 ($11.94 in chips) 
Seat 3: togl63amg ($10 in chips) 
Seat 4: NiceMeng ($10.13 in chips) 
Seat 5: M0nzdrik ($10 in chips) 
Seat 6: Johan25888 ($12.31 in chips) 
Johan25888: posts small blind $0.05
ray691027: posts big blind $0.10
*** HOLE CARDS ***
hubertchen55: calls $0.10
togl63amg: folds 
NiceMeng: folds 
M0nzdrik: folds 
Johan25888: folds 
ray691027: checks 
*** FLOP *** [As Ah 7h]
ray691027: checks 
hubertchen55: bets $0.24
ray691027: raises $0.36 to $0.60
hubertchen55: folds 
Uncalled bet ($0.36) returned to ray691027
ray691027 collected $0.70 from pot
ray691027: doesn't show hand 
*** SUMMARY ***
Total pot $0.73 | Rake $0.03 
Board [As Ah 7h]
Seat 1: ray691027 (big blind) collected ($0.70)
Seat 2: hubertchen55 folded on the Flop
Seat 3: togl63amg folded before Flop (didn't bet)
Seat 4: NiceMeng folded before Flop (didn't bet)
Seat 5: M0nzdrik (button) folded before Flop (didn't bet)
Seat 6: Johan25888 (small blind) folded before Flop



PokerStars Hand #201501144136:  Hold'em No Limit ($0.05/$0.10 USD) - 2019/06/18 4:02:03 ET
Table 'Achird' 6-max Seat #6 is the button
Seat 1: ray691027 ($10.36 in chips) 
Seat 2: hubertchen55 ($11.60 in chips) 
Seat 3: togl63amg ($10 in chips) 
Seat 4: NiceMeng ($10.13 in chips) 
Seat 5: M0nzdrik ($10 in chips) 
Seat 6: Johan25888 ($12.26 in chips) 
ray691027: posts small blind $0.05
hubertchen55: posts big blind $0.10
*** HOLE CARDS ***
togl63amg: folds 
NiceMeng has timed out
NiceMeng: folds 
M0nzdrik: folds 
Johan25888: folds 
ray691027: calls $0.05
hubertchen55: checks 
*** FLOP *** [4h 5h Td]
ray691027: bets $0.10
hubertchen55: calls $0.10
*** TURN *** [4h 5h Td] [Tc]
ray691027: bets $0.10
hubertchen55: calls $0.10
*** RIVER *** [4h 5h Td Tc] [Jc]
ray691027: bets $0.20
hubertchen55: folds 
Uncalled bet ($0.20) returned to ray691027
ray691027 collected $0.57 from pot
ray691027: doesn't show hand 
*** SUMMARY ***
Total pot $0.60 | Rake $0.03 
Board [4h 5h Td Tc Jc]
Seat 1: ray691027 (small blind) collected ($0.57)
Seat 2: hubertchen55 (big blind) folded on the River
Seat 3: togl63amg folded before Flop (didn't bet)
Seat 4: NiceMeng folded before Flop (didn't bet)
Seat 5: M0nzdrik folded before Flop (didn't bet)
Seat 6: Johan25888 (button) folded before Flop (didn't bet)



PokerStars Hand #201501154559:  Hold'em No Limit ($0.05/$0.10 USD) - 2019/06/18 4:02:56 ET
Table 'Achird' 6-max Seat #1 is the button
Seat 1: ray691027 ($10.63 in chips) 
Seat 2: hubertchen55 ($11.30 in chips) 
Seat 3: togl63amg ($10 in chips) 
Seat 4: NiceMeng ($10.13 in chips) 
Seat 5: M0nzdrik ($10 in chips) 
Seat 6: Johan25888 ($12.26 in chips) 
hubertchen55: posts small blind $0.05
togl63amg: posts big blind $0.10
*** HOLE CARDS ***
NiceMeng: folds 
M0nzdrik: folds 
Johan25888: folds 
ray691027: folds 
hubertchen55: calls $0.05
togl63amg: raises $0.30 to $0.40
hubertchen55: folds 
Uncalled bet ($0.30) returned to togl63amg
togl63amg collected $0.20 from pot
*** SUMMARY ***
Total pot $0.20 | Rake $0 
Seat 1: ray691027 (button) folded before Flop (didn't bet)
Seat 2: hubertchen55 (small blind) folded before Flop
Seat 3: togl63amg (big blind) collected ($0.20)
Seat 4: NiceMeng folded before Flop (didn't bet)
Seat 5: M0nzdrik folded before Flop (didn't bet)
Seat 6: Johan25888 folded before Flop (didn't bet)



PokerStars Hand #201501159147:  Hold'em No Limit ($0.05/$0.10 USD) - 2019/06/18 4:03:18 ET
Table 'Achird' 6-max Seat #2 is the button
Seat 1: ray691027 ($10.63 in chips) 
Seat 2: hubertchen55 ($11.20 in chips) 
Seat 3: togl63amg ($10.10 in chips) 
Seat 4: NiceMeng ($10.13 in chips) 
Seat 5: M0nzdrik ($10 in chips) 
Seat 6: Johan25888 ($12.26 in chips) 
togl63amg: posts small blind $0.05
NiceMeng: posts big blind $0.10
*** HOLE CARDS ***
M0nzdrik: folds 
Johan25888: folds 
ray691027: folds 
hubertchen55: raises $0.10 to $0.20
togl63amg: folds 
NiceMeng: calls $0.10
*** FLOP *** [Ah 6c Kd]
NiceMeng: checks 
hubertchen55: checks 
*** TURN *** [Ah 6c Kd] [8h]
NiceMeng: checks 
hubertchen55: checks 
*** RIVER *** [Ah 6c Kd 8h] [5h]
NiceMeng: checks 
hubertchen55: checks 
*** SHOW DOWN ***
NiceMeng: shows [3s 5d] (a pair of Fives)
hubertchen55: shows [Qc Qh] (a pair of Queens)
hubertchen55 collected $0.43 from pot
*** SUMMARY ***
Total pot $0.45 | Rake $0.02 
Board [Ah 6c Kd 8h 5h]
Seat 1: ray691027 folded before Flop (didn't bet)
Seat 2: hubertchen55 (button) showed [Qc Qh] and won ($0.43) with a pair of Queens
Seat 3: togl63amg (small blind) folded before Flop
Seat 4: NiceMeng (big blind) showed [3s 5d] and lost with a pair of Fives
Seat 5: M0nzdrik folded before Flop (didn't bet)
Seat 6: Johan25888 folded before Flop (didn't bet)



PokerStars Hand #201501164389:  Hold'em No Limit ($0.05/$0.10 USD) - 2019/06/18 4:03:44 ET
Table 'Achird' 6-max Seat #3 is the button
Seat 1: ray691027 ($10.63 in chips) 
Seat 2: hubertchen55 ($11.43 in chips) 
Seat 3: togl63amg ($10.05 in chips) 
Seat 4: NiceMeng ($9.93 in chips) 
Seat 5: M0nzdrik ($10 in chips) 
Seat 6: Johan25888 ($12.26 in chips) 
NiceMeng: posts small blind $0.05
M0nzdrik: posts big blind $0.10
*** HOLE CARDS ***
Johan25888: raises $0.20 to $0.30
ray691027: folds 
hubertchen55: folds 
togl63amg: folds 
NiceMeng: folds 
M0nzdrik: folds 
Uncalled bet ($0.20) returned to Johan25888
Johan25888 collected $0.25 from pot
Johan25888: doesn't show hand 
*** SUMMARY ***
Total pot $0.25 | Rake $0 
Seat 1: ray691027 folded before Flop (didn't bet)
Seat 2: hubertchen55 folded before Flop (didn't bet)
Seat 3: togl63amg (button) folded before Flop (didn't bet)
Seat 4: NiceMeng (small blind) folded before Flop
Seat 5: M0nzdrik (big blind) folded before Flop
Seat 6: Johan25888 collected ($0.25)



PokerStars Hand #201501167827:  Hold'em No Limit ($0.05/$0.10 USD) - 2019/06/18 4:04:01 ET
Table 'Achird' 6-max Seat #4 is the button
Seat 1: ray691027 ($10.63 in chips) 
Seat 2: hubertchen55 ($11.43 in chips) 
Seat 3: togl63amg ($10.05 in chips) 
Seat 4: NiceMeng ($9.88 in chips) 
Seat 5: M0nzdrik ($10 in chips) 
Seat 6: Johan25888 ($12.41 in chips) 
M0nzdrik: posts small blind $0.05
Johan25888: posts big blind $0.10
*** HOLE CARDS ***
ray691027: folds 
hubertchen55: raises $0.25 to $0.35
togl63amg: calls $0.35
NiceMeng: folds 
M0nzdrik: calls $0.30
Johan25888: folds 
*** FLOP *** [9c 4h 2h]
M0nzdrik: checks 
hubertchen55: checks 
togl63amg: bets $0.44
M0nzdrik: folds 
hubertchen55: folds 
Uncalled bet ($0.44) returned to togl63amg
togl63amg collected $1.10 from pot
*** SUMMARY ***
Total pot $1.15 | Rake $0.05 
Board [9c 4h 2h]
Seat 1: ray691027 folded before Flop (didn't bet)
Seat 2: hubertchen55 folded on the Flop
Seat 3: togl63amg collected ($1.10)
Seat 4: NiceMeng (button) folded before Flop (didn't bet)
Seat 5: M0nzdrik (small blind) folded on the Flop
Seat 6: Johan25888 (big blind) folded before Flop



PokerStars Hand #201501174162:  Hold'em No Limit ($0.05/$0.10 USD) - 2019/06/18 4:04:33 ET
Table 'Achird' 6-max Seat #5 is the button
Seat 1: ray691027 ($10.63 in chips) 
Seat 2: hubertchen55 ($11.08 in chips) 
Seat 3: togl63amg ($10.80 in chips) 
Seat 4: NiceMeng ($9.88 in chips) 
Seat 5: M0nzdrik ($10 in chips) 
Seat 6: Johan25888 ($12.31 in chips) 
Johan25888: posts small blind $0.05
ray691027: posts big blind $0.10
*** HOLE CARDS ***
hubertchen55: calls $0.10
togl63amg: folds 
NiceMeng: folds 
M0nzdrik: raises $0.30 to $0.40
Johan25888: folds 
ray691027: folds 
hubertchen55: calls $0.30
*** FLOP *** [8s 8d 4h]
hubertchen55: checks 
M0nzdrik: bets $0.48
hubertchen55: folds 
Uncalled bet ($0.48) returned to M0nzdrik
M0nzdrik collected $0.91 from pot
*** SUMMARY ***
Total pot $0.95 | Rake $0.04 
Board [8s 8d 4h]
Seat 1: ray691027 (big blind) folded before Flop
Seat 2: hubertchen55 folded on the Flop
Seat 3: togl63amg folded before Flop (didn't bet)
Seat 4: NiceMeng folded before Flop (didn't bet)
Seat 5: M0nzdrik (button) collected ($0.91)
Seat 6: Johan25888 (small blind) folded before Flop



PokerStars Hand #201501180686:  Hold'em No Limit ($0.05/$0.10 USD) - 2019/06/18 4:05:05 ET
Table 'Achird' 6-max Seat #6 is the button
Seat 1: ray691027 ($10.53 in chips) 
Seat 2: hubertchen55 ($10.68 in chips) 
Seat 3: togl63amg ($10.80 in chips) 
Seat 4: NiceMeng ($9.88 in chips) 
Seat 5: M0nzdrik ($10.51 in chips) 
Seat 6: Johan25888 ($12.26 in chips) 
ray691027: posts small blind $0.05
hubertchen55: posts big blind $0.10
*** HOLE CARDS ***
togl63amg: folds 
NiceMeng: raises $0.20 to $0.30
M0nzdrik: folds 
Johan25888: folds 
ray691027: folds 
hubertchen55: calls $0.20
*** FLOP *** [7h Js 8c]
hubertchen55: checks 
NiceMeng: checks 
*** TURN *** [7h Js 8c] [6c]
hubertchen55: checks 
NiceMeng: checks 
*** RIVER *** [7h Js 8c 6c] [Ah]
hubertchen55: bets $0.10
NiceMeng: raises $0.41 to $0.51
hubertchen55: calls $0.41
*** SHOW DOWN ***
NiceMeng: shows [Ks Qs] (high card Ace)
hubertchen55: shows [As 4d] (a pair of Aces)
hubertchen55 collected $1.59 from pot
*** SUMMARY ***
Total pot $1.67 | Rake $0.08 
Board [7h Js 8c 6c Ah]
Seat 1: ray691027 (small blind) folded before Flop
Seat 2: hubertchen55 (big blind) showed [As 4d] and won ($1.59) with a pair of Aces
Seat 3: togl63amg folded before Flop (didn't bet)
Seat 4: NiceMeng showed [Ks Qs] and lost with high card Ace
Seat 5: M0nzdrik folded before Flop (didn't bet)
Seat 6: Johan25888 (button) folded before Flop (didn't bet)



PokerStars Hand #201501188094:  Hold'em No Limit ($0.05/$0.10 USD) - 2019/06/18 4:05:41 ET
Table 'Achird' 6-max Seat #1 is the button
Seat 1: ray691027 ($10.48 in chips) 
Seat 2: hubertchen55 ($11.46 in chips) 
Seat 3: togl63amg ($10.80 in chips) 
Seat 4: NiceMeng ($9.07 in chips) 
Seat 5: M0nzdrik ($10.51 in chips) 
Seat 6: Johan25888 ($12.26 in chips) 
hubertchen55: posts small blind $0.05
togl63amg: posts big blind $0.10
*** HOLE CARDS ***
NiceMeng: folds 
M0nzdrik: folds 
Johan25888: raises $0.15 to $0.25
ray691027: folds 
hubertchen55: calls $0.20
togl63amg: calls $0.15
*** FLOP *** [Js Kd 9c]
hubertchen55: checks 
togl63amg: checks 
Johan25888: checks 
*** TURN *** [Js Kd 9c] [As]
hubertchen55: checks 
togl63amg: checks 
Johan25888: bets $0.50
hubertchen55: folds 
togl63amg: folds 
Uncalled bet ($0.50) returned to Johan25888
Johan25888 collected $0.72 from pot
Johan25888: doesn't show hand 
*** SUMMARY ***
Total pot $0.75 | Rake $0.03 
Board [Js Kd 9c As]
Seat 1: ray691027 (button) folded before Flop (didn't bet)
Seat 2: hubertchen55 (small blind) folded on the Turn
Seat 3: togl63amg (big blind) folded on the Turn
Seat 4: NiceMeng folded before Flop (didn't bet)
Seat 5: M0nzdrik folded before Flop (didn't bet)
Seat 6: Johan25888 collected ($0.72)



PokerStars Hand #201501201259:  Hold'em No Limit ($0.05/$0.10 USD) - 2019/06/18 4:06:45 ET
Table 'Achird' 6-max Seat #2 is the button
Seat 1: ray691027 ($10.48 in chips) 
Seat 2: hubertchen55 ($11.21 in chips) 
Seat 3: togl63amg ($10.55 in chips) 
Seat 4: NiceMeng ($9.07 in chips) 
Seat 5: M0nzdrik ($10.51 in chips) 
Seat 6: Johan25888 ($12.73 in chips) 
togl63amg: posts small blind $0.05
NiceMeng: posts big blind $0.10
*** HOLE CARDS ***
M0nzdrik: folds 
Johan25888: raises $0.20 to $0.30
ray691027: folds 
hubertchen55: folds 
togl63amg: folds 
NiceMeng: folds 
Uncalled bet ($0.20) returned to Johan25888
Johan25888 collected $0.25 from pot
Johan25888: doesn't show hand 
*** SUMMARY ***
Total pot $0.25 | Rake $0 
Seat 1: ray691027 folded before Flop (didn't bet)
Seat 2: hubertchen55 (button) folded before Flop (didn't bet)
Seat 3: togl63amg (small blind) folded before Flop
Seat 4: NiceMeng (big blind) folded before Flop
Seat 5: M0nzdrik folded before Flop (didn't bet)
Seat 6: Johan25888 collected ($0.25)



PokerStars Hand #201501205179:  Hold'em No Limit ($0.05/$0.10 USD) - 2019/06/18 4:07:04 ET
Table 'Achird' 6-max Seat #3 is the button
Seat 1: ray691027 ($10.48 in chips) 
Seat 2: hubertchen55 ($11.21 in chips) 
Seat 3: togl63amg ($10.50 in chips) 
Seat 4: NiceMeng ($8.97 in chips) 
Seat 5: M0nzdrik ($10.51 in chips) 
Seat 6: Johan25888 ($12.88 in chips) 
NiceMeng: posts small blind $0.05
M0nzdrik: posts big blind $0.10
*** HOLE CARDS ***
Johan25888: folds 
ray691027: folds 
hubertchen55: folds 
togl63amg: folds 
NiceMeng: folds 
Uncalled bet ($0.05) returned to M0nzdrik
M0nzdrik collected $0.10 from pot
*** SUMMARY ***
Total pot $0.10 | Rake $0 
Seat 1: ray691027 folded before Flop (didn't bet)
Seat 2: hubertchen55 folded before Flop (didn't bet)
Seat 3: togl63amg (button) folded before Flop (didn't bet)
Seat 4: NiceMeng (small blind) folded before Flop
Seat 5: M0nzdrik (big blind) collected ($0.10)
Seat 6: Johan25888 folded before Flop (didn't bet)



PokerStars Hand #201501207227:  Hold'em No Limit ($0.05/$0.10 USD) - 2019/06/18 4:07:15 ET
Table 'Achird' 6-max Seat #4 is the button
Seat 1: ray691027 ($10.48 in chips) 
Seat 2: hubertchen55 ($11.21 in chips) 
Seat 3: togl63amg ($10.50 in chips) 
Seat 4: NiceMeng ($8.92 in chips) 
Seat 5: M0nzdrik ($10.56 in chips) 
Seat 6: Johan25888 ($12.88 in chips) 
M0nzdrik: posts small blind $0.05
Johan25888: posts big blind $0.10
*** HOLE CARDS ***
ray691027: folds 
hubertchen55: folds 
togl63amg: folds 
NiceMeng: folds 
M0nzdrik: folds 
Uncalled bet ($0.05) returned to Johan25888
Johan25888 collected $0.10 from pot
Johan25888: doesn't show hand 
*** SUMMARY ***
Total pot $0.10 | Rake $0 
Seat 1: ray691027 folded before Flop (didn't bet)
Seat 2: hubertchen55 folded before Flop (didn't bet)
Seat 3: togl63amg folded before Flop (didn't bet)
Seat 4: NiceMeng (button) folded before Flop (didn't bet)
Seat 5: M0nzdrik (small blind) folded before Flop
Seat 6: Johan25888 (big blind) collected ($0.10)



PokerStars Hand #201501211119:  Hold'em No Limit ($0.05/$0.10 USD) - 2019/06/18 4:07:34 ET
Table 'Achird' 6-max Seat #5 is the button
Seat 1: ray691027 ($10.48 in chips) 
Seat 2: hubertchen55 ($11.21 in chips) 
Seat 3: togl63amg ($10.50 in chips) 
Seat 4: NiceMeng ($8.92 in chips) 
Seat 5: M0nzdrik ($10.51 in chips) 
Seat 6: Johan25888 ($12.93 in chips) 
Johan25888: posts small blind $0.05
ray691027: posts big blind $0.10
*** HOLE CARDS ***
hubertchen55: folds 
togl63amg: folds 
NiceMeng: folds 
M0nzdrik: folds 
Johan25888: folds 
Uncalled bet ($0.05) returned to ray691027
ray691027 collected $0.10 from pot
*** SUMMARY ***
Total pot $0.10 | Rake $0 
Seat 1: ray691027 (big blind) collected ($0.10)
Seat 2: hubertchen55 folded before Flop (didn't bet)
Seat 3: togl63amg folded before Flop (didn't bet)
Seat 4: NiceMeng folded before Flop (didn't bet)
Seat 5: M0nzdrik (button) folded before Flop (didn't bet)
Seat 6: Johan25888 (small blind) folded before Flop



PokerStars Hand #201501214934:  Hold'em No Limit ($0.05/$0.10 USD) - 2019/06/18 4:07:53 ET
Table 'Achird' 6-max Seat #6 is the button
Seat 1: ray691027 ($10.53 in chips) 
Seat 2: hubertchen55 ($11.21 in chips) 
Seat 3: togl63amg ($10.50 in chips) 
Seat 4: NiceMeng ($8.92 in chips) 
Seat 5: M0nzdrik ($10.51 in chips) 
Seat 6: Johan25888 ($12.88 in chips) 
ray691027: posts small blind $0.05
hubertchen55: posts big blind $0.10
*** HOLE CARDS ***
togl63amg: folds 
NiceMeng: folds 
M0nzdrik: raises $0.15 to $0.25
Johan25888: folds 
ray691027: folds 
hubertchen55: folds 
Uncalled bet ($0.15) returned to M0nzdrik
M0nzdrik collected $0.25 from pot
M0nzdrik: doesn't show hand 
*** SUMMARY ***
Total pot $0.25 | Rake $0 
Seat 1: ray691027 (small blind) folded before Flop
Seat 2: hubertchen55 (big blind) folded before Flop
Seat 3: togl63amg folded before Flop (didn't bet)
Seat 4: NiceMeng folded before Flop (didn't bet)
Seat 5: M0nzdrik collected ($0.25)
Seat 6: Johan25888 (button) folded before Flop (didn't bet)



PokerStars Hand #201501218538:  Hold'em No Limit ($0.05/$0.10 USD) - 2019/06/18 4:08:10 ET
Table 'Achird' 6-max Seat #1 is the button
Seat 1: ray691027 ($10.48 in chips) 
Seat 2: hubertchen55 ($11.11 in chips) 
Seat 3: togl63amg ($10.50 in chips) 
Seat 4: NiceMeng ($8.92 in chips) 
Seat 5: M0nzdrik ($10.66 in chips) 
Seat 6: Johan25888 ($12.88 in chips) 
hubertchen55: posts small blind $0.05
togl63amg: posts big blind $0.10
*** HOLE CARDS ***
NiceMeng: folds 
M0nzdrik: folds 
Johan25888: folds 
ray691027: folds 
hubertchen55: calls $0.05
togl63amg: checks 
*** FLOP *** [Qd 4d Jc]
hubertchen55: bets $0.19
togl63amg: folds 
Uncalled bet ($0.19) returned to hubertchen55
hubertchen55 collected $0.19 from pot
hubertchen55: doesn't show hand 
*** SUMMARY ***
Total pot $0.20 | Rake $0.01 
Board [Qd 4d Jc]
Seat 1: ray691027 (button) folded before Flop (didn't bet)
Seat 2: hubertchen55 (small blind) collected ($0.19)
Seat 3: togl63amg (big blind) folded on the Flop
Seat 4: NiceMeng folded before Flop (didn't bet)
Seat 5: M0nzdrik folded before Flop (didn't bet)
Seat 6: Johan25888 folded before Flop (didn't bet)



PokerStars Hand #201501224278:  Hold'em No Limit ($0.05/$0.10 USD) - 2019/06/18 4:08:39 ET
Table 'Achird' 6-max Seat #2 is the button
Seat 1: ray691027 ($10.48 in chips) 
Seat 2: hubertchen55 ($11.20 in chips) 
Seat 3: togl63amg ($10.40 in chips) 
Seat 4: NiceMeng ($8.92 in chips) 
Seat 5: M0nzdrik ($10.66 in chips) 
Seat 6: Johan25888 ($12.88 in chips) 
togl63amg: posts small blind $0.05
NiceMeng: posts big blind $0.10
*** HOLE CARDS ***
M0nzdrik: folds 
Johan25888: folds 
ray691027: folds 
hubertchen55: calls $0.10
togl63amg: folds 
NiceMeng: checks 
*** FLOP *** [Ks Jd 6s]
NiceMeng: checks 
hubertchen55: checks 
*** TURN *** [Ks Jd 6s] [4d]
NiceMeng: checks 
hubertchen55: bets $0.12
NiceMeng: folds 
Uncalled bet ($0.12) returned to hubertchen55
hubertchen55 collected $0.24 from pot
hubertchen55: doesn't show hand 
*** SUMMARY ***
Total pot $0.25 | Rake $0.01 
Board [Ks Jd 6s 4d]
Seat 1: ray691027 folded before Flop (didn't bet)
Seat 2: hubertchen55 (button) collected ($0.24)
Seat 3: togl63amg (small blind) folded before Flop
Seat 4: NiceMeng (big blind) folded on the Turn
Seat 5: M0nzdrik folded before Flop (didn't bet)
Seat 6: Johan25888 folded before Flop (didn't bet)



PokerStars Hand #201501233510:  Hold'em No Limit ($0.05/$0.10 USD) - 2019/06/18 4:09:24 ET
Table 'Achird' 6-max Seat #3 is the button
Seat 1: ray691027 ($10.48 in chips) 
Seat 2: hubertchen55 ($11.34 in chips) 
Seat 3: togl63amg ($10.35 in chips) 
Seat 4: NiceMeng ($8.82 in chips) 
Seat 5: M0nzdrik ($10.66 in chips) 
Seat 6: Johan25888 ($12.88 in chips) 
NiceMeng: posts small blind $0.05
M0nzdrik: posts big blind $0.10
*** HOLE CARDS ***
Johan25888: folds 
ray691027: folds 
hubertchen55: calls $0.10
togl63amg: raises $0.35 to $0.45
NiceMeng: folds 
M0nzdrik: folds 
hubertchen55: calls $0.35
*** FLOP *** [Ah Kc 4s]
hubertchen55: checks 
togl63amg: bets $0.56
hubertchen55: folds 
Uncalled bet ($0.56) returned to togl63amg
togl63amg collected $1 from pot
*** SUMMARY ***
Total pot $1.05 | Rake $0.05 
Board [Ah Kc 4s]
Seat 1: ray691027 folded before Flop (didn't bet)
Seat 2: hubertchen55 folded on the Flop
Seat 3: togl63amg (button) collected ($1)
Seat 4: NiceMeng (small blind) folded before Flop
Seat 5: M0nzdrik (big blind) folded before Flop
Seat 6: Johan25888 folded before Flop (didn't bet)



PokerStars Hand #201501240475:  Hold'em No Limit ($0.05/$0.10 USD) - 2019/06/18 4:09:58 ET
Table 'Achird' 6-max Seat #4 is the button
Seat 1: ray691027 ($10.48 in chips) 
Seat 2: hubertchen55 ($10.89 in chips) 
Seat 3: togl63amg ($10.90 in chips) 
Seat 4: NiceMeng ($8.77 in chips) 
Seat 5: M0nzdrik ($10.56 in chips) 
Seat 6: Johan25888 ($12.88 in chips) 
M0nzdrik: posts small blind $0.05
Johan25888: posts big blind $0.10
*** HOLE CARDS ***
ray691027: folds 
hubertchen55: calls $0.10
togl63amg: raises $0.35 to $0.45
NiceMeng: folds 
M0nzdrik: folds 
Johan25888: folds 
hubertchen55: calls $0.35
*** FLOP *** [Jh 4c 7h]
hubertchen55: bets $0.10
togl63amg: calls $0.10
*** TURN *** [Jh 4c 7h] [Qc]
hubertchen55: bets $0.10
togl63amg: raises $0.78 to $0.88
hubertchen55: folds 
Uncalled bet ($0.78) returned to togl63amg
togl63amg collected $1.38 from pot
*** SUMMARY ***
Total pot $1.45 | Rake $0.07 
Board [Jh 4c 7h Qc]
Seat 1: ray691027 folded before Flop (didn't bet)
Seat 2: hubertchen55 folded on the Turn
Seat 3: togl63amg collected ($1.38)
Seat 4: NiceMeng (button) folded before Flop (didn't bet)
Seat 5: M0nzdrik (small blind) folded before Flop
Seat 6: Johan25888 (big blind) folded before Flop



PokerStars Hand #201501247613:  Hold'em No Limit ($0.05/$0.10 USD) - 2019/06/18 4:10:34 ET
Table 'Achird' 6-max Seat #5 is the button
Seat 1: ray691027 ($10.48 in chips) 
Seat 2: hubertchen55 ($10.24 in chips) 
Seat 3: togl63amg ($11.63 in chips) 
Seat 4: NiceMeng ($8.77 in chips) 
Seat 5: M0nzdrik ($10.51 in chips) 
Seat 6: Johan25888 ($12.78 in chips) 
Johan25888: posts small blind $0.05
ray691027: posts big blind $0.10
*** HOLE CARDS ***
hubertchen55: folds 
togl63amg: folds 
NiceMeng: folds 
M0nzdrik: folds 
Johan25888: folds 
Uncalled bet ($0.05) returned to ray691027
ray691027 collected $0.10 from pot
ray691027: doesn't show hand 
*** SUMMARY ***
Total pot $0.10 | Rake $0 
Seat 1: ray691027 (big blind) collected ($0.10)
Seat 2: hubertchen55 folded before Flop (didn't bet)
Seat 3: togl63amg folded before Flop (didn't bet)
Seat 4: NiceMeng folded before Flop (didn't bet)
Seat 5: M0nzdrik (button) folded before Flop (didn't bet)
Seat 6: Johan25888 (small blind) folded before Flop



PokerStars Hand #201501250114:  Hold'em No Limit ($0.05/$0.10 USD) - 2019/06/18 4:10:46 ET
Table 'Achird' 6-max Seat #6 is the button
Seat 1: ray691027 ($10.53 in chips) 
Seat 2: hubertchen55 ($10.24 in chips) 
Seat 3: togl63amg ($11.63 in chips) 
Seat 4: NiceMeng ($8.77 in chips) 
Seat 5: M0nzdrik ($10.51 in chips) 
Seat 6: Johan25888 ($12.73 in chips) 
ray691027: posts small blind $0.05
hubertchen55: posts big blind $0.10
*** HOLE CARDS ***
togl63amg: raises $0.20 to $0.30
NiceMeng: folds 
M0nzdrik: folds 
Johan25888: folds 
ray691027: folds 
hubertchen55: folds 
Uncalled bet ($0.20) returned to togl63amg
togl63amg collected $0.25 from pot
*** SUMMARY ***
Total pot $0.25 | Rake $0 
Seat 1: ray691027 (small blind) folded before Flop
Seat 2: hubertchen55 (big blind) folded before Flop
Seat 3: togl63amg collected ($0.25)
Seat 4: NiceMeng folded before Flop (didn't bet)
Seat 5: M0nzdrik folded before Flop (didn't bet)
Seat 6: Johan25888 (button) folded before Flop (didn't bet)



PokerStars Hand #201501252596:  Hold'em No Limit ($0.05/$0.10 USD) - 2019/06/18 4:10:58 ET
Table 'Achird' 6-max Seat #1 is the button
Seat 1: ray691027 ($10.48 in chips) 
Seat 2: hubertchen55 ($10.14 in chips) 
Seat 3: togl63amg ($11.78 in chips) 
Seat 4: NiceMeng ($8.77 in chips) 
Seat 5: M0nzdrik ($10.51 in chips) 
Seat 6: Johan25888 ($12.73 in chips) 
hubertchen55: posts small blind $0.05
togl63amg: posts big blind $0.10
*** HOLE CARDS ***
NiceMeng: folds 
M0nzdrik: folds 
Johan25888: raises $0.15 to $0.25
ray691027: folds 
hubertchen55: folds 
togl63amg: folds 
Uncalled bet ($0.15) returned to Johan25888
Johan25888 collected $0.25 from pot
Johan25888: doesn't show hand 
*** SUMMARY ***
Total pot $0.25 | Rake $0 
Seat 1: ray691027 (button) folded before Flop (didn't bet)
Seat 2: hubertchen55 (small blind) folded before Flop
Seat 3: togl63amg (big blind) folded before Flop
Seat 4: NiceMeng folded before Flop (didn't bet)
Seat 5: M0nzdrik folded before Flop (didn't bet)
Seat 6: Johan25888 collected ($0.25)



PokerStars Hand #201501255980:  Hold'em No Limit ($0.05/$0.10 USD) - 2019/06/18 4:11:15 ET
Table 'Achird' 6-max Seat #2 is the button
Seat 1: ray691027 ($10.48 in chips) 
Seat 2: hubertchen55 ($10.09 in chips) 
Seat 3: togl63amg ($11.68 in chips) 
Seat 4: NiceMeng ($8.77 in chips) 
Seat 5: M0nzdrik ($10.51 in chips) 
Seat 6: Johan25888 ($12.88 in chips) 
togl63amg: posts small blind $0.05
NiceMeng: posts big blind $0.10
*** HOLE CARDS ***
M0nzdrik: folds 
Johan25888: folds 
ray691027: raises $0.20 to $0.30
hubertchen55: folds 
togl63amg: folds 
NiceMeng: folds 
Uncalled bet ($0.20) returned to ray691027
ray691027 collected $0.25 from pot
ray691027: doesn't show hand 
*** SUMMARY ***
Total pot $0.25 | Rake $0 
Seat 1: ray691027 collected ($0.25)
Seat 2: hubertchen55 (button) folded before Flop (didn't bet)
Seat 3: togl63amg (small blind) folded before Flop
Seat 4: NiceMeng (big blind) folded before Flop
Seat 5: M0nzdrik folded before Flop (didn't bet)
Seat 6: Johan25888 folded before Flop (didn't bet)



PokerStars Hand #201501258664:  Hold'em No Limit ($0.05/$0.10 USD) - 2019/06/18 4:11:28 ET
Table 'Achird' 6-max Seat #3 is the button
Seat 1: ray691027 ($10.63 in chips) 
Seat 2: hubertchen55 ($10.09 in chips) 
Seat 3: togl63amg ($11.63 in chips) 
Seat 4: NiceMeng ($8.67 in chips) 
Seat 5: M0nzdrik ($10.51 in chips) 
Seat 6: Johan25888 ($12.88 in chips) 
NiceMeng: posts small blind $0.05
M0nzdrik: posts big blind $0.10
*** HOLE CARDS ***
Johan25888: folds 
ray691027: raises $0.20 to $0.30
hubertchen55: calls $0.30
togl63amg: folds 
NiceMeng: folds 
M0nzdrik: folds 
*** FLOP *** [9d Qc Js]
ray691027: bets $0.30
hubertchen55: calls $0.30
*** TURN *** [9d Qc Js] [2d]
ray691027: checks 
hubertchen55: checks 
*** RIVER *** [9d Qc Js 2d] [6d]
ray691027: checks 
hubertchen55: checks 
*** SHOW DOWN ***
ray691027: shows [4c 4h] (a pair of Fours)
hubertchen55: shows [9h Ts] (a pair of Nines)
hubertchen55 collected $1.29 from pot
*** SUMMARY ***
Total pot $1.35 | Rake $0.06 
Board [9d Qc Js 2d 6d]
Seat 1: ray691027 showed [4c 4h] and lost with a pair of Fours
Seat 2: hubertchen55 showed [9h Ts] and won ($1.29) with a pair of Nines
Seat 3: togl63amg (button) folded before Flop (didn't bet)
Seat 4: NiceMeng (small blind) folded before Flop
Seat 5: M0nzdrik (big blind) folded before Flop
Seat 6: Johan25888 folded before Flop (didn't bet)



PokerStars Hand #201501269799:  Hold'em No Limit ($0.05/$0.10 USD) - 2019/06/18 4:12:23 ET
Table 'Achird' 6-max Seat #4 is the button
Seat 1: ray691027 ($10.03 in chips) 
Seat 2: hubertchen55 ($10.78 in chips) 
Seat 3: togl63amg ($11.63 in chips) 
Seat 4: NiceMeng ($8.62 in chips) 
Seat 5: M0nzdrik ($10.41 in chips) 
Seat 6: Johan25888 ($12.88 in chips) 
M0nzdrik: posts small blind $0.05
Johan25888: posts big blind $0.10
*** HOLE CARDS ***
ray691027: folds 
hubertchen55: calls $0.10
togl63amg: folds 
NiceMeng: folds 
M0nzdrik: folds 
Johan25888: checks 
*** FLOP *** [Jc Ad 7s]
Johan25888: checks 
hubertchen55: checks 
*** TURN *** [Jc Ad 7s] [3s]
Johan25888: checks 
hubertchen55: checks 
*** RIVER *** [Jc Ad 7s 3s] [4s]
Johan25888: checks 
hubertchen55: checks 
*** SHOW DOWN ***
Johan25888: shows [Qc 2h] (high card Ace)
hubertchen55: shows [9h 9d] (a pair of Nines)
hubertchen55 collected $0.24 from pot
*** SUMMARY ***
Total pot $0.25 | Rake $0.01 
Board [Jc Ad 7s 3s 4s]
Seat 1: ray691027 folded before Flop (didn't bet)
Seat 2: hubertchen55 showed [9h 9d] and won ($0.24) with a pair of Nines
Seat 3: togl63amg folded before Flop (didn't bet)
Seat 4: NiceMeng (button) folded before Flop (didn't bet)
Seat 5: M0nzdrik (small blind) folded before Flop
Seat 6: Johan25888 (big blind) showed [Qc 2h] and lost with high card Ace



PokerStars Hand #201501275456:  Hold'em No Limit ($0.05/$0.10 USD) - 2019/06/18 4:12:50 ET
Table 'Achird' 6-max Seat #5 is the button
Seat 1: ray691027 ($10.03 in chips) 
Seat 2: hubertchen55 ($10.92 in chips) 
Seat 3: togl63amg ($11.63 in chips) 
Seat 4: NiceMeng ($8.62 in chips) 
Seat 5: M0nzdrik ($10.36 in chips) 
Seat 6: Johan25888 ($12.78 in chips) 
Johan25888: posts small blind $0.05
ray691027: posts big blind $0.10
*** HOLE CARDS ***
hubertchen55: folds 
togl63amg: folds 
NiceMeng: folds 
M0nzdrik: folds 
Johan25888: raises $0.20 to $0.30
ray691027: folds 
Uncalled bet ($0.20) returned to Johan25888
Johan25888 collected $0.20 from pot
Johan25888: doesn't show hand 
*** SUMMARY ***
Total pot $0.20 | Rake $0 
Seat 1: ray691027 (big blind) folded before Flop
Seat 2: hubertchen55 folded before Flop (didn't bet)
Seat 3: togl63amg folded before Flop (didn't bet)
Seat 4: NiceMeng folded before Flop (didn't bet)
Seat 5: M0nzdrik (button) folded before Flop (didn't bet)
Seat 6: Johan25888 (small blind) collected ($0.20)



PokerStars Hand #201501278766:  Hold'em No Limit ($0.05/$0.10 USD) - 2019/06/18 4:13:06 ET
Table 'Achird' 6-max Seat #6 is the button
Seat 1: ray691027 ($9.93 in chips) 
Seat 2: hubertchen55 ($10.92 in chips) 
Seat 3: togl63amg ($11.63 in chips) 
Seat 4: NiceMeng ($8.62 in chips) 
Seat 5: M0nzdrik ($10.36 in chips) 
Seat 6: Johan25888 ($12.88 in chips) 
ray691027: posts small blind $0.05
hubertchen55: posts big blind $0.10
*** HOLE CARDS ***
togl63amg: folds 
NiceMeng: folds 
M0nzdrik: folds 
Johan25888: folds 
ray691027: calls $0.05
hubertchen55: checks 
*** FLOP *** [Jd 8s Ks]
ray691027: checks 
hubertchen55: checks 
*** TURN *** [Jd 8s Ks] [Qd]
ray691027: checks 
hubertchen55: bets $0.10
ray691027: folds 
Uncalled bet ($0.10) returned to hubertchen55
hubertchen55 collected $0.19 from pot
hubertchen55: doesn't show hand 
*** SUMMARY ***
Total pot $0.20 | Rake $0.01 
Board [Jd 8s Ks Qd]
Seat 1: ray691027 (small blind) folded on the Turn
Seat 2: hubertchen55 (big blind) collected ($0.19)
Seat 3: togl63amg folded before Flop (didn't bet)
Seat 4: NiceMeng folded before Flop (didn't bet)
Seat 5: M0nzdrik folded before Flop (didn't bet)
Seat 6: Johan25888 (button) folded before Flop (didn't bet)



PokerStars Hand #201501284924:  Hold'em No Limit ($0.05/$0.10 USD) - 2019/06/18 4:13:36 ET
Table 'Achird' 6-max Seat #1 is the button
Seat 1: ray691027 ($9.83 in chips) 
Seat 2: hubertchen55 ($11.01 in chips) 
Seat 3: togl63amg ($11.63 in chips) 
Seat 4: NiceMeng ($8.62 in chips) 
Seat 5: M0nzdrik ($10.36 in chips) 
Seat 6: Johan25888 ($12.88 in chips) 
hubertchen55: posts small blind $0.05
togl63amg: posts big blind $0.10
*** HOLE CARDS ***
NiceMeng: folds 
M0nzdrik: folds 
Johan25888: folds 
ray691027: folds 
hubertchen55: calls $0.05
togl63amg: checks 
*** FLOP *** [Kc Qc 2s]
hubertchen55: checks 
togl63amg: checks 
*** TURN *** [Kc Qc 2s] [4d]
hubertchen55: checks 
NiceMeng leaves the table
togl63amg: checks 
*** RIVER *** [Kc Qc 2s 4d] [6s]
hubertchen55: bets $0.10
togl63amg: folds 
Uncalled bet ($0.10) returned to hubertchen55
hubertchen55 collected $0.19 from pot
hubertchen55: doesn't show hand 
*** SUMMARY ***
Total pot $0.20 | Rake $0.01 
Board [Kc Qc 2s 4d 6s]
Seat 1: ray691027 (button) folded before Flop (didn't bet)
Seat 2: hubertchen55 (small blind) collected ($0.19)
Seat 3: togl63amg (big blind) folded on the River
Seat 4: NiceMeng folded before Flop (didn't bet)
Seat 5: M0nzdrik folded before Flop (didn't bet)
Seat 6: Johan25888 folded before Flop (didn't bet)



PokerStars Hand #201501294839:  Hold'em No Limit ($0.05/$0.10 USD) - 2019/06/18 4:14:24 ET
Table 'Achird' 6-max Seat #2 is the button
Seat 1: ray691027 ($9.83 in chips) 
Seat 2: hubertchen55 ($11.10 in chips) 
Seat 3: togl63amg ($11.53 in chips) 
Seat 5: M0nzdrik ($10.36 in chips) 
Seat 6: Johan25888 ($12.88 in chips) 
togl63amg: posts small blind $0.05
M0nzdrik: posts big blind $0.10
*** HOLE CARDS ***
Johan25888: folds 
ray691027: folds 
hubertchen55: calls $0.10
togl63amg: folds 
M0nzdrik: checks 
*** FLOP *** [Ts Ks 7c]
M0nzdrik: checks 
hubertchen55: bets $0.24
M0nzdrik: folds 
Uncalled bet ($0.24) returned to hubertchen55
hubertchen55 collected $0.24 from pot
hubertchen55: doesn't show hand 
*** SUMMARY ***
Total pot $0.25 | Rake $0.01 
Board [Ts Ks 7c]
Seat 1: ray691027 folded before Flop (didn't bet)
Seat 2: hubertchen55 (button) collected ($0.24)
Seat 3: togl63amg (small blind) folded before Flop
Seat 5: M0nzdrik (big blind) folded on the Flop
Seat 6: Johan25888 folded before Flop (didn't bet)



PokerStars Hand #201501299733:  Hold'em No Limit ($0.05/$0.10 USD) - 2019/06/18 4:14:47 ET
Table 'Achird' 6-max Seat #3 is the button
Seat 1: ray691027 ($9.83 in chips) 
Seat 2: hubertchen55 ($11.24 in chips) 
Seat 3: togl63amg ($11.48 in chips) 
Seat 5: M0nzdrik ($10.26 in chips) 
Seat 6: Johan25888 ($12.88 in chips) 
M0nzdrik: posts small blind $0.05
Johan25888: posts big blind $0.10
*** HOLE CARDS ***
ray691027: raises $0.20 to $0.30
hubertchen55: folds 
togl63amg: folds 
M0nzdrik: folds 
Johan25888: folds 
Uncalled bet ($0.20) returned to ray691027
ray691027 collected $0.25 from pot
ray691027: doesn't show hand 
*** SUMMARY ***
Total pot $0.25 | Rake $0 
Seat 1: ray691027 collected ($0.25)
Seat 2: hubertchen55 folded before Flop (didn't bet)
Seat 3: togl63amg (button) folded before Flop (didn't bet)
Seat 5: M0nzdrik (small blind) folded before Flop
Seat 6: Johan25888 (big blind) folded before Flop



PokerStars Hand #201501305323:  Hold'em No Limit ($0.05/$0.10 USD) - 2019/06/18 4:15:13 ET
Table 'Achird' 6-max Seat #5 is the button
Seat 1: ray691027 ($9.98 in chips) 
Seat 2: hubertchen55 ($11.24 in chips) 
Seat 3: togl63amg ($11.48 in chips) 
Seat 5: M0nzdrik ($10.21 in chips) 
Seat 6: Johan25888 ($12.78 in chips) 
Johan25888: posts small blind $0.05
ray691027: posts big blind $0.10
*** HOLE CARDS ***
hubertchen55: folds 
togl63amg: folds 
M0nzdrik: folds 
Johan25888: folds 
Uncalled bet ($0.05) returned to ray691027
ray691027 collected $0.10 from pot
ray691027: doesn't show hand 
*** SUMMARY ***
Total pot $0.10 | Rake $0 
Seat 1: ray691027 (big blind) collected ($0.10)
Seat 2: hubertchen55 folded before Flop (didn't bet)
Seat 3: togl63amg folded before Flop (didn't bet)
Seat 5: M0nzdrik (button) folded before Flop (didn't bet)
Seat 6: Johan25888 (small blind) folded before Flop



PokerStars Hand #201501308553:  Hold'em No Limit ($0.05/$0.10 USD) - 2019/06/18 4:15:29 ET
Table 'Achird' 6-max Seat #6 is the button
Seat 1: ray691027 ($10.03 in chips) 
Seat 2: hubertchen55 ($11.24 in chips) 
Seat 3: togl63amg ($11.48 in chips) 
Seat 5: M0nzdrik ($10.21 in chips) 
Seat 6: Johan25888 ($12.73 in chips) 
ray691027: posts small blind $0.05
hubertchen55: posts big blind $0.10
*** HOLE CARDS ***
togl63amg: raises $0.20 to $0.30
M0nzdrik: folds 
Johan25888: folds 
NOTfishON joins the table at seat #4 
ray691027: folds 
hubertchen55: folds 
Uncalled bet ($0.20) returned to togl63amg
togl63amg collected $0.25 from pot
*** SUMMARY ***
Total pot $0.25 | Rake $0 
Seat 1: ray691027 (small blind) folded before Flop
Seat 2: hubertchen55 (big blind) folded before Flop
Seat 3: togl63amg collected ($0.25)
Seat 5: M0nzdrik folded before Flop (didn't bet)
Seat 6: Johan25888 (button) folded before Flop (didn't bet)



PokerStars Hand #201501311649:  Hold'em No Limit ($0.05/$0.10 USD) - 2019/06/18 4:15:44 ET
Table 'Achird' 6-max Seat #1 is the button
Seat 1: ray691027 ($9.98 in chips) 
Seat 2: hubertchen55 ($11.14 in chips) 
Seat 3: togl63amg ($11.63 in chips) 
Seat 5: M0nzdrik ($10.21 in chips) 
Seat 6: Johan25888 ($12.73 in chips) 
hubertchen55: posts small blind $0.05
togl63amg: posts big blind $0.10
*** HOLE CARDS ***
M0nzdrik: folds 
Johan25888: folds 
ray691027: folds 
hubertchen55: calls $0.05
togl63amg: raises $0.30 to $0.40
hubertchen55: folds 
Uncalled bet ($0.30) returned to togl63amg
togl63amg collected $0.20 from pot
*** SUMMARY ***
Total pot $0.20 | Rake $0 
Seat 1: ray691027 (button) folded before Flop (didn't bet)
Seat 2: hubertchen55 (small blind) folded before Flop
Seat 3: togl63amg (big blind) collected ($0.20)
Seat 5: M0nzdrik folded before Flop (didn't bet)
Seat 6: Johan25888 folded before Flop (didn't bet)



PokerStars Hand #201501316316:  Hold'em No Limit ($0.05/$0.10 USD) - 2019/06/18 4:16:06 ET
Table 'Achird' 6-max Seat #2 is the button
Seat 1: ray691027 ($9.98 in chips) 
Seat 2: hubertchen55 ($11.04 in chips) 
Seat 3: togl63amg ($11.73 in chips) 
Seat 5: M0nzdrik ($10.21 in chips) 
Seat 6: Johan25888 ($12.73 in chips) 
togl63amg: posts small blind $0.05
M0nzdrik: posts big blind $0.10
*** HOLE CARDS ***
Johan25888: folds 
ray691027: folds 
hubertchen55: calls $0.10
togl63amg: folds 
M0nzdrik: checks 
*** FLOP *** [6c 6s 2c]
NOTfishON leaves the table
M0nzdrik: bets $0.13
hubertchen55: folds 
Uncalled bet ($0.13) returned to M0nzdrik
M0nzdrik collected $0.24 from pot
M0nzdrik: doesn't show hand 
*** SUMMARY ***
Total pot $0.25 | Rake $0.01 
Board [6c 6s 2c]
Seat 1: ray691027 folded before Flop (didn't bet)
Seat 2: hubertchen55 (button) folded on the Flop
Seat 3: togl63amg (small blind) folded before Flop
Seat 5: M0nzdrik (big blind) collected ($0.24)
Seat 6: Johan25888 folded before Flop (didn't bet)



PokerStars Hand #201501320027:  Hold'em No Limit ($0.05/$0.10 USD) - 2019/06/18 4:16:24 ET
Table 'Achird' 6-max Seat #3 is the button
Seat 1: ray691027 ($9.98 in chips) 
Seat 2: hubertchen55 ($10.94 in chips) 
Seat 3: togl63amg ($11.68 in chips) 
Seat 5: M0nzdrik ($10.35 in chips) 
Seat 6: Johan25888 ($12.73 in chips) 
M0nzdrik: posts small blind $0.05
Johan25888: posts big blind $0.10
*** HOLE CARDS ***
ray691027: folds 
hubertchen55: calls $0.10
Jak_Prihlop joins the table at seat #4 
togl63amg: folds 
M0nzdrik: folds 
Johan25888: checks 
*** FLOP *** [Qh 7c 6s]
Johan25888: checks 
hubertchen55: bets $0.12
Johan25888: calls $0.12
*** TURN *** [Qh 7c 6s] [Ks]
Johan25888: checks 
hubertchen55: checks 
*** RIVER *** [Qh 7c 6s Ks] [5h]
Johan25888: bets $0.10
hubertchen55: calls $0.10
*** SHOW DOWN ***
Johan25888: shows [Qc 3s] (a pair of Queens)
hubertchen55: mucks hand 
Johan25888 collected $0.66 from pot
*** SUMMARY ***
Total pot $0.69 | Rake $0.03 
Board [Qh 7c 6s Ks 5h]
Seat 1: ray691027 folded before Flop (didn't bet)
Seat 2: hubertchen55 mucked
Seat 3: togl63amg (button) folded before Flop (didn't bet)
Seat 5: M0nzdrik (small blind) folded before Flop
Seat 6: Johan25888 (big blind) showed [Qc 3s] and won ($0.66) with a pair of Queens



PokerStars Hand #201501328457:  Hold'em No Limit ($0.05/$0.10 USD) - 2019/06/18 4:17:05 ET
Table 'Achird' 6-max Seat #5 is the button
Seat 1: ray691027 ($9.98 in chips) 
Seat 2: hubertchen55 ($10.62 in chips) 
Seat 3: togl63amg ($11.68 in chips) 
Seat 4: Jak_Prihlop ($10 in chips) 
Seat 5: M0nzdrik ($10.30 in chips) 
Seat 6: Johan25888 ($13.07 in chips) 
Johan25888: posts small blind $0.05
ray691027: posts big blind $0.10
Jak_Prihlop: posts big blind $0.10
*** HOLE CARDS ***
hubertchen55: folds 
togl63amg: folds 
Jak_Prihlop: checks 
M0nzdrik: folds 
Johan25888: folds 
ray691027: checks 
*** FLOP *** [Ts 4c Qh]
ray691027: checks 
Jak_Prihlop: bets $0.20
ray691027: folds 
Uncalled bet ($0.20) returned to Jak_Prihlop
Jak_Prihlop collected $0.24 from pot
Jak_Prihlop: doesn't show hand 
*** SUMMARY ***
Total pot $0.25 | Rake $0.01 
Board [Ts 4c Qh]
Seat 1: ray691027 (big blind) folded on the Flop
Seat 2: hubertchen55 folded before Flop (didn't bet)
Seat 3: togl63amg folded before Flop (didn't bet)
Seat 4: Jak_Prihlop collected ($0.24)
Seat 5: M0nzdrik (button) folded before Flop (didn't bet)
Seat 6: Johan25888 (small blind) folded before Flop



PokerStars Hand #201501335750:  Hold'em No Limit ($0.05/$0.10 USD) - 2019/06/18 4:17:40 ET
Table 'Achird' 6-max Seat #6 is the button
Seat 1: ray691027 ($9.88 in chips) 
Seat 2: hubertchen55 ($10.62 in chips) 
Seat 3: togl63amg ($11.68 in chips) 
Seat 4: Jak_Prihlop ($10.14 in chips) 
Seat 5: M0nzdrik ($10.30 in chips) 
Seat 6: Johan25888 ($13.02 in chips) 
ray691027: posts small blind $0.05
hubertchen55: posts big blind $0.10
*** HOLE CARDS ***
togl63amg: folds 
Jak_Prihlop: calls $0.10
M0nzdrik: raises $0.30 to $0.40
Johan25888: folds 
ray691027: raises $1 to $1.40
hubertchen55: folds 
Jak_Prihlop: folds 
M0nzdrik: folds 
Uncalled bet ($1) returned to ray691027
ray691027 collected $1 from pot
ray691027: doesn't show hand 
*** SUMMARY ***
Total pot $1 | Rake $0 
Seat 1: ray691027 (small blind) collected ($1)
Seat 2: hubertchen55 (big blind) folded before Flop
Seat 3: togl63amg folded before Flop (didn't bet)
Seat 4: Jak_Prihlop folded before Flop
Seat 5: M0nzdrik folded before Flop
Seat 6: Johan25888 (button) folded before Flop (didn't bet)



PokerStars Hand #201501341658:  Hold'em No Limit ($0.05/$0.10 USD) - 2019/06/18 4:18:08 ET
Table 'Achird' 6-max Seat #1 is the button
Seat 1: ray691027 ($10.48 in chips) 
Seat 2: hubertchen55 ($10.52 in chips) 
Seat 3: togl63amg ($11.68 in chips) 
Seat 4: Jak_Prihlop ($10.04 in chips) 
Seat 5: M0nzdrik ($10 in chips) 
Seat 6: Johan25888 ($13.02 in chips) 
hubertchen55: posts small blind $0.05
togl63amg: posts big blind $0.10
*** HOLE CARDS ***
Jak_Prihlop: calls $0.10
M0nzdrik: folds 
Johan25888: folds 
ray691027: folds 
hubertchen55: calls $0.05
togl63amg: checks 
*** FLOP *** [7c 3h Qh]
hubertchen55: checks 
togl63amg: checks 
Jak_Prihlop: checks 
*** TURN *** [7c 3h Qh] [4s]
hubertchen55: bets $0.29
togl63amg: folds 
Jak_Prihlop: calls $0.29
*** RIVER *** [7c 3h Qh 4s] [Kh]
hubertchen55: checks 
Jak_Prihlop: bets $0.40
hubertchen55: folds 
Uncalled bet ($0.40) returned to Jak_Prihlop
Jak_Prihlop collected $0.84 from pot
Jak_Prihlop: doesn't show hand 
*** SUMMARY ***
Total pot $0.88 | Rake $0.04 
Board [7c 3h Qh 4s Kh]
Seat 1: ray691027 (button) folded before Flop (didn't bet)
Seat 2: hubertchen55 (small blind) folded on the River
Seat 3: togl63amg (big blind) folded on the Turn
Seat 4: Jak_Prihlop collected ($0.84)
Seat 5: M0nzdrik folded before Flop (didn't bet)
Seat 6: Johan25888 folded before Flop (didn't bet)



PokerStars Hand #201501352424:  Hold'em No Limit ($0.05/$0.10 USD) - 2019/06/18 4:19:00 ET
Table 'Achird' 6-max Seat #2 is the button
Seat 1: ray691027 ($10.48 in chips) 
Seat 2: hubertchen55 ($10.13 in chips) 
Seat 3: togl63amg ($11.58 in chips) 
Seat 4: Jak_Prihlop ($10.49 in chips) 
Seat 5: M0nzdrik ($10 in chips) 
Seat 6: Johan25888 ($13.02 in chips) 
togl63amg: posts small blind $0.05
Jak_Prihlop: posts big blind $0.10
*** HOLE CARDS ***
M0nzdrik: folds 
Johan25888: folds 
ray691027: folds 
hubertchen55: calls $0.10
togl63amg: raises $0.40 to $0.50
Jak_Prihlop: folds 
hubertchen55: calls $0.40
*** FLOP *** [2c 7h 8s]
togl63amg: bets $0.74
hubertchen55: folds 
Uncalled bet ($0.74) returned to togl63amg
togl63amg collected $1.05 from pot
*** SUMMARY ***
Total pot $1.10 | Rake $0.05 
Board [2c 7h 8s]
Seat 1: ray691027 folded before Flop (didn't bet)
Seat 2: hubertchen55 (button) folded on the Flop
Seat 3: togl63amg (small blind) collected ($1.05)
Seat 4: Jak_Prihlop (big blind) folded before Flop
Seat 5: M0nzdrik folded before Flop (didn't bet)
Seat 6: Johan25888 folded before Flop (didn't bet)



PokerStars Hand #201501371762:  Hold'em No Limit ($0.05/$0.10 USD) - 2019/06/18 4:20:33 ET
Table 'Achird' 6-max Seat #4 is the button
Seat 1: ray691027 ($10.48 in chips) 
Seat 2: hubertchen55 ($8.58 in chips) 
Seat 3: togl63amg ($13.23 in chips) 
Seat 4: Jak_Prihlop ($10.34 in chips) 
Seat 5: M0nzdrik ($10 in chips) 
Seat 6: Johan25888 ($13.02 in chips) 
M0nzdrik: posts small blind $0.05
Johan25888: posts big blind $0.10
*** HOLE CARDS ***
ray691027: folds 
hubertchen55: calls $0.10
togl63amg: folds 
Jak_Prihlop: calls $0.10
M0nzdrik: calls $0.05
Johan25888: checks 
*** FLOP *** [Kh 4s 6s]
M0nzdrik: checks 
Johan25888: checks 
hubertchen55: checks 
Jak_Prihlop: checks 
*** TURN *** [Kh 4s 6s] [2d]
M0nzdrik: checks 
Johan25888: bets $0.38
hubertchen55: folds 
Jak_Prihlop: folds 
M0nzdrik: folds 
Uncalled bet ($0.38) returned to Johan25888
Johan25888 collected $0.38 from pot
Johan25888: doesn't show hand 
*** SUMMARY ***
Total pot $0.40 | Rake $0.02 
Board [Kh 4s 6s 2d]
Seat 1: ray691027 folded before Flop (didn't bet)
Seat 2: hubertchen55 folded on the Turn
Seat 3: togl63amg folded before Flop (didn't bet)
Seat 4: Jak_Prihlop (button) folded on the Turn
Seat 5: M0nzdrik (small blind) folded on the Turn
Seat 6: Johan25888 (big blind) collected ($0.38)



PokerStars Hand #201501381715:  Hold'em No Limit ($0.05/$0.10 USD) - 2019/06/18 4:21:20 ET
Table 'Achird' 6-max Seat #5 is the button
Seat 1: ray691027 ($10.48 in chips) 
Seat 2: hubertchen55 ($8.48 in chips) 
Seat 3: togl63amg ($13.23 in chips) 
Seat 4: Jak_Prihlop ($10.24 in chips) 
Seat 5: M0nzdrik ($10 in chips) 
Seat 6: Johan25888 ($13.30 in chips) 
Johan25888: posts small blind $0.05
ray691027: posts big blind $0.10
*** HOLE CARDS ***
hubertchen55: folds 
togl63amg: folds 
Jak_Prihlop: calls $0.10
M0nzdrik: raises $0.24 to $0.34
Johan25888: folds 
ray691027: folds 
Jak_Prihlop: calls $0.24
*** FLOP *** [Kd 4c 9d]
Jak_Prihlop: checks 
M0nzdrik: bets $0.40
Jak_Prihlop: calls $0.40
*** TURN *** [Kd 4c 9d] [8c]
Jak_Prihlop: checks 
M0nzdrik: bets $0.81
Jak_Prihlop: calls $0.81
*** RIVER *** [Kd 4c 9d 8c] [Qc]
Jak_Prihlop: checks 
M0nzdrik: bets $2.80
Jak_Prihlop: folds 
Uncalled bet ($2.80) returned to M0nzdrik
M0nzdrik collected $3.10 from pot
M0nzdrik: doesn't show hand 
*** SUMMARY ***
Total pot $3.25 | Rake $0.15 
Board [Kd 4c 9d 8c Qc]
Seat 1: ray691027 (big blind) folded before Flop
Seat 2: hubertchen55 folded before Flop (didn't bet)
Seat 3: togl63amg folded before Flop (didn't bet)
Seat 4: Jak_Prihlop folded on the River
Seat 5: M0nzdrik (button) collected ($3.10)
Seat 6: Johan25888 (small blind) folded before Flop



PokerStars Hand #201501393859:  Hold'em No Limit ($0.05/$0.10 USD) - 2019/06/18 4:22:19 ET
Table 'Achird' 6-max Seat #6 is the button
Seat 1: ray691027 ($10.38 in chips) 
Seat 2: hubertchen55 ($8.48 in chips) 
Seat 3: togl63amg ($13.23 in chips) 
Seat 4: Jak_Prihlop ($8.69 in chips) 
Seat 5: M0nzdrik ($11.55 in chips) 
Seat 6: Johan25888 ($13.25 in chips) 
ray691027: posts small blind $0.05
hubertchen55: posts big blind $0.10
*** HOLE CARDS ***
togl63amg: raises $0.20 to $0.30
Jak_Prihlop: folds 
M0nzdrik: folds 
Johan25888: folds 
ray691027: folds 
hubertchen55: folds 
Uncalled bet ($0.20) returned to togl63amg
togl63amg collected $0.25 from pot
*** SUMMARY ***
Total pot $0.25 | Rake $0 
Seat 1: ray691027 (small blind) folded before Flop
Seat 2: hubertchen55 (big blind) folded before Flop
Seat 3: togl63amg collected ($0.25)
Seat 4: Jak_Prihlop folded before Flop (didn't bet)
Seat 5: M0nzdrik folded before Flop (didn't bet)
Seat 6: Johan25888 (button) folded before Flop (didn't bet)



PokerStars Hand #201501397431:  Hold'em No Limit ($0.05/$0.10 USD) - 2019/06/18 4:22:36 ET
Table 'Achird' 6-max Seat #1 is the button
Seat 1: ray691027 ($10.33 in chips) 
Seat 2: hubertchen55 ($8.38 in chips) 
Seat 3: togl63amg ($13.38 in chips) 
Seat 4: Jak_Prihlop ($8.69 in chips) 
Seat 5: M0nzdrik ($11.55 in chips) 
Seat 6: Johan25888 ($13.25 in chips) 
hubertchen55: posts small blind $0.05
togl63amg: posts big blind $0.10
*** HOLE CARDS ***
Jak_Prihlop: folds 
M0nzdrik: folds 
Johan25888: raises $0.15 to $0.25
ray691027: calls $0.25
hubertchen55: calls $0.20
togl63amg: calls $0.15
*** FLOP *** [2c 3c Ks]
hubertchen55: bets $0.48
togl63amg: folds 
Johan25888: raises $0.98 to $1.46
ray691027: folds 
hubertchen55: calls $0.98
*** TURN *** [2c 3c Ks] [Td]
hubertchen55: checks 
Johan25888: bets $2.38
hubertchen55: calls $2.38
*** RIVER *** [2c 3c Ks Td] [As]
hubertchen55: checks 
Johan25888: bets $5.72
hubertchen55: folds 
Uncalled bet ($5.72) returned to Johan25888
Johan25888 collected $8.29 from pot
Johan25888: doesn't show hand 
*** SUMMARY ***
Total pot $8.68 | Rake $0.39 
Board [2c 3c Ks Td As]
Seat 1: ray691027 (button) folded on the Flop
Seat 2: hubertchen55 (small blind) folded on the River
Seat 3: togl63amg (big blind) folded on the Flop
Seat 4: Jak_Prihlop folded before Flop (didn't bet)
Seat 5: M0nzdrik folded before Flop (didn't bet)
Seat 6: Johan25888 collected ($8.29)



PokerStars Hand #201501411069:  Hold'em No Limit ($0.05/$0.10 USD) - 2019/06/18 4:23:41 ET
Table 'Achird' 6-max Seat #2 is the button
Seat 1: ray691027 ($10.08 in chips) 
Seat 2: hubertchen55 ($4.29 in chips) 
Seat 3: togl63amg ($13.13 in chips) 
Seat 4: Jak_Prihlop ($8.69 in chips) 
Seat 5: M0nzdrik ($11.55 in chips) 
Seat 6: Johan25888 ($17.45 in chips) 
togl63amg: posts small blind $0.05
Jak_Prihlop: posts big blind $0.10
*** HOLE CARDS ***
M0nzdrik: folds 
Johan25888: folds 
ray691027: folds 
hubertchen55: folds 
togl63amg: folds 
Uncalled bet ($0.05) returned to Jak_Prihlop
Jak_Prihlop collected $0.10 from pot
Jak_Prihlop: doesn't show hand 
*** SUMMARY ***
Total pot $0.10 | Rake $0 
Seat 1: ray691027 folded before Flop (didn't bet)
Seat 2: hubertchen55 (button) folded before Flop (didn't bet)
Seat 3: togl63amg (small blind) folded before Flop
Seat 4: Jak_Prihlop (big blind) collected ($0.10)
Seat 5: M0nzdrik folded before Flop (didn't bet)
Seat 6: Johan25888 folded before Flop (didn't bet)



PokerStars Hand #201501413179:  Hold'em No Limit ($0.05/$0.10 USD) - 2019/06/18 4:23:52 ET
Table 'Achird' 6-max Seat #3 is the button
Seat 1: ray691027 ($10.08 in chips) 
Seat 2: hubertchen55 ($4.29 in chips) 
Seat 3: togl63amg ($13.08 in chips) 
Seat 4: Jak_Prihlop ($8.74 in chips) 
Seat 5: M0nzdrik ($11.55 in chips) 
Seat 6: Johan25888 ($17.45 in chips) 
Jak_Prihlop: posts small blind $0.05
M0nzdrik: posts big blind $0.10
*** HOLE CARDS ***
Johan25888: folds 
ray691027: folds 
hubertchen55: folds 
togl63amg: folds 
Jak_Prihlop: calls $0.05
M0nzdrik: raises $0.30 to $0.40
Jak_Prihlop: folds 
Uncalled bet ($0.30) returned to M0nzdrik
M0nzdrik collected $0.20 from pot
M0nzdrik: doesn't show hand 
*** SUMMARY ***
Total pot $0.20 | Rake $0 
Seat 1: ray691027 folded before Flop (didn't bet)
Seat 2: hubertchen55 folded before Flop (didn't bet)
Seat 3: togl63amg (button) folded before Flop (didn't bet)
Seat 4: Jak_Prihlop (small blind) folded before Flop
Seat 5: M0nzdrik (big blind) collected ($0.20)
Seat 6: Johan25888 folded before Flop (didn't bet)



PokerStars Hand #201501415849:  Hold'em No Limit ($0.05/$0.10 USD) - 2019/06/18 4:24:05 ET
Table 'Achird' 6-max Seat #4 is the button
Seat 1: ray691027 ($10.08 in chips) 
Seat 2: hubertchen55 ($4.29 in chips) 
Seat 3: togl63amg ($13.08 in chips) 
Seat 4: Jak_Prihlop ($8.64 in chips) 
Seat 5: M0nzdrik ($11.65 in chips) 
Seat 6: Johan25888 ($17.45 in chips) 
M0nzdrik: posts small blind $0.05
Johan25888: posts big blind $0.10
*** HOLE CARDS ***
ray691027: folds 
hubertchen55: calls $0.10
togl63amg: folds 
Jak_Prihlop: calls $0.10
M0nzdrik: folds 
Johan25888: checks 
*** FLOP *** [5c 5d Qs]
Johan25888: checks 
hubertchen55: checks 
Jak_Prihlop: bets $0.20
Johan25888: folds 
hubertchen55: folds 
Uncalled bet ($0.20) returned to Jak_Prihlop
Jak_Prihlop collected $0.33 from pot
Jak_Prihlop: doesn't show hand 
*** SUMMARY ***
Total pot $0.35 | Rake $0.02 
Board [5c 5d Qs]
Seat 1: ray691027 folded before Flop (didn't bet)
Seat 2: hubertchen55 folded on the Flop
Seat 3: togl63amg folded before Flop (didn't bet)
Seat 4: Jak_Prihlop (button) collected ($0.33)
Seat 5: M0nzdrik (small blind) folded before Flop
Seat 6: Johan25888 (big blind) folded on the Flop



PokerStars Hand #201501421152:  Hold'em No Limit ($0.05/$0.10 USD) - 2019/06/18 4:24:31 ET
Table 'Achird' 6-max Seat #5 is the button
Seat 1: ray691027 ($10.08 in chips) 
Seat 2: hubertchen55 ($4.19 in chips) 
Seat 3: togl63amg ($13.08 in chips) 
Seat 4: Jak_Prihlop ($8.87 in chips) 
Seat 5: M0nzdrik ($11.60 in chips) 
Seat 6: Johan25888 ($17.35 in chips) 
Johan25888: posts small blind $0.05
ray691027: posts big blind $0.10
*** HOLE CARDS ***
hubertchen55: folds 
togl63amg: folds 
Jak_Prihlop: calls $0.10
M0nzdrik: folds 
Johan25888: calls $0.05
ray691027: checks 
*** FLOP *** [Kd 5c Kh]
Johan25888: checks 
ray691027: checks 
Jak_Prihlop: bets $0.20
Johan25888: folds 
ray691027: folds 
Uncalled bet ($0.20) returned to Jak_Prihlop
Jak_Prihlop collected $0.29 from pot
Jak_Prihlop: doesn't show hand 
*** SUMMARY ***
Total pot $0.30 | Rake $0.01 
Board [Kd 5c Kh]
Seat 1: ray691027 (big blind) folded on the Flop
Seat 2: hubertchen55 folded before Flop (didn't bet)
Seat 3: togl63amg folded before Flop (didn't bet)
Seat 4: Jak_Prihlop collected ($0.29)
Seat 5: M0nzdrik (button) folded before Flop (didn't bet)
Seat 6: Johan25888 (small blind) folded on the Flop



PokerStars Hand #201501428024:  Hold'em No Limit ($0.05/$0.10 USD) - 2019/06/18 4:25:04 ET
Table 'Achird' 6-max Seat #6 is the button
Seat 1: ray691027 ($9.98 in chips) 
Seat 2: hubertchen55 ($4.19 in chips) 
Seat 3: togl63amg ($13.08 in chips) 
Seat 4: Jak_Prihlop ($9.06 in chips) 
Seat 5: M0nzdrik ($11.60 in chips) 
Seat 6: Johan25888 ($17.25 in chips) 
ray691027: posts small blind $0.05
hubertchen55: posts big blind $0.10
*** HOLE CARDS ***
togl63amg: folds 
Jak_Prihlop: calls $0.10
M0nzdrik: raises $0.24 to $0.34
Johan25888: folds 
ray691027: folds 
hubertchen55: calls $0.24
Jak_Prihlop: calls $0.24
*** FLOP *** [6s Ts Jh]
hubertchen55: checks 
Jak_Prihlop: checks 
M0nzdrik: checks 
*** TURN *** [6s Ts Jh] [7d]
hubertchen55: checks 
Jak_Prihlop: checks 
M0nzdrik: checks 
*** RIVER *** [6s Ts Jh 7d] [Kh]
hubertchen55: bets $1.02
Jak_Prihlop: calls $1.02
M0nzdrik: folds 
*** SHOW DOWN ***
hubertchen55: shows [Ks Ad] (a pair of Kings)
Jak_Prihlop: mucks hand 
hubertchen55 collected $2.97 from pot
*** SUMMARY ***
Total pot $3.11 | Rake $0.14 
Board [6s Ts Jh 7d Kh]
Seat 1: ray691027 (small blind) folded before Flop
Seat 2: hubertchen55 (big blind) showed [Ks Ad] and won ($2.97) with a pair of Kings
Seat 3: togl63amg folded before Flop (didn't bet)
Seat 4: Jak_Prihlop mucked
Seat 5: M0nzdrik folded on the River
Seat 6: Johan25888 (button) folded before Flop (didn't bet)



PokerStars Hand #201501436774:  Hold'em No Limit ($0.05/$0.10 USD) - 2019/06/18 4:25:46 ET
Table 'Achird' 6-max Seat #1 is the button
Seat 1: ray691027 ($9.93 in chips) 
Seat 2: hubertchen55 ($5.80 in chips) 
Seat 3: togl63amg ($13.08 in chips) 
Seat 4: Jak_Prihlop ($7.70 in chips) 
Seat 5: M0nzdrik ($11.26 in chips) 
Seat 6: Johan25888 ($17.25 in chips) 
hubertchen55: posts small blind $0.05
togl63amg: posts big blind $0.10
*** HOLE CARDS ***
Jak_Prihlop: calls $0.10
M0nzdrik: folds 
Johan25888: folds 
ray691027: folds 
hubertchen55: calls $0.05
togl63amg: checks 
*** FLOP *** [Ad Qs 3d]
hubertchen55: checks 
togl63amg: checks 
Jak_Prihlop: bets $0.10
hubertchen55: folds 
togl63amg: folds 
Uncalled bet ($0.10) returned to Jak_Prihlop
Jak_Prihlop collected $0.29 from pot
*** SUMMARY ***
Total pot $0.30 | Rake $0.01 
Board [Ad Qs 3d]
Seat 1: ray691027 (button) folded before Flop (didn't bet)
Seat 2: hubertchen55 (small blind) folded on the Flop
Seat 3: togl63amg (big blind) folded on the Flop
Seat 4: Jak_Prihlop collected ($0.29)
Seat 5: M0nzdrik folded before Flop (didn't bet)
Seat 6: Johan25888 folded before Flop (didn't bet)



PokerStars Hand #201501444541:  Hold'em No Limit ($0.05/$0.10 USD) - 2019/06/18 4:26:24 ET
Table 'Achird' 6-max Seat #2 is the button
Seat 1: ray691027 ($9.93 in chips) 
Seat 2: hubertchen55 ($5.70 in chips) 
Seat 3: togl63amg ($12.98 in chips) 
Seat 4: Jak_Prihlop ($7.89 in chips) 
Seat 5: M0nzdrik ($11.26 in chips) 
Seat 6: Johan25888 ($17.25 in chips) 
togl63amg: posts small blind $0.05
Jak_Prihlop: posts big blind $0.10
*** HOLE CARDS ***
M0nzdrik: folds 
Johan25888: folds 
ray691027: folds 
hubertchen55: folds 
togl63amg: folds 
Uncalled bet ($0.05) returned to Jak_Prihlop
Jak_Prihlop collected $0.10 from pot
Jak_Prihlop: doesn't show hand 
*** SUMMARY ***
Total pot $0.10 | Rake $0 
Seat 1: ray691027 folded before Flop (didn't bet)
Seat 2: hubertchen55 (button) folded before Flop (didn't bet)
Seat 3: togl63amg (small blind) folded before Flop
Seat 4: Jak_Prihlop (big blind) collected ($0.10)
Seat 5: M0nzdrik folded before Flop (didn't bet)
Seat 6: Johan25888 folded before Flop (didn't bet)



PokerStars Hand #201501447829:  Hold'em No Limit ($0.05/$0.10 USD) - 2019/06/18 4:26:40 ET
Table 'Achird' 6-max Seat #3 is the button
Seat 1: ray691027 ($9.93 in chips) 
Seat 2: hubertchen55 ($5.70 in chips) 
Seat 3: togl63amg ($12.93 in chips) 
Seat 4: Jak_Prihlop ($7.94 in chips) 
Seat 5: M0nzdrik ($11.26 in chips) 
Seat 6: Johan25888 ($17.25 in chips) 
Jak_Prihlop: posts small blind $0.05
M0nzdrik: posts big blind $0.10
*** HOLE CARDS ***
Johan25888: folds 
ray691027: folds 
hubertchen55 has timed out
hubertchen55: folds 
togl63amg: raises $0.20 to $0.30
Jak_Prihlop: folds 
M0nzdrik: folds 
Uncalled bet ($0.20) returned to togl63amg
togl63amg collected $0.25 from pot
*** SUMMARY ***
Total pot $0.25 | Rake $0 
Seat 1: ray691027 folded before Flop (didn't bet)
Seat 2: hubertchen55 folded before Flop (didn't bet)
Seat 3: togl63amg (button) collected ($0.25)
Seat 4: Jak_Prihlop (small blind) folded before Flop
Seat 5: M0nzdrik (big blind) folded before Flop
Seat 6: Johan25888 folded before Flop (didn't bet)



PokerStars Hand #201501453032:  Hold'em No Limit ($0.05/$0.10 USD) - 2019/06/18 4:27:05 ET
Table 'Achird' 6-max Seat #4 is the button
Seat 1: ray691027 ($9.93 in chips) 
Seat 3: togl63amg ($13.08 in chips) 
Seat 4: Jak_Prihlop ($7.89 in chips) 
Seat 5: M0nzdrik ($11.16 in chips) 
Seat 6: Johan25888 ($17.25 in chips) 
M0nzdrik: posts small blind $0.05
Johan25888: posts big blind $0.10
*** HOLE CARDS ***
ray691027: folds 
togl63amg: raises $0.20 to $0.30
Jak_Prihlop: folds 
M0nzdrik: folds 
Johan25888: folds 
Uncalled bet ($0.20) returned to togl63amg
togl63amg collected $0.25 from pot
*** SUMMARY ***
Total pot $0.25 | Rake $0 
Seat 1: ray691027 folded before Flop (didn't bet)
Seat 3: togl63amg collected ($0.25)
Seat 4: Jak_Prihlop (button) folded before Flop (didn't bet)
Seat 5: M0nzdrik (small blind) folded before Flop
Seat 6: Johan25888 (big blind) folded before Flop



PokerStars Hand #201501456878:  Hold'em No Limit ($0.05/$0.10 USD) - 2019/06/18 4:27:23 ET
Table 'Achird' 6-max Seat #5 is the button
Seat 1: ray691027 ($9.93 in chips) 
Seat 3: togl63amg ($13.23 in chips) 
Seat 4: Jak_Prihlop ($7.89 in chips) 
Seat 5: M0nzdrik ($11.11 in chips) 
Seat 6: Johan25888 ($17.15 in chips) 
Johan25888: posts small blind $0.05
ray691027: posts big blind $0.10
*** HOLE CARDS ***
togl63amg: raises $0.20 to $0.30
Jak_Prihlop: folds 
M0nzdrik: folds 
Johan25888: folds 
ray691027: folds 
Uncalled bet ($0.20) returned to togl63amg
togl63amg collected $0.25 from pot
*** SUMMARY ***
Total pot $0.25 | Rake $0 
Seat 1: ray691027 (big blind) folded before Flop
Seat 3: togl63amg collected ($0.25)
Seat 4: Jak_Prihlop folded before Flop (didn't bet)
Seat 5: M0nzdrik (button) folded before Flop (didn't bet)
Seat 6: Johan25888 (small blind) folded before Flop



PokerStars Hand #201501460055:  Hold'em No Limit ($0.05/$0.10 USD) - 2019/06/18 4:27:38 ET
Table 'Achird' 6-max Seat #6 is the button
Seat 1: ray691027 ($9.83 in chips) 
Seat 3: togl63amg ($13.38 in chips) 
Seat 4: Jak_Prihlop ($7.89 in chips) 
Seat 5: M0nzdrik ($11.11 in chips) 
Seat 6: Johan25888 ($17.10 in chips) 
ray691027: posts small blind $0.05
togl63amg: posts big blind $0.10
*** HOLE CARDS ***
Jak_Prihlop: folds 
M0nzdrik: raises $0.20 to $0.30
Johan25888: folds 
ray691027: folds 
togl63amg: folds 
Uncalled bet ($0.20) returned to M0nzdrik
M0nzdrik collected $0.25 from pot
M0nzdrik: doesn't show hand 
*** SUMMARY ***
Total pot $0.25 | Rake $0 
Seat 1: ray691027 (small blind) folded before Flop
Seat 3: togl63amg (big blind) folded before Flop
Seat 4: Jak_Prihlop folded before Flop (didn't bet)
Seat 5: M0nzdrik collected ($0.25)
Seat 6: Johan25888 (button) folded before Flop (didn't bet)



PokerStars Hand #201501463546:  Hold'em No Limit ($0.05/$0.10 USD) - 2019/06/18 4:27:55 ET
Table 'Achird' 6-max Seat #1 is the button
Seat 1: ray691027 ($9.78 in chips) 
Seat 3: togl63amg ($13.28 in chips) 
Seat 4: Jak_Prihlop ($7.89 in chips) 
Seat 5: M0nzdrik ($11.26 in chips) 
Seat 6: Johan25888 ($17.10 in chips) 
togl63amg: posts small blind $0.05
Jak_Prihlop: posts big blind $0.10
*** HOLE CARDS ***
M0nzdrik: folds 
Johan25888: folds 
ray691027: folds 
togl63amg: folds 
Uncalled bet ($0.05) returned to Jak_Prihlop
Jak_Prihlop collected $0.10 from pot
Jak_Prihlop: doesn't show hand 
*** SUMMARY ***
Total pot $0.10 | Rake $0 
Seat 1: ray691027 (button) folded before Flop (didn't bet)
Seat 3: togl63amg (small blind) folded before Flop
Seat 4: Jak_Prihlop (big blind) collected ($0.10)
Seat 5: M0nzdrik folded before Flop (didn't bet)
Seat 6: Johan25888 folded before Flop (didn't bet)



PokerStars Hand #201501465557:  Hold'em No Limit ($0.05/$0.10 USD) - 2019/06/18 4:28:05 ET
Table 'Achird' 6-max Seat #3 is the button
Seat 1: ray691027 ($9.78 in chips) 
Seat 2: hubertchen55 ($5.70 in chips) 
Seat 3: togl63amg ($13.23 in chips) 
Seat 4: Jak_Prihlop ($7.94 in chips) 
Seat 5: M0nzdrik ($11.26 in chips) 
Seat 6: Johan25888 ($17.10 in chips) 
Jak_Prihlop: posts small blind $0.05
M0nzdrik: posts big blind $0.10
hubertchen55: posts small & big blinds $0.15
*** HOLE CARDS ***
Johan25888: folds 
ray691027: folds 
hubertchen55: checks 
togl63amg: folds 
Jak_Prihlop: calls $0.05
M0nzdrik: checks 
*** FLOP *** [8h As 7d]
Jak_Prihlop: checks 
M0nzdrik: checks 
hubertchen55: checks 
*** TURN *** [8h As 7d] [Kd]
Jak_Prihlop: checks 
M0nzdrik: bets $0.28
hubertchen55: calls $0.28
Jak_Prihlop: folds 
*** RIVER *** [8h As 7d Kd] [5d]
M0nzdrik: bets $0.44
hubertchen55: folds 
Uncalled bet ($0.44) returned to M0nzdrik
M0nzdrik collected $0.87 from pot
M0nzdrik: doesn't show hand 
*** SUMMARY ***
Total pot $0.91 | Rake $0.04 
Board [8h As 7d Kd 5d]
Seat 1: ray691027 folded before Flop (didn't bet)
Seat 2: hubertchen55 folded on the River
Seat 3: togl63amg (button) folded before Flop (didn't bet)
Seat 4: Jak_Prihlop (small blind) folded on the Turn
Seat 5: M0nzdrik (big blind) collected ($0.87)
Seat 6: Johan25888 folded before Flop (didn't bet)



PokerStars Hand #201501476528:  Hold'em No Limit ($0.05/$0.10 USD) - 2019/06/18 4:28:58 ET
Table 'Achird' 6-max Seat #4 is the button
Seat 1: ray691027 ($9.78 in chips) 
Seat 2: hubertchen55 ($5.27 in chips) 
Seat 3: togl63amg ($13.23 in chips) 
Seat 4: Jak_Prihlop ($7.84 in chips) 
Seat 5: M0nzdrik ($11.75 in chips) 
Seat 6: Johan25888 ($17.10 in chips) 
M0nzdrik: posts small blind $0.05
Johan25888: posts big blind $0.10
*** HOLE CARDS ***
ray691027: folds 
hubertchen55: folds 
togl63amg: raises $0.20 to $0.30
Jak_Prihlop: calls $0.30
M0nzdrik: folds 
Johan25888: folds 
*** FLOP *** [Ts Tc Js]
togl63amg: bets $0.29
Jak_Prihlop: calls $0.29
*** TURN *** [Ts Tc Js] [7h]
togl63amg: bets $0.71
Jak_Prihlop: folds 
Uncalled bet ($0.71) returned to togl63amg
togl63amg collected $1.27 from pot
*** SUMMARY ***
Total pot $1.33 | Rake $0.06 
Board [Ts Tc Js 7h]
Seat 1: ray691027 folded before Flop (didn't bet)
Seat 2: hubertchen55 folded before Flop (didn't bet)
Seat 3: togl63amg collected ($1.27)
Seat 4: Jak_Prihlop (button) folded on the Turn
Seat 5: M0nzdrik (small blind) folded before Flop
Seat 6: Johan25888 (big blind) folded before Flop



PokerStars Hand #201501483946:  Hold'em No Limit ($0.05/$0.10 USD) - 2019/06/18 4:29:34 ET
Table 'Achird' 6-max Seat #5 is the button
Seat 1: ray691027 ($9.78 in chips) 
Seat 2: hubertchen55 ($5.27 in chips) 
Seat 3: togl63amg ($13.91 in chips) 
Seat 4: Jak_Prihlop ($7.25 in chips) 
Seat 5: M0nzdrik ($11.70 in chips) 
Seat 6: Johan25888 ($17 in chips) 
Johan25888: posts small blind $0.05
ray691027: posts big blind $0.10
*** HOLE CARDS ***
hubertchen55: calls $0.10
togl63amg: folds 
Jak_Prihlop: folds 
M0nzdrik: folds 
Johan25888: calls $0.05
ray691027: checks 
*** FLOP *** [Td Ts 3d]
Johan25888: checks 
ray691027: bets $0.10
hubertchen55: folds 
Johan25888: folds 
Uncalled bet ($0.10) returned to ray691027
ray691027 collected $0.29 from pot
ray691027: doesn't show hand 
*** SUMMARY ***
Total pot $0.30 | Rake $0.01 
Board [Td Ts 3d]
Seat 1: ray691027 (big blind) collected ($0.29)
Seat 2: hubertchen55 folded on the Flop
Seat 3: togl63amg folded before Flop (didn't bet)
Seat 4: Jak_Prihlop folded before Flop (didn't bet)
Seat 5: M0nzdrik (button) folded before Flop (didn't bet)
Seat 6: Johan25888 (small blind) folded on the Flop



PokerStars Hand #201501490343:  Hold'em No Limit ($0.05/$0.10 USD) - 2019/06/18 4:30:05 ET
Table 'Achird' 6-max Seat #6 is the button
Seat 1: ray691027 ($9.97 in chips) 
Seat 2: hubertchen55 ($5.17 in chips) 
Seat 3: togl63amg ($13.91 in chips) 
Seat 4: Jak_Prihlop ($7.25 in chips) 
Seat 5: M0nzdrik ($11.70 in chips) 
Seat 6: Johan25888 ($16.90 in chips) 
ray691027: posts small blind $0.05
hubertchen55: posts big blind $0.10
*** HOLE CARDS ***
togl63amg: folds 
Jak_Prihlop: folds 
M0nzdrik: folds 
Johan25888: raises $0.15 to $0.25
ray691027: calls $0.20
hubertchen55: calls $0.15
*** FLOP *** [2s 3h 7h]
ray691027: checks 
hubertchen55: checks 
Johan25888: bets $0.37
ray691027: folds 
hubertchen55: calls $0.37
*** TURN *** [2s 3h 7h] [Qh]
hubertchen55: checks 
Johan25888: bets $0.98
hubertchen55: folds 
Uncalled bet ($0.98) returned to Johan25888
Johan25888 collected $1.42 from pot
Johan25888: doesn't show hand 
*** SUMMARY ***
Total pot $1.49 | Rake $0.07 
Board [2s 3h 7h Qh]
Seat 1: ray691027 (small blind) folded on the Flop
Seat 2: hubertchen55 (big blind) folded on the Turn
Seat 3: togl63amg folded before Flop (didn't bet)
Seat 4: Jak_Prihlop folded before Flop (didn't bet)
Seat 5: M0nzdrik folded before Flop (didn't bet)
Seat 6: Johan25888 (button) collected ($1.42)



PokerStars Hand #201501500443:  Hold'em No Limit ($0.05/$0.10 USD) - 2019/06/18 4:30:54 ET
Table 'Achird' 6-max Seat #1 is the button
Seat 1: ray691027 ($9.72 in chips) 
Seat 2: hubertchen55 ($4.55 in chips) 
Seat 3: togl63amg ($13.91 in chips) 
Seat 4: Jak_Prihlop ($7.25 in chips) 
Seat 5: M0nzdrik ($11.70 in chips) 
Seat 6: Johan25888 ($17.70 in chips) 
hubertchen55: posts small blind $0.05
togl63amg: posts big blind $0.10
*** HOLE CARDS ***
Jak_Prihlop: folds 
M0nzdrik: folds 
Johan25888: folds 
ray691027: raises $0.20 to $0.30
hubertchen55: folds 
togl63amg: folds 
Uncalled bet ($0.20) returned to ray691027
ray691027 collected $0.25 from pot
*** SUMMARY ***
Total pot $0.25 | Rake $0 
Seat 1: ray691027 (button) collected ($0.25)
Seat 2: hubertchen55 (small blind) folded before Flop
Seat 3: togl63amg (big blind) folded before Flop
Seat 4: Jak_Prihlop folded before Flop (didn't bet)
Seat 5: M0nzdrik folded before Flop (didn't bet)
Seat 6: Johan25888 folded before Flop (didn't bet)



PokerStars Hand #201501560668:  Hold'em No Limit ($0.05/$0.10 USD) - 2019/06/18 4:35:38 ET
Table 'Achird' 6-max Seat #1 is the button
Seat 1: ray691027 ($13.54 in chips) 
Seat 2: hubertchen55 ($4 in chips) 
Seat 3: togl63amg ($13.28 in chips) 
Seat 4: Jak_Prihlop ($7.53 in chips) 
Seat 5: M0nzdrik ($11.64 in chips) 
Seat 6: Johan25888 ($14.44 in chips) 
hubertchen55: posts small blind $0.05
togl63amg: posts big blind $0.10
*** HOLE CARDS ***
Jak_Prihlop: folds 
M0nzdrik: folds 
Johan25888: folds 
ray691027: folds 
hubertchen55: calls $0.05
togl63amg: raises $0.30 to $0.40
hubertchen55: calls $0.30
*** FLOP *** [Ad 9c Jd]
hubertchen55: checks 
togl63amg: bets $0.50
hubertchen55: folds 
Uncalled bet ($0.50) returned to togl63amg
togl63amg collected $0.76 from pot
*** SUMMARY ***
Total pot $0.80 | Rake $0.04 
Board [Ad 9c Jd]
Seat 1: ray691027 (button) folded before Flop (didn't bet)
Seat 2: hubertchen55 (small blind) folded on the Flop
Seat 3: togl63amg (big blind) collected ($0.76)
Seat 4: Jak_Prihlop folded before Flop (didn't bet)
Seat 5: M0nzdrik folded before Flop (didn't bet)
Seat 6: Johan25888 folded before Flop (didn't bet)



PokerStars Hand #201501504235:  Hold'em No Limit ($0.05/$0.10 USD) - 2019/06/18 4:31:12 ET
Table 'Achird' 6-max Seat #2 is the button
Seat 1: ray691027 ($9.87 in chips) 
Seat 2: hubertchen55 ($4.50 in chips) 
Seat 3: togl63amg ($13.81 in chips) 
Seat 4: Jak_Prihlop ($7.25 in chips) 
Seat 5: M0nzdrik ($11.70 in chips) 
Seat 6: Johan25888 ($17.70 in chips) 
togl63amg: posts small blind $0.05
Jak_Prihlop: posts big blind $0.10
*** HOLE CARDS ***
M0nzdrik: folds 
Johan25888: folds 
ray691027: folds 
hubertchen55: folds 
togl63amg: raises $0.20 to $0.30
Jak_Prihlop: calls $0.20
*** FLOP *** [2d 3c Ah]
togl63amg: bets $0.23
Jak_Prihlop: raises $0.23 to $0.46
togl63amg: folds 
Uncalled bet ($0.23) returned to Jak_Prihlop
Jak_Prihlop collected $1.01 from pot
Jak_Prihlop: doesn't show hand 
*** SUMMARY ***
Total pot $1.06 | Rake $0.05 
Board [2d 3c Ah]
Seat 1: ray691027 folded before Flop (didn't bet)
Seat 2: hubertchen55 (button) folded before Flop (didn't bet)
Seat 3: togl63amg (small blind) folded on the Flop
Seat 4: Jak_Prihlop (big blind) collected ($1.01)
Seat 5: M0nzdrik folded before Flop (didn't bet)
Seat 6: Johan25888 folded before Flop (didn't bet)



PokerStars Hand #201501515181:  Hold'em No Limit ($0.05/$0.10 USD) - 2019/06/18 4:32:05 ET
Table 'Achird' 6-max Seat #3 is the button
Seat 1: ray691027 ($9.87 in chips) 
Seat 2: hubertchen55 ($4.50 in chips) 
Seat 3: togl63amg ($13.28 in chips) 
Seat 4: Jak_Prihlop ($7.73 in chips) 
Seat 5: M0nzdrik ($11.70 in chips) 
Seat 6: Johan25888 ($17.70 in chips) 
Jak_Prihlop: posts small blind $0.05
M0nzdrik: posts big blind $0.10
*** HOLE CARDS ***
Johan25888: folds 
ray691027: folds 
hubertchen55: folds 
togl63amg: folds 
Jak_Prihlop: calls $0.05
M0nzdrik: checks 
*** FLOP *** [Jh 4d 3s]
Jak_Prihlop: checks 
M0nzdrik: checks 
*** TURN *** [Jh 4d 3s] [7d]
Jak_Prihlop: checks 
M0nzdrik: checks 
*** RIVER *** [Jh 4d 3s 7d] [5h]
Jak_Prihlop: checks 
M0nzdrik: checks 
*** SHOW DOWN ***
Jak_Prihlop: shows [2s 9d] (high card Jack)
M0nzdrik: shows [9h 2c] (high card Jack)
Jak_Prihlop collected $0.10 from pot
M0nzdrik collected $0.09 from pot
*** SUMMARY ***
Total pot $0.20 | Rake $0.01 
Board [Jh 4d 3s 7d 5h]
Seat 1: ray691027 folded before Flop (didn't bet)
Seat 2: hubertchen55 folded before Flop (didn't bet)
Seat 3: togl63amg (button) folded before Flop (didn't bet)
Seat 4: Jak_Prihlop (small blind) showed [2s 9d] and won ($0.10) with high card Jack
Seat 5: M0nzdrik (big blind) showed [9h 2c] and won ($0.09) with high card Jack
Seat 6: Johan25888 folded before Flop (didn't bet)



PokerStars Hand #201501522439:  Hold'em No Limit ($0.05/$0.10 USD) - 2019/06/18 4:32:39 ET
Table 'Achird' 6-max Seat #4 is the button
Seat 1: ray691027 ($9.87 in chips) 
Seat 2: hubertchen55 ($4.50 in chips) 
Seat 3: togl63amg ($13.28 in chips) 
Seat 4: Jak_Prihlop ($7.73 in chips) 
Seat 5: M0nzdrik ($11.69 in chips) 
Seat 6: Johan25888 ($17.70 in chips) 
M0nzdrik: posts small blind $0.05
Johan25888: posts big blind $0.10
*** HOLE CARDS ***
ray691027: raises $0.20 to $0.30
hubertchen55: calls $0.30
togl63amg: folds 
Jak_Prihlop is disconnected 
Jak_Prihlop has timed out while being disconnected
Jak_Prihlop: folds 
M0nzdrik: folds 
Johan25888: folds 
*** FLOP *** [5c 7c 2s]
ray691027: bets $0.40
hubertchen55: folds 
Uncalled bet ($0.40) returned to ray691027
ray691027 collected $0.72 from pot
ray691027: doesn't show hand 
*** SUMMARY ***
Total pot $0.75 | Rake $0.03 
Board [5c 7c 2s]
Seat 1: ray691027 collected ($0.72)
Seat 2: hubertchen55 folded on the Flop
Seat 3: togl63amg folded before Flop (didn't bet)
Seat 4: Jak_Prihlop (button) folded before Flop (didn't bet)
Seat 5: M0nzdrik (small blind) folded before Flop
Seat 6: Johan25888 (big blind) folded before Flop



PokerStars Hand #201501533772:  Hold'em No Limit ($0.05/$0.10 USD) - 2019/06/18 4:33:33 ET
Table 'Achird' 6-max Seat #5 is the button
Seat 1: ray691027 ($10.29 in chips) 
Seat 2: hubertchen55 ($4.20 in chips) 
Seat 3: togl63amg ($13.28 in chips) 
Seat 4: Jak_Prihlop ($7.73 in chips) 
Seat 5: M0nzdrik ($11.64 in chips) 
Seat 6: Johan25888 ($17.60 in chips) 
Johan25888: posts small blind $0.05
ray691027: posts big blind $0.10
*** HOLE CARDS ***
hubertchen55: folds 
togl63amg: folds 
Jak_Prihlop: folds 
M0nzdrik: folds 
Johan25888: raises $0.20 to $0.30
ray691027: calls $0.20
*** FLOP *** [3c Ts Th]
Johan25888: checks 
ray691027: bets $0.29
Johan25888: folds 
Uncalled bet ($0.29) returned to ray691027
ray691027 collected $0.57 from pot
ray691027: doesn't show hand 
*** SUMMARY ***
Total pot $0.60 | Rake $0.03 
Board [3c Ts Th]
Seat 1: ray691027 (big blind) collected ($0.57)
Seat 2: hubertchen55 folded before Flop (didn't bet)
Seat 3: togl63amg folded before Flop (didn't bet)
Seat 4: Jak_Prihlop folded before Flop (didn't bet)
Seat 5: M0nzdrik (button) folded before Flop (didn't bet)
Seat 6: Johan25888 (small blind) folded on the Flop



PokerStars Hand #201501539880:  Hold'em No Limit ($0.05/$0.10 USD) - 2019/06/18 4:34:01 ET
Table 'Achird' 6-max Seat #6 is the button
Seat 1: ray691027 ($10.56 in chips) 
Seat 2: hubertchen55 ($4.20 in chips) 
Seat 3: togl63amg ($13.28 in chips) 
Seat 4: Jak_Prihlop ($7.73 in chips) 
Seat 5: M0nzdrik ($11.64 in chips) 
Seat 6: Johan25888 ($17.30 in chips) 
ray691027: posts small blind $0.05
hubertchen55: posts big blind $0.10
*** HOLE CARDS ***
togl63amg: folds 
Jak_Prihlop: raises $0.10 to $0.20
M0nzdrik: folds 
Johan25888: calls $0.20
ray691027: calls $0.15
hubertchen55: calls $0.10
*** FLOP *** [7c Jd Jh]
ray691027: bets $0.38
hubertchen55: folds 
Jak_Prihlop: folds 
Johan25888: raises $0.50 to $0.88
ray691027: calls $0.50
*** TURN *** [7c Jd Jh] [4s]
ray691027: checks 
Johan25888: bets $1.78
ray691027: calls $1.78
*** RIVER *** [7c Jd Jh 4s] [4h]
ray691027: bets $3
Johan25888: folds [7h 7s]
Uncalled bet ($3) returned to ray691027
ray691027 collected $5.84 from pot
*** SUMMARY ***
Total pot $6.12 | Rake $0.28 
Board [7c Jd Jh 4s 4h]
Seat 1: ray691027 (small blind) collected ($5.84)
Seat 2: hubertchen55 (big blind) folded on the Flop
Seat 3: togl63amg folded before Flop (didn't bet)
Seat 4: Jak_Prihlop folded on the Flop
Seat 5: M0nzdrik folded before Flop (didn't bet)
Seat 6: Johan25888 (button) folded on the River



PokerStars Hand #201501566624:  Hold'em No Limit ($0.05/$0.10 USD) - 2019/06/18 4:36:06 ET
Table 'Achird' 6-max Seat #2 is the button
Seat 1: ray691027 ($13.54 in chips) 
Seat 2: hubertchen55 ($3.60 in chips) 
Seat 3: togl63amg ($13.64 in chips) 
Seat 4: Jak_Prihlop ($7.53 in chips) 
Seat 5: M0nzdrik ($11.64 in chips) 
Seat 6: Johan25888 ($14.44 in chips) 
togl63amg: posts small blind $0.05
Jak_Prihlop: posts big blind $0.10
*** HOLE CARDS ***
M0nzdrik: folds 
Johan25888: folds 
ray691027: folds 
hubertchen55: calls $0.10
togl63amg: calls $0.05
Jak_Prihlop: checks 
*** FLOP *** [3h Qs Qc]
togl63amg: checks 
Jak_Prihlop: bets $0.10
hubertchen55: calls $0.10
togl63amg: folds 
*** TURN *** [3h Qs Qc] [7d]
Jak_Prihlop: bets $0.20
hubertchen55: raises $0.20 to $0.40
Jak_Prihlop: folds 
Uncalled bet ($0.20) returned to hubertchen55
hubertchen55 collected $0.86 from pot
hubertchen55: doesn't show hand 
*** SUMMARY ***
Total pot $0.90 | Rake $0.04 
Board [3h Qs Qc 7d]
Seat 1: ray691027 folded before Flop (didn't bet)
Seat 2: hubertchen55 (button) collected ($0.86)
Seat 3: togl63amg (small blind) folded on the Flop
Seat 4: Jak_Prihlop (big blind) folded on the Turn
Seat 5: M0nzdrik folded before Flop (didn't bet)
Seat 6: Johan25888 folded before Flop (didn't bet)



PokerStars Hand #201501581814:  Hold'em No Limit ($0.05/$0.10 USD) - 2019/06/18 4:37:16 ET
Table 'Achird' 6-max Seat #3 is the button
Seat 1: ray691027 ($13.54 in chips) 
Seat 2: hubertchen55 ($4.06 in chips) 
Seat 3: togl63amg ($13.54 in chips) 
Seat 4: Jak_Prihlop ($7.13 in chips) 
Seat 5: M0nzdrik ($11.64 in chips) 
Seat 6: Johan25888 ($14.44 in chips) 
Jak_Prihlop: posts small blind $0.05
M0nzdrik: posts big blind $0.10
*** HOLE CARDS ***
Johan25888: raises $0.15 to $0.25
ray691027: folds 
hubertchen55: folds 
togl63amg: calls $0.25
Jak_Prihlop: folds 
M0nzdrik: folds 
*** FLOP *** [2c 8c Kh]
Johan25888: bets $0.32
togl63amg: folds 
Uncalled bet ($0.32) returned to Johan25888
Johan25888 collected $0.62 from pot
Johan25888: doesn't show hand 
*** SUMMARY ***
Total pot $0.65 | Rake $0.03 
Board [2c 8c Kh]
Seat 1: ray691027 folded before Flop (didn't bet)
Seat 2: hubertchen55 folded before Flop (didn't bet)
Seat 3: togl63amg (button) folded on the Flop
Seat 4: Jak_Prihlop (small blind) folded before Flop
Seat 5: M0nzdrik (big blind) folded before Flop
Seat 6: Johan25888 collected ($0.62)



PokerStars Hand #201501587474:  Hold'em No Limit ($0.05/$0.10 USD) - 2019/06/18 4:37:42 ET
Table 'Achird' 6-max Seat #4 is the button
Seat 1: ray691027 ($13.54 in chips) 
Seat 2: hubertchen55 ($4.06 in chips) 
Seat 3: togl63amg ($13.29 in chips) 
Seat 4: Jak_Prihlop ($7.08 in chips) 
Seat 5: M0nzdrik ($11.54 in chips) 
Seat 6: Johan25888 ($14.81 in chips) 
M0nzdrik: posts small blind $0.05
Johan25888: posts big blind $0.10
*** HOLE CARDS ***
ray691027: folds 
hubertchen55: calls $0.10
togl63amg: folds 
Jak_Prihlop: calls $0.10
M0nzdrik: folds 
Johan25888: checks 
*** FLOP *** [Qh 7d Qs]
Johan25888: checks 
hubertchen55: checks 
Jak_Prihlop: checks 
*** TURN *** [Qh 7d Qs] [7h]
Johan25888: checks 
hubertchen55: bets $0.17
Jak_Prihlop: folds 
Johan25888: folds 
Uncalled bet ($0.17) returned to hubertchen55
hubertchen55 collected $0.33 from pot
hubertchen55: doesn't show hand 
*** SUMMARY ***
Total pot $0.35 | Rake $0.02 
Board [Qh 7d Qs 7h]
Seat 1: ray691027 folded before Flop (didn't bet)
Seat 2: hubertchen55 collected ($0.33)
Seat 3: togl63amg folded before Flop (didn't bet)
Seat 4: Jak_Prihlop (button) folded on the Turn
Seat 5: M0nzdrik (small blind) folded before Flop
Seat 6: Johan25888 (big blind) folded on the Turn



PokerStars Hand #201501596593:  Hold'em No Limit ($0.05/$0.10 USD) - 2019/06/18 4:38:24 ET
Table 'Achird' 6-max Seat #5 is the button
Seat 1: ray691027 ($13.54 in chips) 
Seat 2: hubertchen55 ($4.29 in chips) 
Seat 3: togl63amg ($13.29 in chips) 
Seat 4: Jak_Prihlop ($6.98 in chips) 
Seat 5: M0nzdrik ($11.49 in chips) 
Seat 6: Johan25888 ($14.71 in chips) 
Johan25888: posts small blind $0.05
ray691027: posts big blind $0.10
*** HOLE CARDS ***
hubertchen55: folds 
togl63amg: folds 
Jak_Prihlop: raises $0.20 to $0.30
M0nzdrik: raises $0.52 to $0.82
Johan25888: folds 
ray691027: calls $0.72
Jak_Prihlop: calls $0.52
*** FLOP *** [9s 6s Th]
ray691027: checks 
Jak_Prihlop: bets $1.20
M0nzdrik: raises $9.47 to $10.67 and is all-in
ray691027: folds 
Jak_Prihlop: folds 
Uncalled bet ($9.47) returned to M0nzdrik
M0nzdrik collected $4.69 from pot
M0nzdrik: doesn't show hand 
*** SUMMARY ***
Total pot $4.91 | Rake $0.22 
Board [9s 6s Th]
Seat 1: ray691027 (big blind) folded on the Flop
Seat 2: hubertchen55 folded before Flop (didn't bet)
Seat 3: togl63amg folded before Flop (didn't bet)
Seat 4: Jak_Prihlop folded on the Flop
Seat 5: M0nzdrik (button) collected ($4.69)
Seat 6: Johan25888 (small blind) folded before Flop



PokerStars Hand #201501608028:  Hold'em No Limit ($0.05/$0.10 USD) - 2019/06/18 4:39:16 ET
Table 'Achird' 6-max Seat #6 is the button
Seat 1: ray691027 ($12.72 in chips) 
Seat 2: hubertchen55 ($4.29 in chips) 
Seat 3: togl63amg ($13.29 in chips) 
Seat 4: Jak_Prihlop ($4.96 in chips) 
Seat 5: M0nzdrik ($14.16 in chips) 
Seat 6: Johan25888 ($14.66 in chips) 
ray691027: posts small blind $0.05
hubertchen55: posts big blind $0.10
*** HOLE CARDS ***
togl63amg: folds 
Jak_Prihlop: calls $0.10
M0nzdrik: folds 
Johan25888: folds 
ray691027: folds 
hubertchen55: checks 
*** FLOP *** [7c 5s Jd]
hubertchen55: bets $0.10
Jak_Prihlop: calls $0.10
*** TURN *** [7c 5s Jd] [8s]
hubertchen55: bets $0.10
Jak_Prihlop: calls $0.10
*** RIVER *** [7c 5s Jd 8s] [8d]
hubertchen55: bets $0.10
Jak_Prihlop: folds 
Uncalled bet ($0.10) returned to hubertchen55
hubertchen55 collected $0.62 from pot
hubertchen55: doesn't show hand 
*** SUMMARY ***
Total pot $0.65 | Rake $0.03 
Board [7c 5s Jd 8s 8d]
Seat 1: ray691027 (small blind) folded before Flop
Seat 2: hubertchen55 (big blind) collected ($0.62)
Seat 3: togl63amg folded before Flop (didn't bet)
Seat 4: Jak_Prihlop folded on the River
Seat 5: M0nzdrik folded before Flop (didn't bet)
Seat 6: Johan25888 (button) folded before Flop (didn't bet)



PokerStars Hand #201501615040:  Hold'em No Limit ($0.05/$0.10 USD) - 2019/06/18 4:39:49 ET
Table 'Achird' 6-max Seat #1 is the button
Seat 1: ray691027 ($12.67 in chips) 
Seat 2: hubertchen55 ($4.61 in chips) 
Seat 3: togl63amg ($13.29 in chips) 
Seat 4: Jak_Prihlop ($4.66 in chips) 
Seat 5: M0nzdrik ($14.16 in chips) 
Seat 6: Johan25888 ($14.66 in chips) 
hubertchen55: posts small blind $0.05
togl63amg: posts big blind $0.10
*** HOLE CARDS ***
Jak_Prihlop: raises $0.10 to $0.20
M0nzdrik: folds 
Johan25888: folds 
ray691027: calls $0.20
hubertchen55: folds 
togl63amg: folds 
*** FLOP *** [8h Qd 9d]
Jak_Prihlop: bets $0.10
ray691027: calls $0.10
*** TURN *** [8h Qd 9d] [6c]
Jak_Prihlop: checks 
ray691027: checks 
*** RIVER *** [8h Qd 9d 6c] [Jh]
Jak_Prihlop: bets $0.70
ray691027: folds 
Uncalled bet ($0.70) returned to Jak_Prihlop
Jak_Prihlop collected $0.72 from pot
Jak_Prihlop: doesn't show hand 
*** SUMMARY ***
Total pot $0.75 | Rake $0.03 
Board [8h Qd 9d 6c Jh]
Seat 1: ray691027 (button) folded on the River
Seat 2: hubertchen55 (small blind) folded before Flop
Seat 3: togl63amg (big blind) folded before Flop
Seat 4: Jak_Prihlop collected ($0.72)
Seat 5: M0nzdrik folded before Flop (didn't bet)
Seat 6: Johan25888 folded before Flop (didn't bet)



PokerStars Hand #201501623804:  Hold'em No Limit ($0.05/$0.10 USD) - 2019/06/18 4:40:29 ET
Table 'Achird' 6-max Seat #2 is the button
Seat 1: ray691027 ($12.37 in chips) 
Seat 2: hubertchen55 ($4.56 in chips) 
Seat 3: togl63amg ($13.19 in chips) 
Seat 4: Jak_Prihlop ($5.08 in chips) 
Seat 5: M0nzdrik ($14.16 in chips) 
Seat 6: Johan25888 ($14.66 in chips) 
togl63amg: posts small blind $0.05
Jak_Prihlop: posts big blind $0.10
*** HOLE CARDS ***
M0nzdrik: folds 
Johan25888: folds 
ray691027: folds 
hubertchen55: folds 
togl63amg: raises $0.20 to $0.30
Jak_Prihlop: folds 
Uncalled bet ($0.20) returned to togl63amg
togl63amg collected $0.20 from pot
*** SUMMARY ***
Total pot $0.20 | Rake $0 
Seat 1: ray691027 folded before Flop (didn't bet)
Seat 2: hubertchen55 (button) folded before Flop (didn't bet)
Seat 3: togl63amg (small blind) collected ($0.20)
Seat 4: Jak_Prihlop (big blind) folded before Flop
Seat 5: M0nzdrik folded before Flop (didn't bet)
Seat 6: Johan25888 folded before Flop (didn't bet)



PokerStars Hand #201501629647:  Hold'em No Limit ($0.05/$0.10 USD) - 2019/06/18 4:40:56 ET
Table 'Achird' 6-max Seat #3 is the button
Seat 1: ray691027 ($12.37 in chips) 
Seat 2: hubertchen55 ($4.56 in chips) 
Seat 3: togl63amg ($13.29 in chips) 
Seat 4: Jak_Prihlop ($4.98 in chips) 
Seat 5: M0nzdrik ($14.16 in chips) 
Seat 6: Johan25888 ($14.66 in chips) 
Jak_Prihlop: posts small blind $0.05
M0nzdrik: posts big blind $0.10
*** HOLE CARDS ***
Johan25888: raises $0.20 to $0.30
ray691027: folds 
hubertchen55: folds 
togl63amg: folds 
Jak_Prihlop: folds 
M0nzdrik: folds 
Uncalled bet ($0.20) returned to Johan25888
Johan25888 collected $0.25 from pot
Johan25888: doesn't show hand 
*** SUMMARY ***
Total pot $0.25 | Rake $0 
Seat 1: ray691027 folded before Flop (didn't bet)
Seat 2: hubertchen55 folded before Flop (didn't bet)
Seat 3: togl63amg (button) folded before Flop (didn't bet)
Seat 4: Jak_Prihlop (small blind) folded before Flop
Seat 5: M0nzdrik (big blind) folded before Flop
Seat 6: Johan25888 collected ($0.25)



PokerStars Hand #201501633923:  Hold'em No Limit ($0.05/$0.10 USD) - 2019/06/18 4:41:15 ET
Table 'Achird' 6-max Seat #4 is the button
Seat 1: ray691027 ($12.37 in chips) 
Seat 2: hubertchen55 ($4.56 in chips) 
Seat 3: togl63amg ($13.29 in chips) 
Seat 4: Jak_Prihlop ($4.93 in chips) 
Seat 5: M0nzdrik ($14.06 in chips) 
M0nzdrik: posts small blind $0.05
Johan25888: is sitting out 
ray691027: posts big blind $0.10
*** HOLE CARDS ***
hubertchen55: calls $0.10
togl63amg: folds 
Jak_Prihlop: raises $0.20 to $0.30
M0nzdrik: folds 
ray691027: folds 
hubertchen55: calls $0.20
*** FLOP *** [Ad 7d 4s]
hubertchen55: bets $0.72
Jak_Prihlop: folds 
Uncalled bet ($0.72) returned to hubertchen55
hubertchen55 collected $0.72 from pot
hubertchen55: doesn't show hand 
*** SUMMARY ***
Total pot $0.75 | Rake $0.03 
Board [Ad 7d 4s]
Seat 1: ray691027 (big blind) folded before Flop
Seat 2: hubertchen55 collected ($0.72)
Seat 3: togl63amg folded before Flop (didn't bet)
Seat 4: Jak_Prihlop (button) folded on the Flop
Seat 5: M0nzdrik (small blind) folded before Flop



PokerStars Hand #201501639749:  Hold'em No Limit ($0.05/$0.10 USD) - 2019/06/18 4:41:42 ET
Table 'Achird' 6-max Seat #5 is the button
Seat 1: ray691027 ($12.27 in chips) 
Seat 2: hubertchen55 ($4.98 in chips) 
Seat 3: togl63amg ($13.29 in chips) 
Seat 4: Jak_Prihlop ($4.63 in chips) 
Seat 5: M0nzdrik ($14.01 in chips) 
ray691027: posts small blind $0.05
hubertchen55: posts big blind $0.10
*** HOLE CARDS ***
togl63amg: folds 
Jak_Prihlop: calls $0.10
M0nzdrik: calls $0.10
ray691027: folds 
hubertchen55: checks 
*** FLOP *** [Qc As 7d]
hubertchen55: bets $0.10
Jak_Prihlop: calls $0.10
M0nzdrik: folds 
*** TURN *** [Qc As 7d] [Ac]
hubertchen55: bets $0.10
Jak_Prihlop: calls $0.10
*** RIVER *** [Qc As 7d Ac] [8s]
hubertchen55: checks 
Jak_Prihlop: checks 
*** SHOW DOWN ***
hubertchen55: shows [2h Qs] (two pair, Aces and Queens)
Jak_Prihlop: mucks hand 
hubertchen55 collected $0.72 from pot
*** SUMMARY ***
Total pot $0.75 | Rake $0.03 
Board [Qc As 7d Ac 8s]
Seat 1: ray691027 (small blind) folded before Flop
Seat 2: hubertchen55 (big blind) showed [2h Qs] and won ($0.72) with two pair, Aces and Queens
Seat 3: togl63amg folded before Flop (didn't bet)
Seat 4: Jak_Prihlop mucked
Seat 5: M0nzdrik (button) folded on the Flop



PokerStars Hand #201501647729:  Hold'em No Limit ($0.05/$0.10 USD) - 2019/06/18 4:42:18 ET
Table 'Achird' 6-max Seat #1 is the button
Seat 1: ray691027 ($12.22 in chips) 
Seat 2: hubertchen55 ($5.40 in chips) 
Seat 3: togl63amg ($13.29 in chips) 
Seat 4: Jak_Prihlop ($4.33 in chips) 
Seat 5: M0nzdrik ($13.91 in chips) 
hubertchen55: posts small blind $0.05
togl63amg: posts big blind $0.10
*** HOLE CARDS ***
Jak_Prihlop: calls $0.10
M0nzdrik: folds 
ray691027: folds 
hubertchen55: calls $0.05
togl63amg: raises $0.40 to $0.50
Jak_Prihlop: calls $0.40
hubertchen55: folds 
*** FLOP *** [Qs 9c 9h]
togl63amg: checks 
Jak_Prihlop: checks 
*** TURN *** [Qs 9c 9h] [Ah]
togl63amg: checks 
Jak_Prihlop: bets $0.30
togl63amg: calls $0.30
*** RIVER *** [Qs 9c 9h Ah] [2d]
togl63amg: checks 
Jak_Prihlop: bets $0.80
togl63amg: calls $0.80
*** SHOW DOWN ***
Jak_Prihlop: shows [4h Ad] (two pair, Aces and Nines)
togl63amg: mucks hand 
Jak_Prihlop collected $3.15 from pot
*** SUMMARY ***
Total pot $3.30 | Rake $0.15 
Board [Qs 9c 9h Ah 2d]
Seat 1: ray691027 (button) folded before Flop (didn't bet)
Seat 2: hubertchen55 (small blind) folded before Flop
Seat 3: togl63amg (big blind) mucked
Seat 4: Jak_Prihlop showed [4h Ad] and won ($3.15) with two pair, Aces and Nines
Seat 5: M0nzdrik folded before Flop (didn't bet)



PokerStars Hand #201501658918:  Hold'em No Limit ($0.05/$0.10 USD) - 2019/06/18 4:43:08 ET
Table 'Achird' 6-max Seat #2 is the button
Seat 1: ray691027 ($12.22 in chips) 
Seat 2: hubertchen55 ($5.30 in chips) 
Seat 3: togl63amg ($11.69 in chips) 
Seat 4: Jak_Prihlop ($5.88 in chips) 
Seat 5: M0nzdrik ($13.91 in chips) 
togl63amg: posts small blind $0.05
Jak_Prihlop: posts big blind $0.10
*** HOLE CARDS ***
M0nzdrik: raises $0.15 to $0.25
ray691027: folds 
hubertchen55: folds 
togl63amg: folds 
Jak_Prihlop: calls $0.15
*** FLOP *** [8s 9c Qs]
Jak_Prihlop: checks 
M0nzdrik: bets $0.28
Jak_Prihlop: calls $0.28
*** TURN *** [8s 9c Qs] [As]
Jak_Prihlop: checks 
M0nzdrik: bets $0.55
Jak_Prihlop: calls $0.55
*** RIVER *** [8s 9c Qs As] [Ac]
Jak_Prihlop: bets $1.10
M0nzdrik: folds 
Uncalled bet ($1.10) returned to Jak_Prihlop
Jak_Prihlop collected $2.11 from pot
Jak_Prihlop: doesn't show hand 
*** SUMMARY ***
Total pot $2.21 | Rake $0.10 
Board [8s 9c Qs As Ac]
Seat 1: ray691027 folded before Flop (didn't bet)
Seat 2: hubertchen55 (button) folded before Flop (didn't bet)
Seat 3: togl63amg (small blind) folded before Flop
Seat 4: Jak_Prihlop (big blind) collected ($2.11)
Seat 5: M0nzdrik folded on the River



PokerStars Hand #201501666587:  Hold'em No Limit ($0.05/$0.10 USD) - 2019/06/18 4:43:42 ET
Table 'Achird' 6-max Seat #3 is the button
Seat 1: ray691027 ($12.22 in chips) 
Seat 2: hubertchen55 ($5.30 in chips) 
Seat 3: togl63amg ($11.64 in chips) 
Seat 4: Jak_Prihlop ($6.91 in chips) 
Seat 5: M0nzdrik ($12.83 in chips) 
Jak_Prihlop: posts small blind $0.05
M0nzdrik: posts big blind $0.10
*** HOLE CARDS ***
ray691027: folds 
hubertchen55: folds 
togl63amg: raises $0.20 to $0.30
Jak_Prihlop: calls $0.25
M0nzdrik: folds 
*** FLOP *** [Qh As 2s]
Jak_Prihlop: bets $0.10
togl63amg: raises $0.49 to $0.59
Jak_Prihlop: calls $0.49
*** TURN *** [Qh As 2s] [9c]
Jak_Prihlop: checks 
togl63amg: bets $1.30
Jak_Prihlop: folds 
Uncalled bet ($1.30) returned to togl63amg
togl63amg collected $1.80 from pot
*** SUMMARY ***
Total pot $1.88 | Rake $0.08 
Board [Qh As 2s 9c]
Seat 1: ray691027 folded before Flop (didn't bet)
Seat 2: hubertchen55 folded before Flop (didn't bet)
Seat 3: togl63amg (button) collected ($1.80)
Seat 4: Jak_Prihlop (small blind) folded on the Turn
Seat 5: M0nzdrik (big blind) folded before Flop



PokerStars Hand #201501674946:  Hold'em No Limit ($0.05/$0.10 USD) - 2019/06/18 4:44:20 ET
Table 'Achird' 6-max Seat #4 is the button
Seat 1: ray691027 ($12.22 in chips) 
Seat 2: hubertchen55 ($5.30 in chips) 
Seat 3: togl63amg ($12.55 in chips) 
Seat 4: Jak_Prihlop ($6.02 in chips) 
Seat 5: M0nzdrik ($12.73 in chips) 
M0nzdrik: posts small blind $0.05
ray691027: posts big blind $0.10
*** HOLE CARDS ***
hubertchen55: folds 
togl63amg: folds 
Jak_Prihlop: calls $0.10
M0nzdrik: calls $0.05
ray691027: checks 
*** FLOP *** [3c 8c Tc]
M0nzdrik: bets $0.15
ray691027: folds 
Jak_Prihlop: calls $0.15
*** TURN *** [3c 8c Tc] [As]
M0nzdrik: bets $0.48
Jak_Prihlop: raises $0.48 to $0.96
M0nzdrik: raises $5.39 to $6.35
Jak_Prihlop: calls $4.81 and is all-in
Uncalled bet ($0.58) returned to M0nzdrik
*** RIVER *** [3c 8c Tc As] [2s]
*** SHOW DOWN ***
M0nzdrik: shows [9c Qc] (a flush, Queen high)
Jak_Prihlop: shows [3s 3h] (three of a kind, Threes)
M0nzdrik collected $11.59 from pot
*** SUMMARY ***
Total pot $12.14 | Rake $0.55 
Board [3c 8c Tc As 2s]
Seat 1: ray691027 (big blind) folded on the Flop
Seat 2: hubertchen55 folded before Flop (didn't bet)
Seat 3: togl63amg folded before Flop (didn't bet)
Seat 4: Jak_Prihlop (button) showed [3s 3h] and lost with three of a kind, Threes
Seat 5: M0nzdrik (small blind) showed [9c Qc] and won ($11.59) with a flush, Queen high



PokerStars Hand #201501684081:  Hold'em No Limit ($0.05/$0.10 USD) - 2019/06/18 4:45:00 ET
Table 'Achird' 6-max Seat #5 is the button
Seat 1: ray691027 ($12.12 in chips) 
Seat 2: hubertchen55 ($5.30 in chips) 
Seat 3: togl63amg ($12.55 in chips) 
Seat 5: M0nzdrik ($18.30 in chips) 
ray691027: posts small blind $0.05
hubertchen55: posts big blind $0.10
*** HOLE CARDS ***
togl63amg: folds 
M0nzdrik: raises $0.20 to $0.30
ray691027: folds 
Jak_Prihlop leaves the table
NOTfishON joins the table at seat #4 
NOTfishON leaves the table
hubertchen55: calls $0.20
*** FLOP *** [6h Kc 9d]
part0s777 joins the table at seat #4 
hubertchen55: checks 
part0s777 leaves the table
M0nzdrik: bets $0.33
cao87 joins the table at seat #4 
cao87 leaves the table
hubertchen55: folds 
Uncalled bet ($0.33) returned to M0nzdrik
M0nzdrik collected $0.62 from pot
M0nzdrik: doesn't show hand 
*** SUMMARY ***
Total pot $0.65 | Rake $0.03 
Board [6h Kc 9d]
Seat 1: ray691027 (small blind) folded before Flop
Seat 2: hubertchen55 (big blind) folded on the Flop
Seat 3: togl63amg folded before Flop (didn't bet)
Seat 5: M0nzdrik (button) collected ($0.62)



PokerStars Hand #201501690833:  Hold'em No Limit ($0.05/$0.10 USD) - 2019/06/18 4:45:30 ET
Table 'Achird' 6-max Seat #1 is the button
Seat 1: ray691027 ($12.07 in chips) 
Seat 2: hubertchen55 ($5 in chips) 
Seat 3: togl63amg ($12.55 in chips) 
Seat 5: M0nzdrik ($18.62 in chips) 
hubertchen55: posts small blind $0.05
togl63amg: posts big blind $0.10
Johan25888: sits out 
*** HOLE CARDS ***
M0nzdrik: folds 
ray691027: folds 
hubertchen55: calls $0.05
togl63amg: raises $0.30 to $0.40
hubertchen55: folds 
Uncalled bet ($0.30) returned to togl63amg
togl63amg collected $0.20 from pot
*** SUMMARY ***
Total pot $0.20 | Rake $0 
Seat 1: ray691027 (button) folded before Flop (didn't bet)
Seat 2: hubertchen55 (small blind) folded before Flop
Seat 3: togl63amg (big blind) collected ($0.20)
Seat 5: M0nzdrik folded before Flop (didn't bet)



PokerStars Hand #201501701546:  Hold'em No Limit ($0.05/$0.10 USD) - 2019/06/18 4:45:53 ET
Table 'Achird' 6-max Seat #2 is the button
Seat 1: ray691027 ($12.07 in chips) 
Seat 2: hubertchen55 ($4.90 in chips) 
Seat 3: togl63amg ($12.65 in chips) 
Seat 5: M0nzdrik ($18.62 in chips) 
togl63amg: posts small blind $0.05
M0nzdrik: posts big blind $0.10
Johan25888: sits out 
*** HOLE CARDS ***
quarantinne joins the table at seat #4 
ray691027: folds 
hubertchen55: calls $0.10
togl63amg: raises $0.40 to $0.50
M0nzdrik: folds 
hubertchen55: calls $0.40
*** FLOP *** [6h 8s 9c]
togl63amg: checks 
hubertchen55: bets $0.53
togl63amg: calls $0.53
*** TURN *** [6h 8s 9c] [4h]
togl63amg: checks 
hubertchen55: checks 
*** RIVER *** [6h 8s 9c 4h] [3s]
togl63amg: checks 
hubertchen55: checks 
*** SHOW DOWN ***
togl63amg: shows [Ts Ac] (high card Ace)
hubertchen55: shows [6c 5c] (a pair of Sixes)
hubertchen55 collected $2.06 from pot
*** SUMMARY ***
Total pot $2.16 | Rake $0.10 
Board [6h 8s 9c 4h 3s]
Seat 1: ray691027 folded before Flop (didn't bet)
Seat 2: hubertchen55 (button) showed [6c 5c] and won ($2.06) with a pair of Sixes
Seat 3: togl63amg (small blind) showed [Ts Ac] and lost with high card Ace
Seat 5: M0nzdrik (big blind) folded before Flop



PokerStars Hand #201501710430:  Hold'em No Limit ($0.05/$0.10 USD) - 2019/06/18 4:46:33 ET
Table 'Achird' 6-max Seat #3 is the button
Seat 1: ray691027 ($12.07 in chips) 
Seat 2: hubertchen55 ($5.93 in chips) 
Seat 3: togl63amg ($11.62 in chips) 
Seat 5: M0nzdrik ($18.52 in chips) 
Seat 6: Johan25888 ($14.81 in chips) 
M0nzdrik: posts small blind $0.05
Johan25888: posts big blind $0.10
*** HOLE CARDS ***
ray691027: raises $0.20 to $0.30
hubertchen55: folds 
togl63amg: folds 
M0nzdrik: folds 
Johan25888: folds 
Uncalled bet ($0.20) returned to ray691027
ray691027 collected $0.25 from pot
ray691027: doesn't show hand 
*** SUMMARY ***
Total pot $0.25 | Rake $0 
Seat 1: ray691027 collected ($0.25)
Seat 2: hubertchen55 folded before Flop (didn't bet)
Seat 3: togl63amg (button) folded before Flop (didn't bet)
Seat 5: M0nzdrik (small blind) folded before Flop
Seat 6: Johan25888 (big blind) folded before Flop



PokerStars Hand #201501714148:  Hold'em No Limit ($0.05/$0.10 USD) - 2019/06/18 4:46:50 ET
Table 'Achird' 6-max Seat #5 is the button
Seat 1: ray691027 ($12.22 in chips) 
Seat 2: hubertchen55 ($5.93 in chips) 
Seat 3: togl63amg ($11.62 in chips) 
Seat 5: M0nzdrik ($18.47 in chips) 
Seat 6: Johan25888 ($14.71 in chips) 
Johan25888: posts small blind $0.05
ray691027: posts big blind $0.10
quarantinne: sits out 
*** HOLE CARDS ***
hubertchen55: folds 
togl63amg: folds 
M0nzdrik: folds 
Johan25888: raises $0.20 to $0.30
ray691027: folds 
Uncalled bet ($0.20) returned to Johan25888
Johan25888 collected $0.20 from pot
Johan25888: doesn't show hand 
*** SUMMARY ***
Total pot $0.20 | Rake $0 
Seat 1: ray691027 (big blind) folded before Flop
Seat 2: hubertchen55 folded before Flop (didn't bet)
Seat 3: togl63amg folded before Flop (didn't bet)
Seat 5: M0nzdrik (button) folded before Flop (didn't bet)
Seat 6: Johan25888 (small blind) collected ($0.20)



PokerStars Hand #201501718078:  Hold'em No Limit ($0.05/$0.10 USD) - 2019/06/18 4:47:07 ET
Table 'Achird' 6-max Seat #6 is the button
Seat 1: ray691027 ($12.12 in chips) 
Seat 2: hubertchen55 ($5.93 in chips) 
Seat 3: togl63amg ($11.62 in chips) 
Seat 5: M0nzdrik ($18.47 in chips) 
Seat 6: Johan25888 ($14.81 in chips) 
ray691027: posts small blind $0.05
hubertchen55: posts big blind $0.10
quarantinne: sits out 
*** HOLE CARDS ***
togl63amg: folds 
M0nzdrik: raises $0.15 to $0.25
Johan25888: folds 
ray691027: folds 
hubertchen55: calls $0.15
*** FLOP *** [Jh 8s 5d]
hubertchen55: checks 
M0nzdrik: bets $0.28
hubertchen55: folds 
Uncalled bet ($0.28) returned to M0nzdrik
M0nzdrik collected $0.53 from pot
M0nzdrik: doesn't show hand 
*** SUMMARY ***
Total pot $0.55 | Rake $0.02 
Board [Jh 8s 5d]
Seat 1: ray691027 (small blind) folded before Flop
Seat 2: hubertchen55 (big blind) folded on the Flop
Seat 3: togl63amg folded before Flop (didn't bet)
Seat 5: M0nzdrik collected ($0.53)
Seat 6: Johan25888 (button) folded before Flop (didn't bet)



PokerStars Hand #201501725483:  Hold'em No Limit ($0.05/$0.10 USD) - 2019/06/18 4:47:41 ET
Table 'Achird' 6-max Seat #1 is the button
Seat 1: ray691027 ($12.07 in chips) 
Seat 2: hubertchen55 ($5.68 in chips) 
Seat 3: togl63amg ($11.62 in chips) 
Seat 5: M0nzdrik ($18.75 in chips) 
Seat 6: Johan25888 ($14.81 in chips) 
hubertchen55: posts small blind $0.05
togl63amg: posts big blind $0.10
quarantinne: sits out 
*** HOLE CARDS ***
M0nzdrik: folds 
Johan25888: folds 
ray691027: folds 
hubertchen55: calls $0.05
togl63amg: raises $0.30 to $0.40
hubertchen55: calls $0.30
*** FLOP *** [4d 5c Ac]
hubertchen55: bets $0.38
togl63amg: raises $0.85 to $1.23
hubertchen55: folds 
Uncalled bet ($0.85) returned to togl63amg
togl63amg collected $1.49 from pot
*** SUMMARY ***
Total pot $1.56 | Rake $0.07 
Board [4d 5c Ac]
Seat 1: ray691027 (button) folded before Flop (didn't bet)
Seat 2: hubertchen55 (small blind) folded on the Flop
Seat 3: togl63amg (big blind) collected ($1.49)
Seat 5: M0nzdrik folded before Flop (didn't bet)
Seat 6: Johan25888 folded before Flop (didn't bet)



PokerStars Hand #201501731799:  Hold'em No Limit ($0.05/$0.10 USD) - 2019/06/18 4:48:09 ET
Table 'Achird' 6-max Seat #2 is the button
Seat 1: ray691027 ($12.07 in chips) 
Seat 2: hubertchen55 ($4.90 in chips) 
Seat 3: togl63amg ($12.33 in chips) 
Seat 4: quarantinne ($10 in chips) 
Seat 5: M0nzdrik ($18.75 in chips) 
Seat 6: Johan25888 ($14.81 in chips) 
togl63amg: posts small blind $0.05
quarantinne: posts big blind $0.10
*** HOLE CARDS ***
M0nzdrik: folds 
Johan25888: folds 
ray691027: raises $0.20 to $0.30
hubertchen55: folds 
togl63amg: folds 
quarantinne: folds 
Uncalled bet ($0.20) returned to ray691027
ray691027 collected $0.25 from pot
ray691027: doesn't show hand 
*** SUMMARY ***
Total pot $0.25 | Rake $0 
Seat 1: ray691027 collected ($0.25)
Seat 2: hubertchen55 (button) folded before Flop (didn't bet)
Seat 3: togl63amg (small blind) folded before Flop
Seat 4: quarantinne (big blind) folded before Flop
Seat 5: M0nzdrik folded before Flop (didn't bet)
Seat 6: Johan25888 folded before Flop (didn't bet)



PokerStars Hand #201501734944:  Hold'em No Limit ($0.05/$0.10 USD) - 2019/06/18 4:48:23 ET
Table 'Achird' 6-max Seat #3 is the button
Seat 1: ray691027 ($12.22 in chips) 
Seat 2: hubertchen55 ($4.90 in chips) 
Seat 3: togl63amg ($12.28 in chips) 
Seat 4: quarantinne ($10 in chips) 
Seat 5: M0nzdrik ($18.75 in chips) 
Seat 6: Johan25888 ($14.81 in chips) 
quarantinne: posts small blind $0.05
M0nzdrik: posts big blind $0.10
*** HOLE CARDS ***
Johan25888: folds 
ray691027: folds 
hubertchen55: folds 
togl63amg: folds 
quarantinne: folds 
Uncalled bet ($0.05) returned to M0nzdrik
M0nzdrik collected $0.10 from pot
M0nzdrik: doesn't show hand 
*** SUMMARY ***
Total pot $0.10 | Rake $0 
Seat 1: ray691027 folded before Flop (didn't bet)
Seat 2: hubertchen55 folded before Flop (didn't bet)
Seat 3: togl63amg (button) folded before Flop (didn't bet)
Seat 4: quarantinne (small blind) folded before Flop
Seat 5: M0nzdrik (big blind) collected ($0.10)
Seat 6: Johan25888 folded before Flop (didn't bet)



PokerStars Hand #201501739355:  Hold'em No Limit ($0.05/$0.10 USD) - 2019/06/18 4:48:42 ET
Table 'Achird' 6-max Seat #4 is the button
Seat 1: ray691027 ($12.22 in chips) 
Seat 2: hubertchen55 ($4.90 in chips) 
Seat 3: togl63amg ($12.28 in chips) 
Seat 4: quarantinne ($10 in chips) 
Seat 5: M0nzdrik ($18.80 in chips) 
Seat 6: Johan25888 ($14.81 in chips) 
M0nzdrik: posts small blind $0.05
Johan25888: posts big blind $0.10
*** HOLE CARDS ***
ray691027: folds 
hubertchen55: folds 
togl63amg: raises $0.20 to $0.30
quarantinne: raises $0.60 to $0.90
M0nzdrik: folds 
Johan25888: folds 
togl63amg: raises $1.40 to $2.30
quarantinne: folds 
Uncalled bet ($1.40) returned to togl63amg
togl63amg collected $1.95 from pot
*** SUMMARY ***
Total pot $1.95 | Rake $0 
Seat 1: ray691027 folded before Flop (didn't bet)
Seat 2: hubertchen55 folded before Flop (didn't bet)
Seat 3: togl63amg collected ($1.95)
Seat 4: quarantinne (button) folded before Flop
Seat 5: M0nzdrik (small blind) folded before Flop
Seat 6: Johan25888 (big blind) folded before Flop



PokerStars Hand #201501749325:  Hold'em No Limit ($0.05/$0.10 USD) - 2019/06/18 4:49:27 ET
Table 'Achird' 6-max Seat #5 is the button
Seat 1: ray691027 ($12.22 in chips) 
Seat 2: hubertchen55 ($4.90 in chips) 
Seat 3: togl63amg ($13.33 in chips) 
Seat 4: quarantinne ($10 in chips) 
Seat 5: M0nzdrik ($18.75 in chips) 
Seat 6: Johan25888 ($14.71 in chips) 
Johan25888: posts small blind $0.05
ray691027: posts big blind $0.10
*** HOLE CARDS ***
hubertchen55: folds 
togl63amg: folds 
quarantinne: raises $0.15 to $0.25
M0nzdrik: folds 
Johan25888: folds 
ray691027: raises $0.55 to $0.80
quarantinne: folds 
Uncalled bet ($0.55) returned to ray691027
ray691027 collected $0.55 from pot
ray691027: doesn't show hand 
*** SUMMARY ***
Total pot $0.55 | Rake $0 
Seat 1: ray691027 (big blind) collected ($0.55)
Seat 2: hubertchen55 folded before Flop (didn't bet)
Seat 3: togl63amg folded before Flop (didn't bet)
Seat 4: quarantinne folded before Flop
Seat 5: M0nzdrik (button) folded before Flop (didn't bet)
Seat 6: Johan25888 (small blind) folded before Flop



PokerStars Hand #201501757808:  Hold'em No Limit ($0.05/$0.10 USD) - 2019/06/18 4:50:04 ET
Table 'Achird' 6-max Seat #6 is the button
Seat 1: ray691027 ($12.52 in chips) 
Seat 2: hubertchen55 ($4.90 in chips) 
Seat 3: togl63amg ($13.33 in chips) 
Seat 4: quarantinne ($10 in chips) 
Seat 5: M0nzdrik ($18.75 in chips) 
Seat 6: Johan25888 ($14.66 in chips) 
ray691027: posts small blind $0.05
hubertchen55: posts big blind $0.10
*** HOLE CARDS ***
togl63amg: folds 
quarantinne: folds 
M0nzdrik: folds 
Johan25888: folds 
ray691027: calls $0.05
hubertchen55: checks 
*** FLOP *** [Th As 2d]
ray691027: bets $0.10
hubertchen55: folds 
Uncalled bet ($0.10) returned to ray691027
ray691027 collected $0.19 from pot
ray691027: doesn't show hand 
*** SUMMARY ***
Total pot $0.20 | Rake $0.01 
Board [Th As 2d]
Seat 1: ray691027 (small blind) collected ($0.19)
Seat 2: hubertchen55 (big blind) folded on the Flop
Seat 3: togl63amg folded before Flop (didn't bet)
Seat 4: quarantinne folded before Flop (didn't bet)
Seat 5: M0nzdrik folded before Flop (didn't bet)
Seat 6: Johan25888 (button) folded before Flop (didn't bet)



PokerStars Hand #201501762393:  Hold'em No Limit ($0.05/$0.10 USD) - 2019/06/18 4:50:25 ET
Table 'Achird' 6-max Seat #1 is the button
Seat 1: ray691027 ($12.61 in chips) 
Seat 2: hubertchen55 ($4.80 in chips) 
Seat 3: togl63amg ($13.33 in chips) 
Seat 4: quarantinne ($10 in chips) 
Seat 5: M0nzdrik ($18.75 in chips) 
Seat 6: Johan25888 ($14.66 in chips) 
hubertchen55: posts small blind $0.05
togl63amg: posts big blind $0.10
*** HOLE CARDS ***
quarantinne: folds 
M0nzdrik: raises $0.20 to $0.30
Johan25888: folds 
ray691027: folds 
hubertchen55: calls $0.25
togl63amg: raises $1.10 to $1.40
M0nzdrik: calls $1.10
hubertchen55: calls $1.10
*** FLOP *** [3h 6h 8h]
hubertchen55: bets $3.40 and is all-in
togl63amg: calls $3.40
M0nzdrik: raises $13.95 to $17.35 and is all-in
togl63amg: calls $8.53 and is all-in
Uncalled bet ($5.42) returned to M0nzdrik
*** TURN *** [3h 6h 8h] [7d]
*** RIVER *** [3h 6h 8h 7d] [7c]
*** SHOW DOWN ***
togl63amg: shows [Kc Kh] (two pair, Kings and Sevens)
M0nzdrik: shows [Ad Ah] (two pair, Aces and Sevens)
M0nzdrik collected $16.29 from side pot
hubertchen55: shows [Qh As] (a pair of Sevens)
M0nzdrik collected $13.75 from main pot
*** SUMMARY ***
Total pot $31.46 Main pot $13.75. Side pot $16.29. | Rake $1.42 
Board [3h 6h 8h 7d 7c]
Seat 1: ray691027 (button) folded before Flop (didn't bet)
Seat 2: hubertchen55 (small blind) showed [Qh As] and lost with a pair of Sevens
Seat 3: togl63amg (big blind) showed [Kc Kh] and lost with two pair, Kings and Sevens
Seat 4: quarantinne folded before Flop (didn't bet)
Seat 5: M0nzdrik showed [Ad Ah] and won ($30.04) with two pair, Aces and Sevens
Seat 6: Johan25888 folded before Flop (didn't bet)



PokerStars Hand #201501773942:  Hold'em No Limit ($0.05/$0.10 USD) - 2019/06/18 4:51:15 ET
Table 'Achird' 6-max Seat #3 is the button
Seat 1: ray691027 ($12.61 in chips) 
Seat 3: togl63amg ($10 in chips) 
Seat 4: quarantinne ($10 in chips) 
Seat 5: M0nzdrik ($35.46 in chips) 
Seat 6: Johan25888 ($14.66 in chips) 
quarantinne: posts small blind $0.05
M0nzdrik: posts big blind $0.10
*** HOLE CARDS ***
Johan25888: raises $0.20 to $0.30
ray691027: calls $0.30
togl63amg: folds 
hubertchen55 leaves the table
quarantinne: folds 
Aleks1988baik joins the table at seat #2 
M0nzdrik: folds 
*** FLOP *** [Kh 4h 6h]
Johan25888: bets $0.37
ray691027: folds 
Uncalled bet ($0.37) returned to Johan25888
Johan25888 collected $0.72 from pot
Johan25888: doesn't show hand 
*** SUMMARY ***
Total pot $0.75 | Rake $0.03 
Board [Kh 4h 6h]
Seat 1: ray691027 folded on the Flop
Seat 3: togl63amg (button) folded before Flop (didn't bet)
Seat 4: quarantinne (small blind) folded before Flop
Seat 5: M0nzdrik (big blind) folded before Flop
Seat 6: Johan25888 collected ($0.72)



PokerStars Hand #201501779862:  Hold'em No Limit ($0.05/$0.10 USD) - 2019/06/18 4:51:41 ET
Table 'Achird' 6-max Seat #4 is the button
Seat 1: ray691027 ($12.31 in chips) 
Seat 3: togl63amg ($10 in chips) 
Seat 4: quarantinne ($10 in chips) 
Seat 5: M0nzdrik ($35.36 in chips) 
Seat 6: Johan25888 ($15.08 in chips) 
M0nzdrik: posts small blind $0.05
Johan25888: posts big blind $0.10
Aleks1988baik: sits out 
*** HOLE CARDS ***
ray691027: raises $0.20 to $0.30
togl63amg: folds 
quarantinne: folds 
M0nzdrik: folds 
Johan25888: folds 
Uncalled bet ($0.20) returned to ray691027
ray691027 collected $0.25 from pot
ray691027: doesn't show hand 
*** SUMMARY ***
Total pot $0.25 | Rake $0 
Seat 1: ray691027 collected ($0.25)
Seat 3: togl63amg folded before Flop (didn't bet)
Seat 4: quarantinne (button) folded before Flop (didn't bet)
Seat 5: M0nzdrik (small blind) folded before Flop
Seat 6: Johan25888 (big blind) folded before Flop



PokerStars Hand #201501782841:  Hold'em No Limit ($0.05/$0.10 USD) - 2019/06/18 4:51:54 ET
Table 'Achird' 6-max Seat #5 is the button
Seat 1: ray691027 ($12.46 in chips) 
Seat 3: togl63amg ($10 in chips) 
Seat 4: quarantinne ($10 in chips) 
Seat 5: M0nzdrik ($35.31 in chips) 
Seat 6: Johan25888 ($14.98 in chips) 
Johan25888: posts small blind $0.05
ray691027: posts big blind $0.10
Aleks1988baik: sits out 
*** HOLE CARDS ***
togl63amg: folds 
quarantinne: raises $0.15 to $0.25
M0nzdrik: folds 
Johan25888: folds 
ray691027: folds 
Uncalled bet ($0.15) returned to quarantinne
Aleks1988baik leaves the table
quarantinne collected $0.25 from pot
quarantinne: doesn't show hand 
*** SUMMARY ***
Total pot $0.25 | Rake $0 
Seat 1: ray691027 (big blind) folded before Flop
Seat 3: togl63amg folded before Flop (didn't bet)
Seat 4: quarantinne collected ($0.25)
Seat 5: M0nzdrik (button) folded before Flop (didn't bet)
Seat 6: Johan25888 (small blind) folded before Flop



PokerStars Hand #201501787728:  Hold'em No Limit ($0.05/$0.10 USD) - 2019/06/18 4:52:16 ET
Table 'Achird' 6-max Seat #6 is the button
Seat 1: ray691027 ($12.36 in chips) 
Seat 3: togl63amg ($10 in chips) 
Seat 4: quarantinne ($10.15 in chips) 
Seat 5: M0nzdrik ($35.31 in chips) 
Seat 6: Johan25888 ($14.93 in chips) 
ray691027: posts small blind $0.05
togl63amg: posts big blind $0.10
*** HOLE CARDS ***
quarantinne: folds 
M0nzdrik: raises $0.15 to $0.25
Johan25888: folds 
ray691027: folds 
togl63amg: folds 
Uncalled bet ($0.15) returned to M0nzdrik
M0nzdrik collected $0.25 from pot
M0nzdrik: doesn't show hand 
*** SUMMARY ***
Total pot $0.25 | Rake $0 
Seat 1: ray691027 (small blind) folded before Flop
Seat 3: togl63amg (big blind) folded before Flop
Seat 4: quarantinne folded before Flop (didn't bet)
Seat 5: M0nzdrik collected ($0.25)
Seat 6: Johan25888 (button) folded before Flop (didn't bet)



PokerStars Hand #201501792928:  Hold'em No Limit ($0.05/$0.10 USD) - 2019/06/18 4:52:39 ET
Table 'Achird' 6-max Seat #1 is the button
Seat 1: ray691027 ($12.31 in chips) 
Seat 3: togl63amg ($10 in chips) 
Seat 6: Johan25888 ($14.93 in chips) 
togl63amg: posts small blind $0.05
quarantinne: is sitting out 
M0nzdrik: is sitting out 
Johan25888: posts big blind $0.10
*** HOLE CARDS ***
M0nzdrik leaves the table
ray691027: folds 
quarantinne leaves the table
jext joins the table at seat #2 
togl63amg: folds 
Uncalled bet ($0.05) returned to Johan25888
ray691027 leaves the table
Johan25888 collected $0.10 from pot
Johan25888: doesn't show hand 
*** SUMMARY ***
Total pot $0.10 | Rake $0 
Seat 1: ray691027 (button) folded before Flop (didn't bet)
Seat 3: togl63amg (small blind) folded before Flop
Seat 6: Johan25888 (big blind) collected ($0.10)



PokerStars Hand #201501836508:  Hold'em No Limit ($0.05/$0.10 USD) - 2019/06/18 4:55:54 ET
Table 'Achird' 6-max Seat #3 is the button
Seat 1: Ngochuyen93 ($10 in chips) 
Seat 3: Vodogrey8 ($10 in chips) 
Vodogrey8: posts small blind $0.05
Ngochuyen93: posts big blind $0.10
*** HOLE CARDS ***
Vodogrey8: raises $0.20 to $0.30
tremsbuettel joins the table at seat #2 
Ngochuyen93: calls $0.20
*** FLOP *** [7h Qd 4d]
yzsbob joins the table at seat #4 
Ngochuyen93: bets $0.30
Vodogrey8: calls $0.30
*** TURN *** [7h Qd 4d] [3c]
Alinyr joins the table at seat #5 
Ngochuyen93: bets $0.60
Beks789 joins the table at seat #6 
Vodogrey8: folds 
Uncalled bet ($0.60) returned to Ngochuyen93
Ngochuyen93 collected $1.15 from pot
Ngochuyen93: doesn't show hand 
*** SUMMARY ***
Total pot $1.20 | Rake $0.05 
Board [7h Qd 4d 3c]
Seat 1: Ngochuyen93 (big blind) collected ($1.15)
Seat 3: Vodogrey8 (button) (small blind) folded on the Turn



PokerStars Hand #201501840667:  Hold'em No Limit ($0.05/$0.10 USD) - 2019/06/18 4:56:15 ET
Table 'Achird' 6-max Seat #1 is the button
Seat 1: Ngochuyen93 ($10.55 in chips) 
Seat 3: Vodogrey8 ($10 in chips) 
Seat 4: yzsbob ($10 in chips) 
Vodogrey8: posts small blind $0.05
yzsbob: posts big blind $0.10
Alinyr: sits out 
Beks789: sits out 
*** HOLE CARDS ***
Ngochuyen93: raises $0.20 to $0.30
Vodogrey8: folds 
yzsbob: folds 
Uncalled bet ($0.20) returned to Ngochuyen93
Ngochuyen93 collected $0.25 from pot
*** SUMMARY ***
Total pot $0.25 | Rake $0 
Seat 1: Ngochuyen93 (button) collected ($0.25)
Seat 3: Vodogrey8 (small blind) folded before Flop
Seat 4: yzsbob (big blind) folded before Flop



PokerStars Hand #201501842961:  Hold'em No Limit ($0.05/$0.10 USD) - 2019/06/18 4:56:27 ET
Table 'Achird' 6-max Seat #3 is the button
Seat 1: Ngochuyen93 ($10.70 in chips) 
Seat 2: tremsbuettel ($8 in chips) 
Seat 3: Vodogrey8 ($10 in chips) 
Seat 4: yzsbob ($9.90 in chips) 
Seat 5: Alinyr ($10.56 in chips) 
yzsbob: posts small blind $0.05
Alinyr: posts big blind $0.10
tremsbuettel: posts big blind $0.10
*** HOLE CARDS ***
Ngochuyen93: calls $0.10
tremsbuettel: checks 
Vodogrey8: folds 
yzsbob: raises $0.10 to $0.20
Alinyr: calls $0.10
Ngochuyen93: raises $0.10 to $0.30
tremsbuettel: folds 
yzsbob: calls $0.10
Alinyr: calls $0.10
*** FLOP *** [6h Js 8h]
yzsbob: checks 
Alinyr: checks 
Ngochuyen93: checks 
*** TURN *** [6h Js 8h] [9d]
yzsbob: bets $0.20
Alinyr: folds 
Ngochuyen93: calls $0.20
*** RIVER *** [6h Js 8h 9d] [Td]
yzsbob: bets $0.70
Ngochuyen93: folds 
Uncalled bet ($0.70) returned to yzsbob
yzsbob collected $1.34 from pot
yzsbob: doesn't show hand 
*** SUMMARY ***
Total pot $1.40 | Rake $0.06 
Board [6h Js 8h 9d Td]
Seat 1: Ngochuyen93 folded on the River
Seat 2: tremsbuettel folded before Flop (didn't bet)
Seat 3: Vodogrey8 (button) folded before Flop (didn't bet)
Seat 4: yzsbob (small blind) collected ($1.34)
Seat 5: Alinyr (big blind) folded on the Turn



PokerStars Hand #201501853417:  Hold'em No Limit ($0.05/$0.10 USD) - 2019/06/18 4:57:19 ET
Table 'Achird' 6-max Seat #4 is the button
Seat 1: Ngochuyen93 ($10.20 in chips) 
Seat 2: tremsbuettel ($7.90 in chips) 
Seat 3: Vodogrey8 ($10 in chips) 
Seat 4: yzsbob ($10.74 in chips) 
Seat 5: Alinyr ($10.26 in chips) 
Seat 6: Beks789 ($10 in chips) 
Alinyr: posts small blind $0.05
Beks789: posts big blind $0.10
*** HOLE CARDS ***
Ngochuyen93: raises $0.10 to $0.20
tremsbuettel: calls $0.20
Vodogrey8: folds 
yzsbob: folds 
Alinyr: folds 
Beks789: raises $1 to $1.20
Ngochuyen93: calls $1
tremsbuettel: calls $1
*** FLOP *** [Jc Ad 4h]
Beks789: bets $0.87
Ngochuyen93: calls $0.87
tremsbuettel: calls $0.87
*** TURN *** [Jc Ad 4h] [3d]
Beks789: checks 
Ngochuyen93: checks 
tremsbuettel: checks 
*** RIVER *** [Jc Ad 4h 3d] [Ks]
Beks789: checks 
Ngochuyen93: bets $2.20
tremsbuettel: folds 
Beks789: folds 
Uncalled bet ($2.20) returned to Ngochuyen93
Ngochuyen93 collected $5.98 from pot
Ngochuyen93: doesn't show hand 
*** SUMMARY ***
Total pot $6.26 | Rake $0.28 
Board [Jc Ad 4h 3d Ks]
Seat 1: Ngochuyen93 collected ($5.98)
Seat 2: tremsbuettel folded on the River
Seat 3: Vodogrey8 folded before Flop (didn't bet)
Seat 4: yzsbob (button) folded before Flop (didn't bet)
Seat 5: Alinyr (small blind) folded before Flop
Seat 6: Beks789 (big blind) folded on the River



PokerStars Hand #201501873488:  Hold'em No Limit ($0.05/$0.10 USD) - 2019/06/18 4:58:59 ET
Table 'Achird' 6-max Seat #5 is the button
Seat 1: Ngochuyen93 ($14.11 in chips) 
Seat 2: tremsbuettel ($5.83 in chips) 
Seat 3: Vodogrey8 ($10 in chips) 
Seat 4: yzsbob ($10.74 in chips) 
Seat 5: Alinyr ($10.21 in chips) 
Seat 6: Beks789 ($10 in chips) 
Beks789: posts small blind $0.05
Ngochuyen93: posts big blind $0.10
*** HOLE CARDS ***
tremsbuettel: folds 
Vodogrey8: folds 
yzsbob: folds 
Alinyr: raises $0.15 to $0.25
Beks789: folds 
Ngochuyen93: folds 
Uncalled bet ($0.15) returned to Alinyr
Alinyr collected $0.25 from pot
Alinyr: doesn't show hand 
*** SUMMARY ***
Total pot $0.25 | Rake $0 
Seat 1: Ngochuyen93 (big blind) folded before Flop
Seat 2: tremsbuettel folded before Flop (didn't bet)
Seat 3: Vodogrey8 folded before Flop (didn't bet)
Seat 4: yzsbob folded before Flop (didn't bet)
Seat 5: Alinyr (button) collected ($0.25)
Seat 6: Beks789 (small blind) folded before Flop



PokerStars Hand #201501878031:  Hold'em No Limit ($0.05/$0.10 USD) - 2019/06/18 4:59:22 ET
Table 'Achird' 6-max Seat #6 is the button
Seat 1: Ngochuyen93 ($14.01 in chips) 
Seat 2: tremsbuettel ($5.83 in chips) 
Seat 3: Vodogrey8 ($10 in chips) 
Seat 4: yzsbob ($10.74 in chips) 
Seat 5: Alinyr ($10.36 in chips) 
Seat 6: Beks789 ($10 in chips) 
Ngochuyen93: posts small blind $0.05
tremsbuettel: posts big blind $0.10
*** HOLE CARDS ***
Vodogrey8: folds 
yzsbob: raises $0.20 to $0.30
Alinyr: folds 
Beks789: folds 
Ngochuyen93: calls $0.25
tremsbuettel: calls $0.20
*** FLOP *** [5c 6d Jc]
Ngochuyen93: bets $0.10
tremsbuettel: calls $0.10
yzsbob: raises $0.30 to $0.40
Ngochuyen93: calls $0.30
tremsbuettel: calls $0.30
*** TURN *** [5c 6d Jc] [7h]
Ngochuyen93: checks 
tremsbuettel: checks 
yzsbob: checks 
*** RIVER *** [5c 6d Jc 7h] [9s]
Ngochuyen93: bets $1
tremsbuettel: calls $1
yzsbob: folds 
*** SHOW DOWN ***
Ngochuyen93: shows [2c 9c] (a pair of Nines)
tremsbuettel: shows [8c 8h] (a straight, Five to Nine)
tremsbuettel collected $3.92 from pot
*** SUMMARY ***
Total pot $4.10 | Rake $0.18 
Board [5c 6d Jc 7h 9s]
Seat 1: Ngochuyen93 (small blind) showed [2c 9c] and lost with a pair of Nines
Seat 2: tremsbuettel (big blind) showed [8c 8h] and won ($3.92) with a straight, Five to Nine
Seat 3: Vodogrey8 folded before Flop (didn't bet)
Seat 4: yzsbob folded on the River
Seat 5: Alinyr folded before Flop (didn't bet)
Seat 6: Beks789 (button) folded before Flop (didn't bet)



PokerStars Hand #201501891763:  Hold'em No Limit ($0.05/$0.10 USD) - 2019/06/18 5:00:30 ET
Table 'Achird' 6-max Seat #1 is the button
Seat 1: Ngochuyen93 ($12.31 in chips) 
Seat 2: tremsbuettel ($8.05 in chips) 
Seat 3: Vodogrey8 ($10 in chips) 
Seat 4: yzsbob ($10.04 in chips) 
Seat 5: Alinyr ($10.36 in chips) 
Seat 6: Beks789 ($10 in chips) 
tremsbuettel: posts small blind $0.05
Vodogrey8: posts big blind $0.10
*** HOLE CARDS ***
yzsbob: folds 
Alinyr: folds 
Beks789: folds 
Ngochuyen93: raises $0.20 to $0.30
yzsbob leaves the table
tremsbuettel: folds 
Vodogrey8: folds 
Uncalled bet ($0.20) returned to Ngochuyen93
Ngochuyen93 collected $0.25 from pot
Ngochuyen93: doesn't show hand 
*** SUMMARY ***
Total pot $0.25 | Rake $0 
Seat 1: Ngochuyen93 (button) collected ($0.25)
Seat 2: tremsbuettel (small blind) folded before Flop
Seat 3: Vodogrey8 (big blind) folded before Flop
Seat 4: yzsbob folded before Flop (didn't bet)
Seat 5: Alinyr folded before Flop (didn't bet)
Seat 6: Beks789 folded before Flop (didn't bet)



PokerStars Hand #201501894786:  Hold'em No Limit ($0.05/$0.10 USD) - 2019/06/18 5:00:45 ET
Table 'Achird' 6-max Seat #2 is the button
Seat 1: Ngochuyen93 ($12.46 in chips) 
Seat 2: tremsbuettel ($8 in chips) 
Seat 3: Vodogrey8 ($10 in chips) 
Seat 5: Alinyr ($10.36 in chips) 
Seat 6: Beks789 ($10 in chips) 
Vodogrey8: posts small blind $0.05
Alinyr: posts big blind $0.10
*** HOLE CARDS ***
Beks789: folds 
Ngochuyen93: raises $0.20 to $0.30
tremsbuettel: folds 
Vodogrey8: folds 
Alinyr: folds 
Uncalled bet ($0.20) returned to Ngochuyen93
Ngochuyen93 collected $0.25 from pot
Ngochuyen93: doesn't show hand 
*** SUMMARY ***
Total pot $0.25 | Rake $0 
Seat 1: Ngochuyen93 collected ($0.25)
Seat 2: tremsbuettel (button) folded before Flop (didn't bet)
Seat 3: Vodogrey8 (small blind) folded before Flop
Seat 5: Alinyr (big blind) folded before Flop
Seat 6: Beks789 folded before Flop (didn't bet)



PokerStars Hand #201501897135:  Hold'em No Limit ($0.05/$0.10 USD) - 2019/06/18 5:00:55 ET
Table 'Achird' 6-max Seat #3 is the button
Seat 1: Ngochuyen93 ($12.61 in chips) 
Seat 2: tremsbuettel ($8 in chips) 
Seat 3: Vodogrey8 ($10 in chips) 
Seat 5: Alinyr ($10.26 in chips) 
Seat 6: Beks789 ($10 in chips) 
Alinyr: posts small blind $0.05
Beks789: posts big blind $0.10
*** HOLE CARDS ***
Ngochuyen93: folds 
tremsbuettel: calls $0.10
Vodogrey8: folds 
Alinyr: folds 
Beks789: checks 
*** FLOP *** [7s 5c 2c]
Beks789: checks 
tremsbuettel: checks 
*** TURN *** [7s 5c 2c] [6d]
Beks789: bets $0.16
cao87 joins the table at seat #4 
tremsbuettel: calls $0.16
*** RIVER *** [7s 5c 2c 6d] [8s]
Beks789: bets $0.28
tremsbuettel: calls $0.28
*** SHOW DOWN ***
Beks789: shows [6c Kc] (a pair of Sixes)
tremsbuettel: mucks hand 
Beks789 collected $1.08 from pot
*** SUMMARY ***
Total pot $1.13 | Rake $0.05 
Board [7s 5c 2c 6d 8s]
Seat 1: Ngochuyen93 folded before Flop (didn't bet)
Seat 2: tremsbuettel mucked
Seat 3: Vodogrey8 (button) folded before Flop (didn't bet)
Seat 5: Alinyr (small blind) folded before Flop
Seat 6: Beks789 (big blind) showed [6c Kc] and won ($1.08) with a pair of Sixes



PokerStars Hand #201501907221:  Hold'em No Limit ($0.05/$0.10 USD) - 2019/06/18 5:01:41 ET
Table 'Achird' 6-max Seat #5 is the button
Seat 1: Ngochuyen93 ($12.61 in chips) 
Seat 2: tremsbuettel ($7.46 in chips) 
Seat 3: Vodogrey8 ($10 in chips) 
Seat 5: Alinyr ($10.21 in chips) 
Seat 6: Beks789 ($10.54 in chips) 
Beks789: posts small blind $0.05
Ngochuyen93: posts big blind $0.10
cao87: sits out 
*** HOLE CARDS ***
tremsbuettel: calls $0.10
Vodogrey8: folds 
Alinyr: raises $0.30 to $0.40
Beks789: folds 
Ngochuyen93: calls $0.30
tremsbuettel: folds 
*** FLOP *** [9c 3s 2h]
Ngochuyen93: bets $0.50
Alinyr: calls $0.50
*** TURN *** [9c 3s 2h] [Jd]
Ngochuyen93: bets $0.90
Alinyr: folds 
Uncalled bet ($0.90) returned to Ngochuyen93
Ngochuyen93 collected $1.86 from pot
Ngochuyen93: doesn't show hand 
*** SUMMARY ***
Total pot $1.95 | Rake $0.09 
Board [9c 3s 2h Jd]
Seat 1: Ngochuyen93 (big blind) collected ($1.86)
Seat 2: tremsbuettel folded before Flop
Seat 3: Vodogrey8 folded before Flop (didn't bet)
Seat 5: Alinyr (button) folded on the Turn
Seat 6: Beks789 (small blind) folded before Flop



PokerStars Hand #201501917268:  Hold'em No Limit ($0.05/$0.10 USD) - 2019/06/18 5:02:25 ET
Table 'Achird' 6-max Seat #6 is the button
Seat 1: Ngochuyen93 ($13.57 in chips) 
Seat 2: tremsbuettel ($7.36 in chips) 
Seat 3: Vodogrey8 ($10 in chips) 
Seat 5: Alinyr ($10 in chips) 
Seat 6: Beks789 ($10.49 in chips) 
Ngochuyen93: posts small blind $0.05
tremsbuettel: posts big blind $0.10
cao87: sits out 
*** HOLE CARDS ***
Vodogrey8: folds 
Alinyr: folds 
Beks789: folds 
Ngochuyen93: folds 
Uncalled bet ($0.05) returned to tremsbuettel
tremsbuettel collected $0.10 from pot
tremsbuettel: doesn't show hand 
*** SUMMARY ***
Total pot $0.10 | Rake $0 
Seat 1: Ngochuyen93 (small blind) folded before Flop
Seat 2: tremsbuettel (big blind) collected ($0.10)
Seat 3: Vodogrey8 folded before Flop (didn't bet)
Seat 5: Alinyr folded before Flop (didn't bet)
Seat 6: Beks789 (button) folded before Flop (didn't bet)



PokerStars Hand #201501919414:  Hold'em No Limit ($0.05/$0.10 USD) - 2019/06/18 5:02:35 ET
Table 'Achird' 6-max Seat #1 is the button
Seat 1: Ngochuyen93 ($13.52 in chips) 
Seat 2: tremsbuettel ($7.41 in chips) 
Seat 3: Vodogrey8 ($10 in chips) 
Seat 5: Alinyr ($10 in chips) 
Seat 6: Beks789 ($10.49 in chips) 
tremsbuettel: posts small blind $0.05
Vodogrey8: posts big blind $0.10
cao87: sits out 
*** HOLE CARDS ***
Alinyr: folds 
Beks789: folds 
Ngochuyen93: raises $0.30 to $0.40
tremsbuettel: folds 
Vodogrey8: folds 
Uncalled bet ($0.30) returned to Ngochuyen93
Ngochuyen93 collected $0.25 from pot
Ngochuyen93: doesn't show hand 
*** SUMMARY ***
Total pot $0.25 | Rake $0 
Seat 1: Ngochuyen93 (button) collected ($0.25)
Seat 2: tremsbuettel (small blind) folded before Flop
Seat 3: Vodogrey8 (big blind) folded before Flop
Seat 5: Alinyr folded before Flop (didn't bet)
Seat 6: Beks789 folded before Flop (didn't bet)



PokerStars Hand #201501922599:  Hold'em No Limit ($0.05/$0.10 USD) - 2019/06/18 5:02:49 ET
Table 'Achird' 6-max Seat #2 is the button
Seat 1: Ngochuyen93 ($13.67 in chips) 
Seat 2: tremsbuettel ($7.36 in chips) 
Seat 3: Vodogrey8 ($10 in chips) 
Seat 4: cao87 ($10 in chips) 
Seat 5: Alinyr ($10 in chips) 
Seat 6: Beks789 ($10.49 in chips) 
Vodogrey8: posts small blind $0.05
cao87: posts big blind $0.10
*** HOLE CARDS ***
Alinyr: folds 
Beks789: folds 
Ngochuyen93: raises $0.30 to $0.40
tremsbuettel: folds 
Vodogrey8: folds 
cao87: folds 
Uncalled bet ($0.30) returned to Ngochuyen93
Ngochuyen93 collected $0.25 from pot
Ngochuyen93: doesn't show hand 
*** SUMMARY ***
Total pot $0.25 | Rake $0 
Seat 1: Ngochuyen93 collected ($0.25)
Seat 2: tremsbuettel (button) folded before Flop (didn't bet)
Seat 3: Vodogrey8 (small blind) folded before Flop
Seat 4: cao87 (big blind) folded before Flop
Seat 5: Alinyr folded before Flop (didn't bet)
Seat 6: Beks789 folded before Flop (didn't bet)



PokerStars Hand #201501926055:  Hold'em No Limit ($0.05/$0.10 USD) - 2019/06/18 5:03:04 ET
Table 'Achird' 6-max Seat #3 is the button
Seat 1: Ngochuyen93 ($13.82 in chips) 
Seat 2: tremsbuettel ($7.36 in chips) 
Seat 3: Vodogrey8 ($10 in chips) 
Seat 4: cao87 ($10 in chips) 
Seat 5: Alinyr ($10 in chips) 
Seat 6: Beks789 ($10.49 in chips) 
cao87: posts small blind $0.05
Alinyr: posts big blind $0.10
*** HOLE CARDS ***
Beks789: folds 
Ngochuyen93: calls $0.10
tremsbuettel: calls $0.10
Vodogrey8: folds 
cao87: folds 
Alinyr: checks 
*** FLOP *** [Jd 6c 9s]
Alinyr: checks 
Ngochuyen93: bets $0.10
tremsbuettel: calls $0.10
Alinyr: calls $0.10
*** TURN *** [Jd 6c 9s] [5c]
Alinyr: checks 
Ngochuyen93: bets $0.10
tremsbuettel: calls $0.10
Alinyr: calls $0.10
*** RIVER *** [Jd 6c 9s 5c] [3c]
Alinyr: checks 
Ngochuyen93: bets $0.50
tremsbuettel: calls $0.50
Alinyr: folds 
*** SHOW DOWN ***
Ngochuyen93: shows [Th 7h] (high card Jack)
tremsbuettel: shows [Ac As] (a pair of Aces)
tremsbuettel collected $1.86 from pot
*** SUMMARY ***
Total pot $1.95 | Rake $0.09 
Board [Jd 6c 9s 5c 3c]
Seat 1: Ngochuyen93 showed [Th 7h] and lost with high card Jack
Seat 2: tremsbuettel showed [Ac As] and won ($1.86) with a pair of Aces
Seat 3: Vodogrey8 (button) folded before Flop (didn't bet)
Seat 4: cao87 (small blind) folded before Flop
Seat 5: Alinyr (big blind) folded on the River
Seat 6: Beks789 folded before Flop (didn't bet)



PokerStars Hand #201501942724:  Hold'em No Limit ($0.05/$0.10 USD) - 2019/06/18 5:04:15 ET
Table 'Achird' 6-max Seat #4 is the button
Seat 1: Ngochuyen93 ($13.02 in chips) 
Seat 2: tremsbuettel ($8.42 in chips) 
Seat 3: Vodogrey8 ($10 in chips) 
Seat 4: cao87 ($10 in chips) 
Seat 5: Alinyr ($10 in chips) 
Seat 6: Beks789 ($10.49 in chips) 
Alinyr: posts small blind $0.05
Beks789: posts big blind $0.10
*** HOLE CARDS ***
Ngochuyen93: folds 
tremsbuettel: calls $0.10
Ngochuyen93 leaves the table
Vodogrey8: folds 
cao87: folds 
Alinyr: raises $0.40 to $0.50
Beks789: folds 
tremsbuettel: folds 
Uncalled bet ($0.40) returned to Alinyr
Alinyr collected $0.30 from pot
Alinyr: doesn't show hand 
*** SUMMARY ***
Total pot $0.30 | Rake $0 
Seat 1: Ngochuyen93 folded before Flop (didn't bet)
Seat 2: tremsbuettel folded before Flop
Seat 3: Vodogrey8 folded before Flop (didn't bet)
Seat 4: cao87 (button) folded before Flop (didn't bet)
Seat 5: Alinyr (small blind) collected ($0.30)
Seat 6: Beks789 (big blind) folded before Flop



PokerStars Hand #201501948152:  Hold'em No Limit ($0.05/$0.10 USD) - 2019/06/18 5:04:38 ET
Table 'Achird' 6-max Seat #5 is the button
Seat 2: tremsbuettel ($8.32 in chips) 
Seat 3: Vodogrey8 ($10 in chips) 
Seat 4: cao87 ($10 in chips) 
Seat 5: Alinyr ($10.20 in chips) 
Seat 6: Beks789 ($10.39 in chips) 
Beks789: posts small blind $0.05
tremsbuettel: posts big blind $0.10
*** HOLE CARDS ***
Vodogrey8: folds 
cao87: folds 
Alinyr: raises $0.15 to $0.25
Beks789: folds 
tremsbuettel: calls $0.15
*** FLOP *** [Js 6s 7d]
Vodogrey8 leaves the table
micksher joins the table at seat #3 
tremsbuettel: checks 
M0nzdrik joins the table at seat #1 
Alinyr: bets $0.18
tremsbuettel: calls $0.18
*** TURN *** [Js 6s 7d] [Qh]
tremsbuettel: checks 
M0nzdrik leaves the table
Alinyr: checks 
*** RIVER *** [Js 6s 7d Qh] [Qs]
tremsbuettel: bets $0.87
Alinyr: folds 
Uncalled bet ($0.87) returned to tremsbuettel
tremsbuettel collected $0.87 from pot
tremsbuettel: doesn't show hand 
*** SUMMARY ***
Total pot $0.91 | Rake $0.04 
Board [Js 6s 7d Qh Qs]
Seat 2: tremsbuettel (big blind) collected ($0.87)
Seat 3: Vodogrey8 folded before Flop (didn't bet)
Seat 4: cao87 folded before Flop (didn't bet)
Seat 5: Alinyr (button) folded on the River
Seat 6: Beks789 (small blind) folded before Flop



PokerStars Hand #201501961632:  Hold'em No Limit ($0.05/$0.10 USD) - 2019/06/18 5:05:35 ET
Table 'Achird' 6-max Seat #6 is the button
Seat 2: tremsbuettel ($8.76 in chips) 
Seat 3: micksher ($10 in chips) 
Seat 4: cao87 ($10 in chips) 
Seat 5: Alinyr ($10 in chips) 
Seat 6: Beks789 ($10.34 in chips) 
tremsbuettel: posts small blind $0.05
micksher: posts big blind $0.10
*** HOLE CARDS ***
cao87: folds 
Alinyr: raises $0.20 to $0.30
Beks789: folds 
tremsbuettel: folds 
micksher: calls $0.20
*** FLOP *** [9d Jh 8h]
AKs[EV+]N joins the table at seat #1 
micksher: checks 
Alinyr: checks 
*** TURN *** [9d Jh 8h] [5s]
micksher: checks 
Alinyr: bets $0.48
micksher: folds 
Uncalled bet ($0.48) returned to Alinyr
Alinyr collected $0.62 from pot
Alinyr: doesn't show hand 
*** SUMMARY ***
Total pot $0.65 | Rake $0.03 
Board [9d Jh 8h 5s]
Seat 2: tremsbuettel (small blind) folded before Flop
Seat 3: micksher (big blind) folded on the Turn
Seat 4: cao87 folded before Flop (didn't bet)
Seat 5: Alinyr collected ($0.62)
Seat 6: Beks789 (button) folded before Flop (didn't bet)



PokerStars Hand #201501971162:  Hold'em No Limit ($0.05/$0.10 USD) - 2019/06/18 5:06:15 ET
Table 'Achird' 6-max Seat #2 is the button
Seat 2: tremsbuettel ($8.71 in chips) 
Seat 3: micksher ($10 in chips) 
Seat 4: cao87 ($10 in chips) 
Seat 5: Alinyr ($10.32 in chips) 
Seat 6: Beks789 ($10.34 in chips) 
micksher: posts small blind $0.05
cao87: posts big blind $0.10
AKs[EV+]N: sits out 
*** HOLE CARDS ***
Alinyr: folds 
Beks789: raises $0.20 to $0.30
tremsbuettel: folds 
micksher: folds 
cao87: folds 
Uncalled bet ($0.20) returned to Beks789
Beks789 collected $0.25 from pot
Beks789: doesn't show hand 
*** SUMMARY ***
Total pot $0.25 | Rake $0 
Seat 2: tremsbuettel (button) folded before Flop (didn't bet)
Seat 3: micksher (small blind) folded before Flop
Seat 4: cao87 (big blind) folded before Flop
Seat 5: Alinyr folded before Flop (didn't bet)
Seat 6: Beks789 collected ($0.25)



PokerStars Hand #201501975330:  Hold'em No Limit ($0.05/$0.10 USD) - 2019/06/18 5:06:33 ET
Table 'Achird' 6-max Seat #3 is the button
Seat 2: tremsbuettel ($8.71 in chips) 
Seat 3: micksher ($10 in chips) 
Seat 4: cao87 ($10 in chips) 
Seat 5: Alinyr ($10.32 in chips) 
Seat 6: Beks789 ($10.49 in chips) 
cao87: posts small blind $0.05
Alinyr: posts big blind $0.10
AKs[EV+]N: sits out 
*** HOLE CARDS ***
Beks789: raises $0.20 to $0.30
tremsbuettel: folds 
micksher: folds 
cao87: folds 
Alinyr: folds 
Uncalled bet ($0.20) returned to Beks789
Beks789 collected $0.25 from pot
Beks789: doesn't show hand 
*** SUMMARY ***
Total pot $0.25 | Rake $0 
Seat 2: tremsbuettel folded before Flop (didn't bet)
Seat 3: micksher (button) folded before Flop (didn't bet)
Seat 4: cao87 (small blind) folded before Flop
Seat 5: Alinyr (big blind) folded before Flop
Seat 6: Beks789 collected ($0.25)



PokerStars Hand #201501978414:  Hold'em No Limit ($0.05/$0.10 USD) - 2019/06/18 5:06:46 ET
Table 'Achird' 6-max Seat #4 is the button
Seat 2: tremsbuettel ($8.71 in chips) 
Seat 3: micksher ($10 in chips) 
Seat 4: cao87 ($10 in chips) 
Seat 5: Alinyr ($10.22 in chips) 
Seat 6: Beks789 ($10.64 in chips) 
Alinyr: posts small blind $0.05
Beks789: posts big blind $0.10
AKs[EV+]N: sits out 
*** HOLE CARDS ***
tremsbuettel: calls $0.10
micksher: folds 
cao87: folds 
Alinyr: folds 
Beks789: checks 
*** FLOP *** [3h 2s 7d]
Beks789: checks 
tremsbuettel: bets $0.10
Beks789: folds 
Uncalled bet ($0.10) returned to tremsbuettel
tremsbuettel collected $0.24 from pot
tremsbuettel: doesn't show hand 
*** SUMMARY ***
Total pot $0.25 | Rake $0.01 
Board [3h 2s 7d]
Seat 2: tremsbuettel collected ($0.24)
Seat 3: micksher folded before Flop (didn't bet)
Seat 4: cao87 (button) folded before Flop (didn't bet)
Seat 5: Alinyr (small blind) folded before Flop
Seat 6: Beks789 (big blind) folded on the Flop



PokerStars Hand #201501983447:  Hold'em No Limit ($0.05/$0.10 USD) - 2019/06/18 5:07:07 ET
Table 'Achird' 6-max Seat #5 is the button
Seat 1: AKs[EV+]N ($10 in chips) 
Seat 2: tremsbuettel ($8.85 in chips) 
Seat 3: micksher ($10 in chips) 
Seat 4: cao87 ($10 in chips) 
Seat 5: Alinyr ($10.17 in chips) 
Seat 6: Beks789 ($10.54 in chips) 
Beks789: posts small blind $0.05
AKs[EV+]N: posts big blind $0.10
*** HOLE CARDS ***
tremsbuettel: folds 
micksher: raises $0.15 to $0.25
cao87: folds 
Alinyr: folds 
Beks789: folds 
AKs[EV+]N: folds 
Uncalled bet ($0.15) returned to micksher
micksher collected $0.25 from pot
*** SUMMARY ***
Total pot $0.25 | Rake $0 
Seat 1: AKs[EV+]N (big blind) folded before Flop
Seat 2: tremsbuettel folded before Flop (didn't bet)
Seat 3: micksher collected ($0.25)
Seat 4: cao87 folded before Flop (didn't bet)
Seat 5: Alinyr (button) folded before Flop (didn't bet)
Seat 6: Beks789 (small blind) folded before Flop



PokerStars Hand #201501988533:  Hold'em No Limit ($0.05/$0.10 USD) - 2019/06/18 5:07:28 ET
Table 'Achird' 6-max Seat #6 is the button
Seat 1: AKs[EV+]N ($10 in chips) 
Seat 2: tremsbuettel ($8.85 in chips) 
Seat 3: micksher ($10.15 in chips) 
Seat 4: cao87 ($10 in chips) 
Seat 5: Alinyr ($10.17 in chips) 
Seat 6: Beks789 ($10.49 in chips) 
AKs[EV+]N: posts small blind $0.05
tremsbuettel: posts big blind $0.10
*** HOLE CARDS ***
micksher: raises $0.15 to $0.25
cao87: folds 
Alinyr: folds 
Beks789: folds 
AKs[EV+]N: folds 
tremsbuettel: folds 
Uncalled bet ($0.15) returned to micksher
micksher collected $0.25 from pot
micksher: doesn't show hand 
*** SUMMARY ***
Total pot $0.25 | Rake $0 
Seat 1: AKs[EV+]N (small blind) folded before Flop
Seat 2: tremsbuettel (big blind) folded before Flop
Seat 3: micksher collected ($0.25)
Seat 4: cao87 folded before Flop (didn't bet)
Seat 5: Alinyr folded before Flop (didn't bet)
Seat 6: Beks789 (button) folded before Flop (didn't bet)



PokerStars Hand #201501993169:  Hold'em No Limit ($0.05/$0.10 USD) - 2019/06/18 5:07:48 ET
Table 'Achird' 6-max Seat #1 is the button
Seat 1: AKs[EV+]N ($10 in chips) 
Seat 2: tremsbuettel ($8.75 in chips) 
Seat 3: micksher ($10.30 in chips) 
Seat 4: cao87 ($10 in chips) 
Seat 5: Alinyr ($10.17 in chips) 
Seat 6: Beks789 ($10.49 in chips) 
tremsbuettel: posts small blind $0.05
micksher: posts big blind $0.10
*** HOLE CARDS ***
cao87: folds 
Alinyr: raises $0.20 to $0.30
Beks789: folds 
AKs[EV+]N: folds 
tremsbuettel: calls $0.25
micksher: folds 
*** FLOP *** [6d Kc Ad]
tremsbuettel: checks 
Alinyr: bets $0.44
tremsbuettel: calls $0.44
*** TURN *** [6d Kc Ad] [7c]
tremsbuettel: checks 
Alinyr: bets $2.28
tremsbuettel: folds 
Uncalled bet ($2.28) returned to Alinyr
Alinyr collected $1.51 from pot
Alinyr: doesn't show hand 
*** SUMMARY ***
Total pot $1.58 | Rake $0.07 
Board [6d Kc Ad 7c]
Seat 1: AKs[EV+]N (button) folded before Flop (didn't bet)
Seat 2: tremsbuettel (small blind) folded on the Turn
Seat 3: micksher (big blind) folded before Flop
Seat 4: cao87 folded before Flop (didn't bet)
Seat 5: Alinyr collected ($1.51)
Seat 6: Beks789 folded before Flop (didn't bet)



PokerStars Hand #201502011627:  Hold'em No Limit ($0.05/$0.10 USD) - 2019/06/18 5:09:04 ET
Table 'Achird' 6-max Seat #2 is the button
Seat 1: AKs[EV+]N ($10 in chips) 
Seat 2: tremsbuettel ($8.01 in chips) 
Seat 3: micksher ($10.20 in chips) 
Seat 4: cao87 ($10 in chips) 
Seat 5: Alinyr ($10.94 in chips) 
Seat 6: Beks789 ($10.49 in chips) 
micksher: posts small blind $0.05
cao87: posts big blind $0.10
*** HOLE CARDS ***
Alinyr: folds 
Beks789: folds 
AKs[EV+]N: folds 
tremsbuettel: calls $0.10
micksher: folds 
cao87: raises $0.25 to $0.35
tremsbuettel: folds 
Uncalled bet ($0.25) returned to cao87
cao87 collected $0.25 from pot
cao87: doesn't show hand 
*** SUMMARY ***
Total pot $0.25 | Rake $0 
Seat 1: AKs[EV+]N folded before Flop (didn't bet)
Seat 2: tremsbuettel (button) folded before Flop
Seat 3: micksher (small blind) folded before Flop
Seat 4: cao87 (big blind) collected ($0.25)
Seat 5: Alinyr folded before Flop (didn't bet)
Seat 6: Beks789 folded before Flop (didn't bet)



PokerStars Hand #201502017287:  Hold'em No Limit ($0.05/$0.10 USD) - 2019/06/18 5:09:28 ET
Table 'Achird' 6-max Seat #3 is the button
Seat 1: AKs[EV+]N ($10 in chips) 
Seat 2: tremsbuettel ($7.91 in chips) 
Seat 3: micksher ($10.15 in chips) 
Seat 4: cao87 ($10.15 in chips) 
Seat 5: Alinyr ($10.94 in chips) 
Seat 6: Beks789 ($10.49 in chips) 
cao87: posts small blind $0.05
Alinyr: posts big blind $0.10
*** HOLE CARDS ***
Beks789: raises $0.20 to $0.30
AKs[EV+]N: folds 
tremsbuettel: calls $0.30
micksher: folds 
cao87: folds 
Alinyr: folds 
*** FLOP *** [Js 4c 2s]
Beks789 has timed out
Beks789: checks 
tremsbuettel: bets $0.72
Beks789: folds 
Uncalled bet ($0.72) returned to tremsbuettel
tremsbuettel collected $0.72 from pot
tremsbuettel: doesn't show hand 
*** SUMMARY ***
Total pot $0.75 | Rake $0.03 
Board [Js 4c 2s]
Seat 1: AKs[EV+]N folded before Flop (didn't bet)
Seat 2: tremsbuettel collected ($0.72)
Seat 3: micksher (button) folded before Flop (didn't bet)
Seat 4: cao87 (small blind) folded before Flop
Seat 5: Alinyr (big blind) folded before Flop
Seat 6: Beks789 folded on the Flop



PokerStars Hand #201502033372:  Hold'em No Limit ($0.05/$0.10 USD) - 2019/06/18 5:10:36 ET
Table 'Achird' 6-max Seat #4 is the button
Seat 1: AKs[EV+]N ($10 in chips) 
Seat 2: tremsbuettel ($8.33 in chips) 
Seat 3: micksher ($10.15 in chips) 
Seat 4: cao87 ($10.10 in chips) 
Seat 5: Alinyr ($10.84 in chips) 
Alinyr: posts small blind $0.05
Beks789: is sitting out 
AKs[EV+]N: posts big blind $0.10
*** HOLE CARDS ***
Beks789 leaves the table
tremsbuettel: folds 
Furbzzz joins the table at seat #6 
Furbzzz leaves the table
micksher: folds 
cao87: folds 
7013yuki joins the table at seat #6 
Alinyr: raises $0.20 to $0.30
AKs[EV+]N: folds 
Uncalled bet ($0.20) returned to Alinyr
Alinyr collected $0.20 from pot
Alinyr: doesn't show hand 
*** SUMMARY ***
Total pot $0.20 | Rake $0 
Seat 1: AKs[EV+]N (big blind) folded before Flop
Seat 2: tremsbuettel folded before Flop (didn't bet)
Seat 3: micksher folded before Flop (didn't bet)
Seat 4: cao87 (button) folded before Flop (didn't bet)
Seat 5: Alinyr (small blind) collected ($0.20)



PokerStars Hand #201502109850:  Hold'em No Limit ($0.05/$0.10 USD) - 2019/06/18 5:15:56 ET
Table 'Achird' 6-max Seat #3 is the button
Seat 1: AKs[EV+]N ($14.38 in chips) 
Seat 2: tremsbuettel ($9.02 in chips) 
Seat 3: micksher ($10 in chips) 
Seat 4: cao87 ($10 in chips) 
Seat 5: Alinyr ($19.98 in chips) 
Seat 6: 7013yuki ($4.90 in chips) 
cao87: posts small blind $0.05
Alinyr: posts big blind $0.10
*** HOLE CARDS ***
7013yuki: raises $4.80 to $4.90 and is all-in
AKs[EV+]N: folds 
tremsbuettel: folds 
micksher: folds 
cao87: folds 
Alinyr: folds 
Uncalled bet ($4.80) returned to 7013yuki
7013yuki collected $0.25 from pot
*** SUMMARY ***
Total pot $0.25 | Rake $0 
Seat 1: AKs[EV+]N folded before Flop (didn't bet)
Seat 2: tremsbuettel folded before Flop (didn't bet)
Seat 3: micksher (button) folded before Flop (didn't bet)
Seat 4: cao87 (small blind) folded before Flop
Seat 5: Alinyr (big blind) folded before Flop
Seat 6: 7013yuki collected ($0.25)



PokerStars Hand #201502039599:  Hold'em No Limit ($0.05/$0.10 USD) - 2019/06/18 5:11:02 ET
Table 'Achird' 6-max Seat #5 is the button
Seat 1: AKs[EV+]N ($10 in chips) 
Seat 2: tremsbuettel ($8.33 in chips) 
Seat 3: micksher ($10.15 in chips) 
Seat 4: cao87 ($10.10 in chips) 
Seat 5: Alinyr ($10.94 in chips) 
AKs[EV+]N: posts small blind $0.05
tremsbuettel: posts big blind $0.10
*** HOLE CARDS ***
micksher: raises $0.15 to $0.25
cao87: folds 
Alinyr: folds 
AKs[EV+]N: folds 
tremsbuettel: calls $0.15
*** FLOP *** [5d Kh Jd]
tremsbuettel: checks 
micksher: checks 
*** TURN *** [5d Kh Jd] [Kd]
tremsbuettel: checks 
micksher: checks 
*** RIVER *** [5d Kh Jd Kd] [6h]
tremsbuettel: checks 
micksher: checks 
*** SHOW DOWN ***
tremsbuettel: shows [Qh Ah] (a pair of Kings)
micksher: shows [Qs As] (a pair of Kings)
tremsbuettel collected $0.27 from pot
micksher collected $0.26 from pot
*** SUMMARY ***
Total pot $0.55 | Rake $0.02 
Board [5d Kh Jd Kd 6h]
Seat 1: AKs[EV+]N (small blind) folded before Flop
Seat 2: tremsbuettel (big blind) showed [Qh Ah] and won ($0.27) with a pair of Kings
Seat 3: micksher showed [Qs As] and won ($0.26) with a pair of Kings
Seat 4: cao87 folded before Flop (didn't bet)
Seat 5: Alinyr (button) folded before Flop (didn't bet)



PokerStars Hand #201502049836:  Hold'em No Limit ($0.05/$0.10 USD) - 2019/06/18 5:11:45 ET
Table 'Achird' 6-max Seat #1 is the button
Seat 1: AKs[EV+]N ($10 in chips) 
Seat 2: tremsbuettel ($8.35 in chips) 
Seat 3: micksher ($10.16 in chips) 
Seat 4: cao87 ($10.10 in chips) 
Seat 5: Alinyr ($10.94 in chips) 
Seat 6: 7013yuki ($10 in chips) 
tremsbuettel: posts small blind $0.05
micksher: posts big blind $0.10
7013yuki: posts big blind $0.10
*** HOLE CARDS ***
cao87: folds 
Alinyr: raises $0.50 to $0.60
7013yuki: calls $0.50
AKs[EV+]N: folds 
tremsbuettel: folds 
micksher: folds 
*** FLOP *** [As Qh Jc]
Alinyr: bets $1.10
7013yuki: calls $1.10
*** TURN *** [As Qh Jc] [6d]
Alinyr: bets $3
7013yuki: calls $3
*** RIVER *** [As Qh Jc 6d] [3s]
Alinyr: bets $6.24 and is all-in
7013yuki: calls $5.30 and is all-in
Uncalled bet ($0.94) returned to Alinyr
*** SHOW DOWN ***
Alinyr: shows [Qs Ah] (two pair, Aces and Queens)
7013yuki: shows [Ad 8s] (a pair of Aces)
Alinyr collected $19.24 from pot
*** SUMMARY ***
Total pot $20.15 | Rake $0.91 
Board [As Qh Jc 6d 3s]
Seat 1: AKs[EV+]N (button) folded before Flop (didn't bet)
Seat 2: tremsbuettel (small blind) folded before Flop
Seat 3: micksher (big blind) folded before Flop
Seat 4: cao87 folded before Flop (didn't bet)
Seat 5: Alinyr showed [Qs Ah] and won ($19.24) with two pair, Aces and Queens
Seat 6: 7013yuki showed [Ad 8s] and lost with a pair of Aces



PokerStars Hand #201502064528:  Hold'em No Limit ($0.05/$0.10 USD) - 2019/06/18 5:12:47 ET
Table 'Achird' 6-max Seat #2 is the button
Seat 1: AKs[EV+]N ($10 in chips) 
Seat 2: tremsbuettel ($8.30 in chips) 
Seat 3: micksher ($10.06 in chips) 
Seat 4: cao87 ($10.10 in chips) 
Seat 5: Alinyr ($20.18 in chips) 
micksher: posts small blind $0.05
cao87: posts big blind $0.10
*** HOLE CARDS ***
Alinyr: folds 
AKs[EV+]N: folds 
tremsbuettel: folds 
micksher: folds 
Uncalled bet ($0.05) returned to cao87
cao87 collected $0.10 from pot
cao87: doesn't show hand 
*** SUMMARY ***
Total pot $0.10 | Rake $0 
Seat 1: AKs[EV+]N folded before Flop (didn't bet)
Seat 2: tremsbuettel (button) folded before Flop (didn't bet)
Seat 3: micksher (small blind) folded before Flop
Seat 4: cao87 (big blind) collected ($0.10)
Seat 5: Alinyr folded before Flop (didn't bet)



PokerStars Hand #201502067085:  Hold'em No Limit ($0.05/$0.10 USD) - 2019/06/18 5:12:57 ET
Table 'Achird' 6-max Seat #3 is the button
Seat 1: AKs[EV+]N ($10 in chips) 
Seat 2: tremsbuettel ($8.30 in chips) 
Seat 3: micksher ($10.01 in chips) 
Seat 4: cao87 ($10.15 in chips) 
Seat 5: Alinyr ($20.18 in chips) 
Seat 6: 7013yuki ($10 in chips) 
cao87: posts small blind $0.05
Alinyr: posts big blind $0.10
*** HOLE CARDS ***
7013yuki: raises $9.90 to $10 and is all-in
AKs[EV+]N: folds 
tremsbuettel: folds 
micksher: folds 
cao87: folds 
Alinyr: folds 
Uncalled bet ($9.90) returned to 7013yuki
7013yuki collected $0.25 from pot
7013yuki: doesn't show hand 
*** SUMMARY ***
Total pot $0.25 | Rake $0 
Seat 1: AKs[EV+]N folded before Flop (didn't bet)
Seat 2: tremsbuettel folded before Flop (didn't bet)
Seat 3: micksher (button) folded before Flop (didn't bet)
Seat 4: cao87 (small blind) folded before Flop
Seat 5: Alinyr (big blind) folded before Flop
Seat 6: 7013yuki collected ($0.25)



PokerStars Hand #201502070008:  Hold'em No Limit ($0.05/$0.10 USD) - 2019/06/18 5:13:10 ET
Table 'Achird' 6-max Seat #4 is the button
Seat 1: AKs[EV+]N ($10 in chips) 
Seat 2: tremsbuettel ($8.30 in chips) 
Seat 3: micksher ($10.01 in chips) 
Seat 4: cao87 ($10.10 in chips) 
Seat 5: Alinyr ($20.08 in chips) 
Seat 6: 7013yuki ($10.15 in chips) 
Alinyr: posts small blind $0.05
7013yuki: posts big blind $0.10
*** HOLE CARDS ***
AKs[EV+]N: folds 
tremsbuettel: folds 
micksher: folds 
cao87: folds 
Alinyr: calls $0.05
7013yuki: raises $0.40 to $0.50
Alinyr: folds 
Uncalled bet ($0.40) returned to 7013yuki
7013yuki collected $0.20 from pot
7013yuki: doesn't show hand 
*** SUMMARY ***
Total pot $0.20 | Rake $0 
Seat 1: AKs[EV+]N folded before Flop (didn't bet)
Seat 2: tremsbuettel folded before Flop (didn't bet)
Seat 3: micksher folded before Flop (didn't bet)
Seat 4: cao87 (button) folded before Flop (didn't bet)
Seat 5: Alinyr (small blind) folded before Flop
Seat 6: 7013yuki (big blind) collected ($0.20)



PokerStars Hand #201502074408:  Hold'em No Limit ($0.05/$0.10 USD) - 2019/06/18 5:13:28 ET
Table 'Achird' 6-max Seat #5 is the button
Seat 1: AKs[EV+]N ($10 in chips) 
Seat 2: tremsbuettel ($8.30 in chips) 
Seat 3: micksher ($10.01 in chips) 
Seat 4: cao87 ($10.10 in chips) 
Seat 5: Alinyr ($19.98 in chips) 
Seat 6: 7013yuki ($10.25 in chips) 
7013yuki: posts small blind $0.05
AKs[EV+]N: posts big blind $0.10
*** HOLE CARDS ***
tremsbuettel: folds 
micksher: folds 
cao87: folds 
Alinyr: folds 
7013yuki: raises $0.10 to $0.20
AKs[EV+]N: calls $0.10
*** FLOP *** [8c Ad Qs]
7013yuki: bets $0.50
AKs[EV+]N: calls $0.50
*** TURN *** [8c Ad Qs] [As]
7013yuki: bets $1
AKs[EV+]N: calls $1
*** RIVER *** [8c Ad Qs As] [8s]
7013yuki: bets $3
AKs[EV+]N: raises $5.30 to $8.30 and is all-in
7013yuki: folds 
Uncalled bet ($5.30) returned to AKs[EV+]N
AKs[EV+]N collected $8.98 from pot
AKs[EV+]N: doesn't show hand 
*** SUMMARY ***
Total pot $9.40 | Rake $0.42 
Board [8c Ad Qs As 8s]
Seat 1: AKs[EV+]N (big blind) collected ($8.98)
Seat 2: tremsbuettel folded before Flop (didn't bet)
Seat 3: micksher folded before Flop (didn't bet)
Seat 4: cao87 folded before Flop (didn't bet)
Seat 5: Alinyr (button) folded before Flop (didn't bet)
Seat 6: 7013yuki (small blind) folded on the River



PokerStars Hand #201502089163:  Hold'em No Limit ($0.05/$0.10 USD) - 2019/06/18 5:14:30 ET
Table 'Achird' 6-max Seat #6 is the button
Seat 1: AKs[EV+]N ($14.28 in chips) 
Seat 2: tremsbuettel ($8.30 in chips) 
Seat 3: micksher ($10.01 in chips) 
Seat 4: cao87 ($10.10 in chips) 
Seat 5: Alinyr ($19.98 in chips) 
Seat 6: 7013yuki ($5.55 in chips) 
AKs[EV+]N: posts small blind $0.05
tremsbuettel: posts big blind $0.10
*** HOLE CARDS ***
micksher: folds 
cao87: folds 
Alinyr: folds 
7013yuki: folds 
AKs[EV+]N: raises $0.15 to $0.25
tremsbuettel: folds 
Uncalled bet ($0.15) returned to AKs[EV+]N
AKs[EV+]N collected $0.20 from pot
AKs[EV+]N: doesn't show hand 
*** SUMMARY ***
Total pot $0.20 | Rake $0 
Seat 1: AKs[EV+]N (small blind) collected ($0.20)
Seat 2: tremsbuettel (big blind) folded before Flop
Seat 3: micksher folded before Flop (didn't bet)
Seat 4: cao87 folded before Flop (didn't bet)
Seat 5: Alinyr folded before Flop (didn't bet)
Seat 6: 7013yuki (button) folded before Flop (didn't bet)



PokerStars Hand #201502094530:  Hold'em No Limit ($0.05/$0.10 USD) - 2019/06/18 5:14:53 ET
Table 'Achird' 6-max Seat #1 is the button
Seat 1: AKs[EV+]N ($14.38 in chips) 
Seat 2: tremsbuettel ($8.20 in chips) 
Seat 3: micksher ($10.01 in chips) 
Seat 4: cao87 ($10.10 in chips) 
Seat 5: Alinyr ($19.98 in chips) 
Seat 6: 7013yuki ($5.55 in chips) 
tremsbuettel: posts small blind $0.05
micksher: posts big blind $0.10
*** HOLE CARDS ***
cao87: folds 
Alinyr: folds 
7013yuki: raises $5.45 to $5.55 and is all-in
AKs[EV+]N: folds 
tremsbuettel: folds 
micksher: folds 
Uncalled bet ($5.45) returned to 7013yuki
7013yuki collected $0.25 from pot
7013yuki: doesn't show hand 
*** SUMMARY ***
Total pot $0.25 | Rake $0 
Seat 1: AKs[EV+]N (button) folded before Flop (didn't bet)
Seat 2: tremsbuettel (small blind) folded before Flop
Seat 3: micksher (big blind) folded before Flop
Seat 4: cao87 folded before Flop (didn't bet)
Seat 5: Alinyr folded before Flop (didn't bet)
Seat 6: 7013yuki collected ($0.25)



PokerStars Hand #201502098733:  Hold'em No Limit ($0.05/$0.10 USD) - 2019/06/18 5:15:10 ET
Table 'Achird' 6-max Seat #2 is the button
Seat 1: AKs[EV+]N ($14.38 in chips) 
Seat 2: tremsbuettel ($8.15 in chips) 
Seat 3: micksher ($10 in chips) 
Seat 4: cao87 ($10.10 in chips) 
Seat 5: Alinyr ($19.98 in chips) 
Seat 6: 7013yuki ($5.70 in chips) 
micksher: posts small blind $0.05
cao87: posts big blind $0.10
*** HOLE CARDS ***
Alinyr: folds 
7013yuki: raises $0.10 to $0.20
AKs[EV+]N: folds 
tremsbuettel: calls $0.20
micksher: folds 
cao87: folds 
*** FLOP *** [6c 9h Qs]
7013yuki: bets $0.50
tremsbuettel: calls $0.50
*** TURN *** [6c 9h Qs] [Jd]
7013yuki: bets $0.10
tremsbuettel: raises $1.68 to $1.78
7013yuki: folds 
Uncalled bet ($1.68) returned to tremsbuettel
tremsbuettel collected $1.67 from pot
tremsbuettel: doesn't show hand 
*** SUMMARY ***
Total pot $1.75 | Rake $0.08 
Board [6c 9h Qs Jd]
Seat 1: AKs[EV+]N folded before Flop (didn't bet)
Seat 2: tremsbuettel (button) collected ($1.67)
Seat 3: micksher (small blind) folded before Flop
Seat 4: cao87 (big blind) folded before Flop
Seat 5: Alinyr folded before Flop (didn't bet)
Seat 6: 7013yuki folded on the Turn



PokerStars Hand #201502113001:  Hold'em No Limit ($0.05/$0.10 USD) - 2019/06/18 5:16:09 ET
Table 'Achird' 6-max Seat #4 is the button
Seat 1: AKs[EV+]N ($14.38 in chips) 
Seat 2: tremsbuettel ($9.02 in chips) 
Seat 3: micksher ($10 in chips) 
Seat 4: cao87 ($10 in chips) 
Seat 5: Alinyr ($19.88 in chips) 
Seat 6: 7013yuki ($5.05 in chips) 
Alinyr: posts small blind $0.05
7013yuki: posts big blind $0.10
*** HOLE CARDS ***
AKs[EV+]N: folds 
tremsbuettel: calls $0.10
micksher: folds 
cao87: folds 
Alinyr: raises $0.40 to $0.50
7013yuki: calls $0.40
tremsbuettel: calls $0.40
*** FLOP *** [7c Qs 5d]
Alinyr: bets $1.10
7013yuki: folds 
tremsbuettel: calls $1.10
*** TURN *** [7c Qs 5d] [9c]
Alinyr: bets $2.58
tremsbuettel: folds 
Uncalled bet ($2.58) returned to Alinyr
Alinyr collected $3.53 from pot
Alinyr: doesn't show hand 
*** SUMMARY ***
Total pot $3.70 | Rake $0.17 
Board [7c Qs 5d 9c]
Seat 1: AKs[EV+]N folded before Flop (didn't bet)
Seat 2: tremsbuettel folded on the Turn
Seat 3: micksher folded before Flop (didn't bet)
Seat 4: cao87 (button) folded before Flop (didn't bet)
Seat 5: Alinyr (small blind) collected ($3.53)
Seat 6: 7013yuki (big blind) folded on the Flop



PokerStars Hand #201502124837:  Hold'em No Limit ($0.05/$0.10 USD) - 2019/06/18 5:16:58 ET
Table 'Achird' 6-max Seat #5 is the button
Seat 1: AKs[EV+]N ($14.38 in chips) 
Seat 2: tremsbuettel ($7.42 in chips) 
Seat 3: micksher ($10 in chips) 
Seat 4: cao87 ($10 in chips) 
Seat 5: Alinyr ($21.81 in chips) 
Seat 6: 7013yuki ($4.55 in chips) 
7013yuki: posts small blind $0.05
AKs[EV+]N: posts big blind $0.10
*** HOLE CARDS ***
tremsbuettel: calls $0.10
micksher: folds 
cao87: folds 
Alinyr: folds 
7013yuki: calls $0.05
AKs[EV+]N: raises $0.50 to $0.60
tremsbuettel: calls $0.50
7013yuki: folds 
*** FLOP *** [4c 8h 9c]
AKs[EV+]N: checks 
tremsbuettel: bets $1.24
AKs[EV+]N: folds 
Uncalled bet ($1.24) returned to tremsbuettel
tremsbuettel collected $1.24 from pot
tremsbuettel: doesn't show hand 
*** SUMMARY ***
Total pot $1.30 | Rake $0.06 
Board [4c 8h 9c]
Seat 1: AKs[EV+]N (big blind) folded on the Flop
Seat 2: tremsbuettel collected ($1.24)
Seat 3: micksher folded before Flop (didn't bet)
Seat 4: cao87 folded before Flop (didn't bet)
Seat 5: Alinyr (button) folded before Flop (didn't bet)
Seat 6: 7013yuki (small blind) folded before Flop



PokerStars Hand #201502135306:  Hold'em No Limit ($0.05/$0.10 USD) - 2019/06/18 5:17:41 ET
Table 'Achird' 6-max Seat #6 is the button
Seat 1: AKs[EV+]N ($13.78 in chips) 
Seat 2: tremsbuettel ($8.06 in chips) 
Seat 3: micksher ($10 in chips) 
Seat 4: cao87 ($10 in chips) 
Seat 5: Alinyr ($21.81 in chips) 
Seat 6: 7013yuki ($4.45 in chips) 
AKs[EV+]N: posts small blind $0.05
tremsbuettel: posts big blind $0.10
*** HOLE CARDS ***
micksher: folds 
cao87: folds 
Alinyr: folds 
7013yuki: raises $0.10 to $0.20
AKs[EV+]N: folds 
tremsbuettel: calls $0.10
*** FLOP *** [4c Qd 2d]
tremsbuettel: checks 
7013yuki: bets $0.10
tremsbuettel: calls $0.10
*** TURN *** [4c Qd 2d] [3h]
tremsbuettel: checks 
7013yuki: bets $0.10
tremsbuettel: calls $0.10
*** RIVER *** [4c Qd 2d 3h] [Ac]
tremsbuettel: bets $0.81
7013yuki: folds 
Uncalled bet ($0.81) returned to tremsbuettel
tremsbuettel collected $0.81 from pot
tremsbuettel: doesn't show hand 
*** SUMMARY ***
Total pot $0.85 | Rake $0.04 
Board [4c Qd 2d 3h Ac]
Seat 1: AKs[EV+]N (small blind) folded before Flop
Seat 2: tremsbuettel (big blind) collected ($0.81)
Seat 3: micksher folded before Flop (didn't bet)
Seat 4: cao87 folded before Flop (didn't bet)
Seat 5: Alinyr folded before Flop (didn't bet)
Seat 6: 7013yuki (button) folded on the River



PokerStars Hand #201502146921:  Hold'em No Limit ($0.05/$0.10 USD) - 2019/06/18 5:18:28 ET
Table 'Achird' 6-max Seat #1 is the button
Seat 1: AKs[EV+]N ($13.73 in chips) 
Seat 2: tremsbuettel ($8.47 in chips) 
Seat 3: micksher ($10 in chips) 
Seat 4: cao87 ($10 in chips) 
Seat 5: Alinyr ($21.81 in chips) 
Seat 6: 7013yuki ($4.05 in chips) 
tremsbuettel: posts small blind $0.05
micksher: posts big blind $0.10
*** HOLE CARDS ***
cao87: folds 
Alinyr: raises $0.20 to $0.30
7013yuki: raises $3.75 to $4.05 and is all-in
AKs[EV+]N: folds 
tremsbuettel: folds 
micksher: folds 
Alinyr: folds 
Uncalled bet ($3.75) returned to 7013yuki
7013yuki collected $0.75 from pot
*** SUMMARY ***
Total pot $0.75 | Rake $0 
Seat 1: AKs[EV+]N (button) folded before Flop (didn't bet)
Seat 2: tremsbuettel (small blind) folded before Flop
Seat 3: micksher (big blind) folded before Flop
Seat 4: cao87 folded before Flop (didn't bet)
Seat 5: Alinyr folded before Flop
Seat 6: 7013yuki collected ($0.75)



PokerStars Hand #201502154530:  Hold'em No Limit ($0.05/$0.10 USD) - 2019/06/18 5:19:00 ET
Table 'Achird' 6-max Seat #2 is the button
Seat 1: AKs[EV+]N ($13.73 in chips) 
Seat 2: tremsbuettel ($8.42 in chips) 
Seat 3: micksher ($10 in chips) 
Seat 4: cao87 ($10 in chips) 
Seat 5: Alinyr ($21.51 in chips) 
Seat 6: 7013yuki ($4.50 in chips) 
micksher: posts small blind $0.05
cao87: posts big blind $0.10
*** HOLE CARDS ***
Alinyr: folds 
7013yuki: calls $0.10
AKs[EV+]N: folds 
tremsbuettel: calls $0.10
micksher: folds 
cao87: checks 
*** FLOP *** [Jh 6s 5d]
cao87: checks 
7013yuki: bets $0.10
tremsbuettel: calls $0.10
cao87: folds 
*** TURN *** [Jh 6s 5d] [5c]
7013yuki: bets $0.30
tremsbuettel: calls $0.30
*** RIVER *** [Jh 6s 5d 5c] [6h]
7013yuki: bets $1
tremsbuettel: folds 
Uncalled bet ($1) returned to 7013yuki
7013yuki collected $1.10 from pot
*** SUMMARY ***
Total pot $1.15 | Rake $0.05 
Board [Jh 6s 5d 5c 6h]
Seat 1: AKs[EV+]N folded before Flop (didn't bet)
Seat 2: tremsbuettel (button) folded on the River
Seat 3: micksher (small blind) folded before Flop
Seat 4: cao87 (big blind) folded on the Flop
Seat 5: Alinyr folded before Flop (didn't bet)
Seat 6: 7013yuki collected ($1.10)



PokerStars Hand #201502165212:  Hold'em No Limit ($0.05/$0.10 USD) - 2019/06/18 5:19:44 ET
Table 'Achird' 6-max Seat #3 is the button
Seat 1: AKs[EV+]N ($13.73 in chips) 
Seat 2: tremsbuettel ($7.92 in chips) 
Seat 3: micksher ($10 in chips) 
Seat 4: cao87 ($10 in chips) 
Seat 5: Alinyr ($21.51 in chips) 
Seat 6: 7013yuki ($5.10 in chips) 
cao87: posts small blind $0.05
Alinyr: posts big blind $0.10
*** HOLE CARDS ***
7013yuki: raises $5 to $5.10 and is all-in
AKs[EV+]N: folds 
tremsbuettel: folds 
micksher: folds 
cao87: folds 
Alinyr: folds 
Uncalled bet ($5) returned to 7013yuki
7013yuki collected $0.25 from pot
7013yuki: doesn't show hand 
*** SUMMARY ***
Total pot $0.25 | Rake $0 
Seat 1: AKs[EV+]N folded before Flop (didn't bet)
Seat 2: tremsbuettel folded before Flop (didn't bet)
Seat 3: micksher (button) folded before Flop (didn't bet)
Seat 4: cao87 (small blind) folded before Flop
Seat 5: Alinyr (big blind) folded before Flop
Seat 6: 7013yuki collected ($0.25)



PokerStars Hand #201502168365:  Hold'em No Limit ($0.05/$0.10 USD) - 2019/06/18 5:19:57 ET
Table 'Achird' 6-max Seat #4 is the button
Seat 1: AKs[EV+]N ($13.73 in chips) 
Seat 2: tremsbuettel ($7.92 in chips) 
Seat 3: micksher ($10 in chips) 
Seat 4: cao87 ($10 in chips) 
Seat 5: Alinyr ($21.41 in chips) 
Seat 6: 7013yuki ($5.25 in chips) 
Alinyr: posts small blind $0.05
7013yuki: posts big blind $0.10
*** HOLE CARDS ***
AKs[EV+]N: folds 
tremsbuettel: calls $0.10
micksher: raises $0.30 to $0.40
cao87: folds 
Alinyr: folds 
7013yuki: calls $0.30
tremsbuettel: folds 
*** FLOP *** [5h Ah Ac]
7013yuki: bets $0.10
micksher: raises $0.74 to $0.84
7013yuki: folds 
Uncalled bet ($0.74) returned to micksher
micksher collected $1.10 from pot
micksher: doesn't show hand 
*** SUMMARY ***
Total pot $1.15 | Rake $0.05 
Board [5h Ah Ac]
Seat 1: AKs[EV+]N folded before Flop (didn't bet)
Seat 2: tremsbuettel folded before Flop
Seat 3: micksher collected ($1.10)
Seat 4: cao87 (button) folded before Flop (didn't bet)
Seat 5: Alinyr (small blind) folded before Flop
Seat 6: 7013yuki (big blind) folded on the Flop



PokerStars Hand #201502208597:  Hold'em No Limit ($0.05/$0.10 USD) - 2019/06/18 5:22:42 ET
Table 'Achird' 6-max Seat #2 is the button
Seat 1: AKs[EV+]N ($15.19 in chips) 
Seat 2: tremsbuettel ($8.54 in chips) 
Seat 4: cao87 ($10 in chips) 
Seat 5: Alinyr ($21.36 in chips) 
Seat 6: 7013yuki ($4.70 in chips) 
cao87: posts small blind $0.05
Alinyr: posts big blind $0.10
*** HOLE CARDS ***
7013yuki: folds 
AKs[EV+]N: folds 
tremsbuettel: calls $0.10
cao87: folds 
Alinyr: checks 
*** FLOP *** [8c 3c 3d]
Alinyr: checks 
tremsbuettel: checks 
*** TURN *** [8c 3c 3d] [2c]
Alinyr: checks 
tremsbuettel: checks 
*** RIVER *** [8c 3c 3d 2c] [9s]
Alinyr: checks 
tremsbuettel: checks 
*** SHOW DOWN ***
Alinyr: shows [4d 9c] (two pair, Nines and Threes)
tremsbuettel: mucks hand 
Alinyr collected $0.24 from pot
*** SUMMARY ***
Total pot $0.25 | Rake $0.01 
Board [8c 3c 3d 2c 9s]
Seat 1: AKs[EV+]N folded before Flop (didn't bet)
Seat 2: tremsbuettel (button) mucked
Seat 4: cao87 (small blind) folded before Flop
Seat 5: Alinyr (big blind) showed [4d 9c] and won ($0.24) with two pair, Nines and Threes
Seat 6: 7013yuki folded before Flop (didn't bet)



PokerStars Hand #201502219038:  Hold'em No Limit ($0.05/$0.10 USD) - 2019/06/18 5:23:26 ET
Table 'Achird' 6-max Seat #4 is the button
Seat 1: AKs[EV+]N ($15.19 in chips) 
Seat 2: tremsbuettel ($8.44 in chips) 
Seat 4: cao87 ($10 in chips) 
Seat 5: Alinyr ($21.50 in chips) 
Seat 6: 7013yuki ($4.70 in chips) 
Alinyr: posts small blind $0.05
7013yuki: posts big blind $0.10
*** HOLE CARDS ***
AKs[EV+]N: folds 
tremsbuettel: calls $0.10
cao87: folds 
Alinyr: folds 
7013yuki: checks 
*** FLOP *** [4d 3d 8c]
7013yuki: bets $0.10
tremsbuettel: calls $0.10
*** TURN *** [4d 3d 8c] [6h]
7013yuki: bets $0.10
tremsbuettel: calls $0.10
*** RIVER *** [4d 3d 8c 6h] [8s]
7013yuki: bets $0.30
tremsbuettel: calls $0.30
*** SHOW DOWN ***
7013yuki: shows [Td 9h] (a pair of Eights)
tremsbuettel: shows [Ad 7d] (a pair of Eights - Ace kicker)
tremsbuettel collected $1.19 from pot
*** SUMMARY ***
Total pot $1.25 | Rake $0.06 
Board [4d 3d 8c 6h 8s]
Seat 1: AKs[EV+]N folded before Flop (didn't bet)
Seat 2: tremsbuettel showed [Ad 7d] and won ($1.19) with a pair of Eights
Seat 4: cao87 (button) folded before Flop (didn't bet)
Seat 5: Alinyr (small blind) folded before Flop
Seat 6: 7013yuki (big blind) showed [Td 9h] and lost with a pair of Eights



PokerStars Hand #201502235346:  Hold'em No Limit ($0.05/$0.10 USD) - 2019/06/18 5:24:34 ET
Table 'Achird' 6-max Seat #5 is the button
Seat 1: AKs[EV+]N ($15.19 in chips) 
Seat 2: tremsbuettel ($9.03 in chips) 
Seat 4: cao87 ($10 in chips) 
Seat 5: Alinyr ($21.45 in chips) 
Seat 6: 7013yuki ($4.10 in chips) 
7013yuki: posts small blind $0.05
AKs[EV+]N: posts big blind $0.10
*** HOLE CARDS ***
tremsbuettel: calls $0.10
cao87: folds 
Alinyr: folds 
7013yuki: calls $0.05
AKs[EV+]N: checks 
*** FLOP *** [5d 7d Qd]
7013yuki: checks 
AKs[EV+]N: checks 
tremsbuettel: checks 
*** TURN *** [5d 7d Qd] [Td]
7013yuki: checks 
AKs[EV+]N: checks 
tremsbuettel: checks 
*** RIVER *** [5d 7d Qd Td] [Ac]
7013yuki: checks 
AKs[EV+]N: checks 
tremsbuettel: checks 
*** SHOW DOWN ***
7013yuki: shows [Ks 8c] (high card Ace)
AKs[EV+]N: shows [5s Ts] (two pair, Tens and Fives)
tremsbuettel: mucks hand 
AKs[EV+]N collected $0.29 from pot
*** SUMMARY ***
Total pot $0.30 | Rake $0.01 
Board [5d 7d Qd Td Ac]
Seat 1: AKs[EV+]N (big blind) showed [5s Ts] and won ($0.29) with two pair, Tens and Fives
Seat 2: tremsbuettel mucked
Seat 4: cao87 folded before Flop (didn't bet)
Seat 5: Alinyr (button) folded before Flop (didn't bet)
Seat 6: 7013yuki (small blind) showed [Ks 8c] and lost with high card Ace



PokerStars Hand #201502248124:  Hold'em No Limit ($0.05/$0.10 USD) - 2019/06/18 5:25:26 ET
Table 'Achird' 6-max Seat #6 is the button
Seat 1: AKs[EV+]N ($15.38 in chips) 
Seat 2: tremsbuettel ($8.93 in chips) 
Seat 4: cao87 ($10 in chips) 
Seat 5: Alinyr ($21.45 in chips) 
Seat 6: 7013yuki ($4 in chips) 
AKs[EV+]N: posts small blind $0.05
tremsbuettel: posts big blind $0.10
*** HOLE CARDS ***
cao87: folds 
Alinyr: folds 
7013yuki: raises $0.20 to $0.30
AKs[EV+]N: folds 
tremsbuettel: calls $0.20
*** FLOP *** [7h 5h 9d]
tremsbuettel: bets $0.62
7013yuki: raises $0.62 to $1.24
tremsbuettel: calls $0.62
*** TURN *** [7h 5h 9d] [5d]
tremsbuettel: checks 
7013yuki: bets $1.10
tremsbuettel: calls $1.10
*** RIVER *** [7h 5h 9d 5d] [4h]
tremsbuettel: checks 
7013yuki: bets $1.36 and is all-in
tremsbuettel: folds 
Uncalled bet ($1.36) returned to 7013yuki
7013yuki collected $5.09 from pot
*** SUMMARY ***
Total pot $5.33 | Rake $0.24 
Board [7h 5h 9d 5d 4h]
Seat 1: AKs[EV+]N (small blind) folded before Flop
Seat 2: tremsbuettel (big blind) folded on the River
Seat 4: cao87 folded before Flop (didn't bet)
Seat 5: Alinyr folded before Flop (didn't bet)
Seat 6: 7013yuki (button) collected ($5.09)



PokerStars Hand #201502262815:  Hold'em No Limit ($0.05/$0.10 USD) - 2019/06/18 5:26:27 ET
Table 'Achird' 6-max Seat #1 is the button
Seat 1: AKs[EV+]N ($15.33 in chips) 
Seat 2: tremsbuettel ($6.29 in chips) 
Seat 4: cao87 ($10 in chips) 
Seat 5: Alinyr ($21.45 in chips) 
Seat 6: 7013yuki ($6.45 in chips) 
tremsbuettel: posts small blind $0.05
cao87: posts big blind $0.10
*** HOLE CARDS ***
Alinyr: folds 
7013yuki: calls $0.10
AKs[EV+]N: folds 
tremsbuettel: calls $0.05
cao87: checks 
*** FLOP *** [8s Qs 2s]
tremsbuettel: checks 
cao87: checks 
7013yuki: bets $0.10
tremsbuettel: folds 
cao87: folds 
Uncalled bet ($0.10) returned to 7013yuki
7013yuki collected $0.29 from pot
7013yuki: doesn't show hand 
*** SUMMARY ***
Total pot $0.30 | Rake $0.01 
Board [8s Qs 2s]
Seat 1: AKs[EV+]N (button) folded before Flop (didn't bet)
Seat 2: tremsbuettel (small blind) folded on the Flop
Seat 4: cao87 (big blind) folded on the Flop
Seat 5: Alinyr folded before Flop (didn't bet)
Seat 6: 7013yuki collected ($0.29)



PokerStars Hand #201502272474:  Hold'em No Limit ($0.05/$0.10 USD) - 2019/06/18 5:27:07 ET
Table 'Achird' 6-max Seat #2 is the button
Seat 1: AKs[EV+]N ($15.33 in chips) 
Seat 2: tremsbuettel ($6.19 in chips) 
Seat 4: cao87 ($10 in chips) 
Seat 5: Alinyr ($21.45 in chips) 
Seat 6: 7013yuki ($6.64 in chips) 
cao87: posts small blind $0.05
Alinyr: posts big blind $0.10
*** HOLE CARDS ***
7013yuki: folds 
AKs[EV+]N: folds 
tremsbuettel: calls $0.10
cao87: folds 
Alinyr: checks 
*** FLOP *** [Qc Ad 4d]
Alinyr: checks 
tremsbuettel: checks 
*** TURN *** [Qc Ad 4d] [Jc]
Alinyr: checks 
tremsbuettel: checks 
*** RIVER *** [Qc Ad 4d Jc] [6h]
Alinyr: checks 
tremsbuettel: checks 
*** SHOW DOWN ***
Alinyr: shows [3c 5d] (high card Ace)
tremsbuettel: shows [7d Ah] (a pair of Aces)
tremsbuettel collected $0.24 from pot
*** SUMMARY ***
Total pot $0.25 | Rake $0.01 
Board [Qc Ad 4d Jc 6h]
Seat 1: AKs[EV+]N folded before Flop (didn't bet)
Seat 2: tremsbuettel (button) showed [7d Ah] and won ($0.24) with a pair of Aces
Seat 4: cao87 (small blind) folded before Flop
Seat 5: Alinyr (big blind) showed [3c 5d] and lost with high card Ace
Seat 6: 7013yuki folded before Flop (didn't bet)



PokerStars Hand #201502280535:  Hold'em No Limit ($0.05/$0.10 USD) - 2019/06/18 5:27:41 ET
Table 'Achird' 6-max Seat #4 is the button
Seat 1: AKs[EV+]N ($15.33 in chips) 
Seat 2: tremsbuettel ($6.33 in chips) 
Seat 4: cao87 ($10 in chips) 
Seat 5: Alinyr ($21.35 in chips) 
Seat 6: 7013yuki ($6.64 in chips) 
Alinyr: posts small blind $0.05
7013yuki: posts big blind $0.10
part0s777: sits out 
*** HOLE CARDS ***
AKs[EV+]N: raises $0.15 to $0.25
tremsbuettel: folds 
cao87: folds 
Alinyr: folds 
7013yuki: calls $0.15
*** FLOP *** [8c 9h Td]
7013yuki: checks 
AKs[EV+]N: checks 
*** TURN *** [8c 9h Td] [4d]
7013yuki: checks 
AKs[EV+]N: checks 
*** RIVER *** [8c 9h Td 4d] [Qh]
7013yuki: bets $3
AKs[EV+]N: folds 
Uncalled bet ($3) returned to 7013yuki
7013yuki collected $0.53 from pot
7013yuki: doesn't show hand 
*** SUMMARY ***
Total pot $0.55 | Rake $0.02 
Board [8c 9h Td 4d Qh]
Seat 1: AKs[EV+]N folded on the River
Seat 2: tremsbuettel folded before Flop (didn't bet)
Seat 4: cao87 (button) folded before Flop (didn't bet)
Seat 5: Alinyr (small blind) folded before Flop
Seat 6: 7013yuki (big blind) collected ($0.53)



PokerStars Hand #201502294771:  Hold'em No Limit ($0.05/$0.10 USD) - 2019/06/18 5:28:40 ET
Table 'Achird' 6-max Seat #5 is the button
Seat 1: AKs[EV+]N ($15.08 in chips) 
Seat 2: tremsbuettel ($6.33 in chips) 
Seat 4: cao87 ($10 in chips) 
Seat 5: Alinyr ($21.30 in chips) 
Seat 6: 7013yuki ($6.92 in chips) 
7013yuki: posts small blind $0.05
AKs[EV+]N: posts big blind $0.10
*** HOLE CARDS ***
tremsbuettel: calls $0.10
cao87: folds 
Alinyr: raises $0.30 to $0.40
7013yuki: calls $0.35
AKs[EV+]N: folds 
tremsbuettel: folds 
*** FLOP *** [Ad 3d 9d]
7013yuki: bets $0.10
Alinyr: calls $0.10
*** TURN *** [Ad 3d 9d] [Js]
7013yuki: bets $0.10
Alinyr: calls $0.10
*** RIVER *** [Ad 3d 9d Js] [5h]
7013yuki: bets $0.80
part0s777 leaves the table
Alinyr: calls $0.80
*** SHOW DOWN ***
7013yuki: shows [Jh Ts] (a pair of Jacks)
Alinyr: shows [Ah 6h] (a pair of Aces)
Shivas prana joins the table at seat #3 
Alinyr collected $2.86 from pot
*** SUMMARY ***
Total pot $3 | Rake $0.14 
Board [Ad 3d 9d Js 5h]
Seat 1: AKs[EV+]N (big blind) folded before Flop
Seat 2: tremsbuettel folded before Flop
Seat 4: cao87 folded before Flop (didn't bet)
Seat 5: Alinyr (button) showed [Ah 6h] and won ($2.86) with a pair of Aces
Seat 6: 7013yuki (small blind) showed [Jh Ts] and lost with a pair of Jacks



PokerStars Hand #201502528481:  Hold'em No Limit ($0.05/$0.10 USD) - 2019/06/18 5:44:31 ET
Table 'Achird' 6-max Seat #5 is the button
Seat 1: AKs[EV+]N ($16.88 in chips) 
Seat 2: tremsbuettel ($11.47 in chips) 
Seat 3: Shivas prana ($10 in chips) 
Seat 4: letovpower ($10 in chips) 
Seat 5: Alinyr ($35.71 in chips) 
AKs[EV+]N: posts small blind $0.05
tremsbuettel: posts big blind $0.10
*** HOLE CARDS ***
Shivas prana: folds 
letovpower: folds 
Alinyr: raises $0.15 to $0.25
AKs[EV+]N: folds 
tremsbuettel: folds 
Uncalled bet ($0.15) returned to Alinyr
Alinyr collected $0.25 from pot
Alinyr: doesn't show hand 
*** SUMMARY ***
Total pot $0.25 | Rake $0 
Seat 1: AKs[EV+]N (small blind) folded before Flop
Seat 2: tremsbuettel (big blind) folded before Flop
Seat 3: Shivas prana folded before Flop (didn't bet)
Seat 4: letovpower folded before Flop (didn't bet)
Seat 5: Alinyr (button) collected ($0.25)



PokerStars Hand #201502918048:  Hold'em No Limit ($0.05/$0.10 USD) - 2019/06/18 6:10:35 ET
Table 'Achird' 6-max Seat #2 is the button
Seat 1: Wolveredo ($10.36 in chips) 
Seat 2: tremsbuettel ($7.21 in chips) 
Seat 3: Shivas prana ($10 in chips) 
Seat 4: letovpower ($10 in chips) 
Seat 5: Alinyr ($46.92 in chips) 
Seat 6: ale9030 ($10 in chips) 
Shivas prana: posts small blind $0.05
letovpower: posts big blind $0.10
*** HOLE CARDS ***
Alinyr: folds 
ale9030: folds 
Wolveredo: raises $0.15 to $0.25
tremsbuettel: folds 
Shivas prana: folds 
letovpower: folds 
Uncalled bet ($0.15) returned to Wolveredo
Wolveredo collected $0.25 from pot
Wolveredo: doesn't show hand 
*** SUMMARY ***
Total pot $0.25 | Rake $0 
Seat 1: Wolveredo collected ($0.25)
Seat 2: tremsbuettel (button) folded before Flop (didn't bet)
Seat 3: Shivas prana (small blind) folded before Flop
Seat 4: letovpower (big blind) folded before Flop
Seat 5: Alinyr folded before Flop (didn't bet)
Seat 6: ale9030 folded before Flop (didn't bet)



PokerStars Hand #201502924550:  Hold'em No Limit ($0.05/$0.10 USD) - 2019/06/18 6:11:00 ET
Table 'Achird' 6-max Seat #3 is the button
Seat 1: Wolveredo ($10.51 in chips) 
Seat 2: tremsbuettel ($7.21 in chips) 
Seat 3: Shivas prana ($10 in chips) 
Seat 4: letovpower ($10 in chips) 
Seat 5: Alinyr ($46.92 in chips) 
Seat 6: ale9030 ($10 in chips) 
letovpower: posts small blind $0.05
Alinyr: posts big blind $0.10
*** HOLE CARDS ***
ale9030: folds 
Wolveredo: folds 
tremsbuettel: folds 
Shivas prana: folds 
letovpower: folds 
Uncalled bet ($0.05) returned to Alinyr
Alinyr collected $0.10 from pot
Alinyr: doesn't show hand 
*** SUMMARY ***
Total pot $0.10 | Rake $0 
Seat 1: Wolveredo folded before Flop (didn't bet)
Seat 2: tremsbuettel folded before Flop (didn't bet)
Seat 3: Shivas prana (button) folded before Flop (didn't bet)
Seat 4: letovpower (small blind) folded before Flop
Seat 5: Alinyr (big blind) collected ($0.10)
Seat 6: ale9030 folded before Flop (didn't bet)



PokerStars Hand #201502929889:  Hold'em No Limit ($0.05/$0.10 USD) - 2019/06/18 6:11:20 ET
Table 'Achird' 6-max Seat #4 is the button
Seat 1: Wolveredo ($10.51 in chips) 
Seat 2: tremsbuettel ($7.21 in chips) 
Seat 3: Shivas prana ($10 in chips) 
Seat 4: letovpower ($10 in chips) 
Seat 5: Alinyr ($46.97 in chips) 
Seat 6: ale9030 ($10 in chips) 
Alinyr: posts small blind $0.05
ale9030: posts big blind $0.10
*** HOLE CARDS ***
Wolveredo: raises $0.15 to $0.25
tremsbuettel: calls $0.25
Shivas prana: folds 
letovpower: folds 
Alinyr: folds 
ale9030: folds 
*** FLOP *** [Kh Qh 5c]
Wolveredo: bets $0.42
tremsbuettel: folds 
Uncalled bet ($0.42) returned to Wolveredo
Wolveredo collected $0.62 from pot
Wolveredo: doesn't show hand 
*** SUMMARY ***
Total pot $0.65 | Rake $0.03 
Board [Kh Qh 5c]
Seat 1: Wolveredo collected ($0.62)
Seat 2: tremsbuettel folded on the Flop
Seat 3: Shivas prana folded before Flop (didn't bet)
Seat 4: letovpower (button) folded before Flop (didn't bet)
Seat 5: Alinyr (small blind) folded before Flop
Seat 6: ale9030 (big blind) folded before Flop



PokerStars Hand #201502938723:  Hold'em No Limit ($0.05/$0.10 USD) - 2019/06/18 6:11:54 ET
Table 'Achird' 6-max Seat #5 is the button
Seat 1: Wolveredo ($10.88 in chips) 
Seat 2: tremsbuettel ($6.96 in chips) 
Seat 3: Shivas prana ($10 in chips) 
Seat 4: letovpower ($10 in chips) 
Seat 5: Alinyr ($46.92 in chips) 
Seat 6: ale9030 ($10 in chips) 
ale9030: posts small blind $0.05
Wolveredo: posts big blind $0.10
*** HOLE CARDS ***
tremsbuettel: folds 
Shivas prana: folds 
letovpower: folds 
Alinyr: folds 
ale9030: calls $0.05
Wolveredo: checks 
*** FLOP *** [2s Ad 7d]
ale9030: bets $0.10
Wolveredo: raises $0.24 to $0.34
ale9030: folds 
Uncalled bet ($0.24) returned to Wolveredo
Wolveredo collected $0.38 from pot
Wolveredo: doesn't show hand 
*** SUMMARY ***
Total pot $0.40 | Rake $0.02 
Board [2s Ad 7d]
Seat 1: Wolveredo (big blind) collected ($0.38)
Seat 2: tremsbuettel folded before Flop (didn't bet)
Seat 3: Shivas prana folded before Flop (didn't bet)
Seat 4: letovpower folded before Flop (didn't bet)
Seat 5: Alinyr (button) folded before Flop (didn't bet)
Seat 6: ale9030 (small blind) folded on the Flop



PokerStars Hand #201502954472:  Hold'em No Limit ($0.05/$0.10 USD) - 2019/06/18 6:12:52 ET
Table 'Achird' 6-max Seat #6 is the button
Seat 1: Wolveredo ($11.06 in chips) 
Seat 2: tremsbuettel ($6.96 in chips) 
Seat 3: Shivas prana ($10 in chips) 
Seat 4: letovpower ($10 in chips) 
Seat 5: Alinyr ($46.92 in chips) 
Seat 6: ale9030 ($10 in chips) 
Wolveredo: posts small blind $0.05
tremsbuettel: posts big blind $0.10
*** HOLE CARDS ***
Shivas prana: folds 
letovpower: raises $0.20 to $0.30
Alinyr: folds 
ale9030: folds 
Wolveredo: raises $0.70 to $1
tremsbuettel: folds 
letovpower: folds 
Uncalled bet ($0.70) returned to Wolveredo
Wolveredo collected $0.70 from pot
Wolveredo: doesn't show hand 
*** SUMMARY ***
Total pot $0.70 | Rake $0 
Seat 1: Wolveredo (small blind) collected ($0.70)
Seat 2: tremsbuettel (big blind) folded before Flop
Seat 3: Shivas prana folded before Flop (didn't bet)
Seat 4: letovpower folded before Flop
Seat 5: Alinyr folded before Flop (didn't bet)
Seat 6: ale9030 (button) folded before Flop (didn't bet)



PokerStars Hand #201502959349:  Hold'em No Limit ($0.05/$0.10 USD) - 2019/06/18 6:13:10 ET
Table 'Achird' 6-max Seat #1 is the button
Seat 1: Wolveredo ($11.46 in chips) 
Seat 2: tremsbuettel ($6.86 in chips) 
Seat 3: Shivas prana ($10 in chips) 
Seat 4: letovpower ($10 in chips) 
Seat 5: Alinyr ($46.92 in chips) 
Seat 6: ale9030 ($10 in chips) 
tremsbuettel: posts small blind $0.05
Shivas prana: posts big blind $0.10
*** HOLE CARDS ***
letovpower: folds 
Alinyr: folds 
ale9030: folds 
Wolveredo: raises $0.15 to $0.25
tremsbuettel: calls $0.20
Shivas prana: folds 
*** FLOP *** [Tc 8h 2d]
tremsbuettel: checks 
Wolveredo: bets $0.19
tremsbuettel: calls $0.19
*** TURN *** [Tc 8h 2d] [2s]
tremsbuettel: bets $0.94
Wolveredo: folds 
Uncalled bet ($0.94) returned to tremsbuettel
tremsbuettel collected $0.94 from pot
tremsbuettel: doesn't show hand 
*** SUMMARY ***
Total pot $0.98 | Rake $0.04 
Board [Tc 8h 2d 2s]
Seat 1: Wolveredo (button) folded on the Turn
Seat 2: tremsbuettel (small blind) collected ($0.94)
Seat 3: Shivas prana (big blind) folded before Flop
Seat 4: letovpower folded before Flop (didn't bet)
Seat 5: Alinyr folded before Flop (didn't bet)
Seat 6: ale9030 folded before Flop (didn't bet)



PokerStars Hand #201502976200:  Hold'em No Limit ($0.05/$0.10 USD) - 2019/06/18 6:14:13 ET
Table 'Achird' 6-max Seat #2 is the button
Seat 1: Wolveredo ($11.02 in chips) 
Seat 2: tremsbuettel ($7.36 in chips) 
Seat 3: Shivas prana ($10 in chips) 
Seat 4: letovpower ($10 in chips) 
Seat 5: Alinyr ($46.92 in chips) 
Seat 6: ale9030 ($10 in chips) 
Shivas prana: posts small blind $0.05
letovpower: posts big blind $0.10
*** HOLE CARDS ***
Alinyr: folds 
ale9030: folds 
Wolveredo has timed out
Wolveredo: folds 
tremsbuettel: calls $0.10
Shivas prana: folds 
letovpower: raises $0.30 to $0.40
tremsbuettel: folds 
Uncalled bet ($0.30) returned to letovpower
letovpower collected $0.25 from pot
letovpower: doesn't show hand 
*** SUMMARY ***
Total pot $0.25 | Rake $0 
Seat 1: Wolveredo folded before Flop (didn't bet)
Seat 2: tremsbuettel (button) folded before Flop
Seat 3: Shivas prana (small blind) folded before Flop
Seat 4: letovpower (big blind) collected ($0.25)
Seat 5: Alinyr folded before Flop (didn't bet)
Seat 6: ale9030 folded before Flop (didn't bet)



PokerStars Hand #201502983660:  Hold'em No Limit ($0.05/$0.10 USD) - 2019/06/18 6:14:41 ET
Table 'Achird' 6-max Seat #3 is the button
Seat 1: Wolveredo ($11.02 in chips) 
Seat 2: tremsbuettel ($7.26 in chips) 
Seat 3: Shivas prana ($10 in chips) 
Seat 4: letovpower ($10.15 in chips) 
Seat 5: Alinyr ($46.92 in chips) 
Seat 6: ale9030 ($10 in chips) 
letovpower: posts small blind $0.05
Alinyr: posts big blind $0.10
*** HOLE CARDS ***
ale9030: folds 
Wolveredo: folds 
tremsbuettel: calls $0.10
Shivas prana: raises $0.30 to $0.40
letovpower: folds 
Alinyr: calls $0.30
tremsbuettel: calls $0.30
*** FLOP *** [Qs Jd 3h]
Alinyr: checks 
tremsbuettel: checks 
Shivas prana: checks 
*** TURN *** [Qs Jd 3h] [6d]
Alinyr: checks 
tremsbuettel: checks 
Shivas prana: checks 
*** RIVER *** [Qs Jd 3h 6d] [Kd]
Alinyr: bets $0.82
tremsbuettel: folds 
Shivas prana: folds 
Uncalled bet ($0.82) returned to Alinyr
Alinyr collected $1.19 from pot
Alinyr: doesn't show hand 
*** SUMMARY ***
Total pot $1.25 | Rake $0.06 
Board [Qs Jd 3h 6d Kd]
Seat 1: Wolveredo folded before Flop (didn't bet)
Seat 2: tremsbuettel folded on the River
Seat 3: Shivas prana (button) folded on the River
Seat 4: letovpower (small blind) folded before Flop
Seat 5: Alinyr (big blind) collected ($1.19)
Seat 6: ale9030 folded before Flop (didn't bet)



PokerStars Hand #201503003849:  Hold'em No Limit ($0.05/$0.10 USD) - 2019/06/18 6:15:56 ET
Table 'Achird' 6-max Seat #4 is the button
Seat 1: Wolveredo ($11.02 in chips) 
Seat 2: tremsbuettel ($6.86 in chips) 
Seat 3: Shivas prana ($10 in chips) 
Seat 4: letovpower ($10.10 in chips) 
Seat 5: Alinyr ($47.71 in chips) 
Seat 6: ale9030 ($10 in chips) 
Alinyr: posts small blind $0.05
ale9030: posts big blind $0.10
*** HOLE CARDS ***
Wolveredo: raises $0.15 to $0.25
tremsbuettel: folds 
Shivas prana: folds 
letovpower: folds 
Alinyr: folds 
ale9030: folds 
Uncalled bet ($0.15) returned to Wolveredo
Wolveredo collected $0.25 from pot
Wolveredo: doesn't show hand 
*** SUMMARY ***
Total pot $0.25 | Rake $0 
Seat 1: Wolveredo collected ($0.25)
Seat 2: tremsbuettel folded before Flop (didn't bet)
Seat 3: Shivas prana folded before Flop (didn't bet)
Seat 4: letovpower (button) folded before Flop (didn't bet)
Seat 5: Alinyr (small blind) folded before Flop
Seat 6: ale9030 (big blind) folded before Flop



PokerStars Hand #201503010297:  Hold'em No Limit ($0.05/$0.10 USD) - 2019/06/18 6:16:21 ET
Table 'Achird' 6-max Seat #5 is the button
Seat 1: Wolveredo ($11.17 in chips) 
Seat 2: tremsbuettel ($6.86 in chips) 
Seat 3: Shivas prana ($10 in chips) 
Seat 4: letovpower ($10.10 in chips) 
Seat 5: Alinyr ($47.66 in chips) 
Seat 6: ale9030 ($10 in chips) 
ale9030: posts small blind $0.05
Wolveredo: posts big blind $0.10
*** HOLE CARDS ***
tremsbuettel: folds 
Shivas prana: folds 
letovpower: folds 
Alinyr: raises $0.15 to $0.25
ale9030: folds 
Wolveredo: folds 
Uncalled bet ($0.15) returned to Alinyr
Alinyr collected $0.25 from pot
Alinyr: doesn't show hand 
*** SUMMARY ***
Total pot $0.25 | Rake $0 
Seat 1: Wolveredo (big blind) folded before Flop
Seat 2: tremsbuettel folded before Flop (didn't bet)
Seat 3: Shivas prana folded before Flop (didn't bet)
Seat 4: letovpower folded before Flop (didn't bet)
Seat 5: Alinyr (button) collected ($0.25)
Seat 6: ale9030 (small blind) folded before Flop



PokerStars Hand #201503014992:  Hold'em No Limit ($0.05/$0.10 USD) - 2019/06/18 6:16:39 ET
Table 'Achird' 6-max Seat #6 is the button
Seat 1: Wolveredo ($11.07 in chips) 
Seat 2: tremsbuettel ($6.86 in chips) 
Seat 3: Shivas prana ($10 in chips) 
Seat 4: letovpower ($10.10 in chips) 
Seat 5: Alinyr ($47.81 in chips) 
Seat 6: ale9030 ($10 in chips) 
Wolveredo: posts small blind $0.05
tremsbuettel: posts big blind $0.10
*** HOLE CARDS ***
Shivas prana: folds 
letovpower: folds 
Alinyr: folds 
ale9030: folds 
Wolveredo: folds 
Uncalled bet ($0.05) returned to tremsbuettel
tremsbuettel collected $0.10 from pot
tremsbuettel: doesn't show hand 
*** SUMMARY ***
Total pot $0.10 | Rake $0 
Seat 1: Wolveredo (small blind) folded before Flop
Seat 2: tremsbuettel (big blind) collected ($0.10)
Seat 3: Shivas prana folded before Flop (didn't bet)
Seat 4: letovpower folded before Flop (didn't bet)
Seat 5: Alinyr folded before Flop (didn't bet)
Seat 6: ale9030 (button) folded before Flop (didn't bet)



PokerStars Hand #201503019058:  Hold'em No Limit ($0.05/$0.10 USD) - 2019/06/18 6:16:54 ET
Table 'Achird' 6-max Seat #1 is the button
Seat 1: Wolveredo ($11.02 in chips) 
Seat 2: tremsbuettel ($6.91 in chips) 
Seat 3: Shivas prana ($10 in chips) 
Seat 4: letovpower ($10.10 in chips) 
Seat 5: Alinyr ($47.81 in chips) 
Seat 6: ale9030 ($10 in chips) 
tremsbuettel: posts small blind $0.05
Shivas prana: posts big blind $0.10
*** HOLE CARDS ***
letovpower: raises $0.20 to $0.30
Alinyr: folds 
ale9030: folds 
Wolveredo: folds 
tremsbuettel: folds 
Shivas prana: folds 
Uncalled bet ($0.20) returned to letovpower
letovpower collected $0.25 from pot
letovpower: doesn't show hand 
*** SUMMARY ***
Total pot $0.25 | Rake $0 
Seat 1: Wolveredo (button) folded before Flop (didn't bet)
Seat 2: tremsbuettel (small blind) folded before Flop
Seat 3: Shivas prana (big blind) folded before Flop
Seat 4: letovpower collected ($0.25)
Seat 5: Alinyr folded before Flop (didn't bet)
Seat 6: ale9030 folded before Flop (didn't bet)



PokerStars Hand #201503023189:  Hold'em No Limit ($0.05/$0.10 USD) - 2019/06/18 6:17:09 ET
Table 'Achird' 6-max Seat #2 is the button
Seat 1: Wolveredo ($11.02 in chips) 
Seat 2: tremsbuettel ($6.86 in chips) 
Seat 3: Shivas prana ($10 in chips) 
Seat 4: letovpower ($10.25 in chips) 
Seat 5: Alinyr ($47.81 in chips) 
Seat 6: ale9030 ($10 in chips) 
Shivas prana: posts small blind $0.05
letovpower: posts big blind $0.10
*** HOLE CARDS ***
Alinyr: folds 
ale9030: raises $0.20 to $0.30
Wolveredo: folds 
tremsbuettel: folds 
Shivas prana: folds 
letovpower: raises $0.75 to $1.05
ale9030: folds 
Uncalled bet ($0.75) returned to letovpower
letovpower collected $0.65 from pot
letovpower: doesn't show hand 
*** SUMMARY ***
Total pot $0.65 | Rake $0 
Seat 1: Wolveredo folded before Flop (didn't bet)
Seat 2: tremsbuettel (button) folded before Flop (didn't bet)
Seat 3: Shivas prana (small blind) folded before Flop
Seat 4: letovpower (big blind) collected ($0.65)
Seat 5: Alinyr folded before Flop (didn't bet)
Seat 6: ale9030 folded before Flop



PokerStars Hand #201502828340:  Hold'em No Limit ($0.05/$0.10 USD) - 2019/06/18 6:04:52 ET
Table 'Achird' 6-max Seat #6 is the button
Seat 1: Wolveredo ($10.05 in chips) 
Seat 2: tremsbuettel ($6.78 in chips) 
Seat 3: Shivas prana ($10 in chips) 
Seat 4: letovpower ($10.65 in chips) 
Seat 5: Alinyr ($46.53 in chips) 
Seat 6: ale9030 ($10 in chips) 
Wolveredo: posts small blind $0.05
tremsbuettel: posts big blind $0.10
*** HOLE CARDS ***
Shivas prana: folds 
letovpower: folds 
Alinyr: folds 
ale9030: folds 
Wolveredo: folds 
Uncalled bet ($0.05) returned to tremsbuettel
tremsbuettel collected $0.10 from pot
tremsbuettel: doesn't show hand 
*** SUMMARY ***
Total pot $0.10 | Rake $0 
Seat 1: Wolveredo (small blind) folded before Flop
Seat 2: tremsbuettel (big blind) collected ($0.10)
Seat 3: Shivas prana folded before Flop (didn't bet)
Seat 4: letovpower folded before Flop (didn't bet)
Seat 5: Alinyr folded before Flop (didn't bet)
Seat 6: ale9030 (button) folded before Flop (didn't bet)



PokerStars Hand #201502834452:  Hold'em No Limit ($0.05/$0.10 USD) - 2019/06/18 6:05:16 ET
Table 'Achird' 6-max Seat #1 is the button
Seat 1: Wolveredo ($10 in chips) 
Seat 2: tremsbuettel ($6.83 in chips) 
Seat 3: Shivas prana ($10 in chips) 
Seat 4: letovpower ($10.65 in chips) 
Seat 5: Alinyr ($46.53 in chips) 
Seat 6: ale9030 ($10 in chips) 
tremsbuettel: posts small blind $0.05
Shivas prana: posts big blind $0.10
*** HOLE CARDS ***
letovpower: folds 
Alinyr: folds 
ale9030: folds 
Wolveredo: folds 
tremsbuettel: calls $0.05
Shivas prana: checks 
*** FLOP *** [3c Kh 9d]
tremsbuettel: checks 
Shivas prana: checks 
*** TURN *** [3c Kh 9d] [Td]
tremsbuettel: bets $0.19
Shivas prana: folds 
Uncalled bet ($0.19) returned to tremsbuettel
tremsbuettel collected $0.19 from pot
tremsbuettel: doesn't show hand 
*** SUMMARY ***
Total pot $0.20 | Rake $0.01 
Board [3c Kh 9d Td]
Seat 1: Wolveredo (button) folded before Flop (didn't bet)
Seat 2: tremsbuettel (small blind) collected ($0.19)
Seat 3: Shivas prana (big blind) folded on the Turn
Seat 4: letovpower folded before Flop (didn't bet)
Seat 5: Alinyr folded before Flop (didn't bet)
Seat 6: ale9030 folded before Flop (didn't bet)



PokerStars Hand #201502843964:  Hold'em No Limit ($0.05/$0.10 USD) - 2019/06/18 6:05:52 ET
Table 'Achird' 6-max Seat #2 is the button
Seat 1: Wolveredo ($10 in chips) 
Seat 2: tremsbuettel ($6.92 in chips) 
Seat 3: Shivas prana ($10 in chips) 
Seat 4: letovpower ($10.65 in chips) 
Seat 5: Alinyr ($46.53 in chips) 
Seat 6: ale9030 ($10 in chips) 
Shivas prana: posts small blind $0.05
letovpower: posts big blind $0.10
*** HOLE CARDS ***
Alinyr: folds 
ale9030: folds 
Wolveredo: raises $0.15 to $0.25
tremsbuettel: folds 
Shivas prana: folds 
letovpower: calls $0.15
*** FLOP *** [8s Qd 9s]
letovpower: checks 
Wolveredo: checks 
*** TURN *** [8s Qd 9s] [9d]
letovpower: checks 
Wolveredo: checks 
*** RIVER *** [8s Qd 9s 9d] [7c]
letovpower: checks 
Wolveredo: checks 
*** SHOW DOWN ***
letovpower: shows [Ac 5h] (a pair of Nines)
Wolveredo: shows [4h 4c] (two pair, Nines and Fours)
Wolveredo collected $0.53 from pot
*** SUMMARY ***
Total pot $0.55 | Rake $0.02 
Board [8s Qd 9s 9d 7c]
Seat 1: Wolveredo showed [4h 4c] and won ($0.53) with two pair, Nines and Fours
Seat 2: tremsbuettel (button) folded before Flop (didn't bet)
Seat 3: Shivas prana (small blind) folded before Flop
Seat 4: letovpower (big blind) showed [Ac 5h] and lost with a pair of Nines
Seat 5: Alinyr folded before Flop (didn't bet)
Seat 6: ale9030 folded before Flop (didn't bet)



PokerStars Hand #201502857774:  Hold'em No Limit ($0.05/$0.10 USD) - 2019/06/18 6:06:45 ET
Table 'Achird' 6-max Seat #3 is the button
Seat 1: Wolveredo ($10.28 in chips) 
Seat 2: tremsbuettel ($6.92 in chips) 
Seat 3: Shivas prana ($10 in chips) 
Seat 4: letovpower ($10.40 in chips) 
Seat 5: Alinyr ($46.53 in chips) 
Seat 6: ale9030 ($10 in chips) 
letovpower: posts small blind $0.05
Alinyr: posts big blind $0.10
*** HOLE CARDS ***
ale9030: folds 
Wolveredo: raises $0.15 to $0.25
tremsbuettel: folds 
Shivas prana: folds 
letovpower: folds 
Alinyr: calls $0.15
*** FLOP *** [4c Jh 4s]
Alinyr: checks 
Wolveredo: bets $0.18
Alinyr: calls $0.18
*** TURN *** [4c Jh 4s] [Ad]
Alinyr: checks 
Wolveredo: checks 
*** RIVER *** [4c Jh 4s Ad] [3d]
Alinyr: bets $0.62
Wolveredo: folds 
Uncalled bet ($0.62) returned to Alinyr
Alinyr collected $0.87 from pot
Alinyr: doesn't show hand 
*** SUMMARY ***
Total pot $0.91 | Rake $0.04 
Board [4c Jh 4s Ad 3d]
Seat 1: Wolveredo folded on the River
Seat 2: tremsbuettel folded before Flop (didn't bet)
Seat 3: Shivas prana (button) folded before Flop (didn't bet)
Seat 4: letovpower (small blind) folded before Flop
Seat 5: Alinyr (big blind) collected ($0.87)
Seat 6: ale9030 folded before Flop (didn't bet)



PokerStars Hand #201502877195:  Hold'em No Limit ($0.05/$0.10 USD) - 2019/06/18 6:07:59 ET
Table 'Achird' 6-max Seat #4 is the button
Seat 1: Wolveredo ($10 in chips) 
Seat 2: tremsbuettel ($6.92 in chips) 
Seat 3: Shivas prana ($10 in chips) 
Seat 4: letovpower ($10.35 in chips) 
Seat 5: Alinyr ($46.97 in chips) 
Seat 6: ale9030 ($10 in chips) 
Alinyr: posts small blind $0.05
ale9030: posts big blind $0.10
*** HOLE CARDS ***
Wolveredo: folds 
tremsbuettel: calls $0.10
Shivas prana: folds 
letovpower: raises $0.25 to $0.35
Alinyr: folds 
ale9030: folds 
tremsbuettel: calls $0.25
*** FLOP *** [6c 9s 8c]
tremsbuettel: checks 
letovpower: checks 
*** TURN *** [6c 9s 8c] [5s]
tremsbuettel: checks 
letovpower: checks 
*** RIVER *** [6c 9s 8c 5s] [6s]
tremsbuettel: bets $0.81
letovpower: folds 
Uncalled bet ($0.81) returned to tremsbuettel
tremsbuettel collected $0.81 from pot
tremsbuettel: doesn't show hand 
*** SUMMARY ***
Total pot $0.85 | Rake $0.04 
Board [6c 9s 8c 5s 6s]
Seat 1: Wolveredo folded before Flop (didn't bet)
Seat 2: tremsbuettel collected ($0.81)
Seat 3: Shivas prana folded before Flop (didn't bet)
Seat 4: letovpower (button) folded on the River
Seat 5: Alinyr (small blind) folded before Flop
Seat 6: ale9030 (big blind) folded before Flop



PokerStars Hand #201502886756:  Hold'em No Limit ($0.05/$0.10 USD) - 2019/06/18 6:08:36 ET
Table 'Achird' 6-max Seat #5 is the button
Seat 1: Wolveredo ($10 in chips) 
Seat 2: tremsbuettel ($7.38 in chips) 
Seat 3: Shivas prana ($10 in chips) 
Seat 4: letovpower ($10 in chips) 
Seat 5: Alinyr ($46.92 in chips) 
Seat 6: ale9030 ($10 in chips) 
ale9030: posts small blind $0.05
Wolveredo: posts big blind $0.10
*** HOLE CARDS ***
tremsbuettel: calls $0.10
Shivas prana: folds 
letovpower: folds 
Alinyr: folds 
ale9030: folds 
Wolveredo: checks 
*** FLOP *** [Js 9c Jc]
Wolveredo: checks 
tremsbuettel: bets $0.24
Wolveredo: folds 
Uncalled bet ($0.24) returned to tremsbuettel
tremsbuettel collected $0.24 from pot
tremsbuettel: doesn't show hand 
*** SUMMARY ***
Total pot $0.25 | Rake $0.01 
Board [Js 9c Jc]
Seat 1: Wolveredo (big blind) folded on the Flop
Seat 2: tremsbuettel collected ($0.24)
Seat 3: Shivas prana folded before Flop (didn't bet)
Seat 4: letovpower folded before Flop (didn't bet)
Seat 5: Alinyr (button) folded before Flop (didn't bet)
Seat 6: ale9030 (small blind) folded before Flop



PokerStars Hand #201502894568:  Hold'em No Limit ($0.05/$0.10 USD) - 2019/06/18 6:09:06 ET
Table 'Achird' 6-max Seat #6 is the button
Seat 1: Wolveredo ($10 in chips) 
Seat 2: tremsbuettel ($7.52 in chips) 
Seat 3: Shivas prana ($10 in chips) 
Seat 4: letovpower ($10 in chips) 
Seat 5: Alinyr ($46.92 in chips) 
Seat 6: ale9030 ($10 in chips) 
Wolveredo: posts small blind $0.05
tremsbuettel: posts big blind $0.10
*** HOLE CARDS ***
Shivas prana: folds 
letovpower: folds 
Alinyr: folds 
ale9030: folds 
Wolveredo: raises $0.20 to $0.30
tremsbuettel: calls $0.20
*** FLOP *** [Tc Jc Ah]
Wolveredo: checks 
tremsbuettel: bets $0.10
Wolveredo: calls $0.10
*** TURN *** [Tc Jc Ah] [8d]
Wolveredo: bets $0.40
tremsbuettel: folds 
Uncalled bet ($0.40) returned to Wolveredo
Wolveredo collected $0.76 from pot
Wolveredo: doesn't show hand 
*** SUMMARY ***
Total pot $0.80 | Rake $0.04 
Board [Tc Jc Ah 8d]
Seat 1: Wolveredo (small blind) collected ($0.76)
Seat 2: tremsbuettel (big blind) folded on the Turn
Seat 3: Shivas prana folded before Flop (didn't bet)
Seat 4: letovpower folded before Flop (didn't bet)
Seat 5: Alinyr folded before Flop (didn't bet)
Seat 6: ale9030 (button) folded before Flop (didn't bet)



PokerStars Hand #201503028498:  Hold'em No Limit ($0.05/$0.10 USD) - 2019/06/18 6:17:29 ET
Table 'Achird' 6-max Seat #3 is the button
Seat 1: Wolveredo ($11.02 in chips) 
Seat 2: tremsbuettel ($6.86 in chips) 
Seat 3: Shivas prana ($10 in chips) 
Seat 4: letovpower ($10.60 in chips) 
Seat 5: Alinyr ($47.81 in chips) 
Seat 6: ale9030 ($10 in chips) 
letovpower: posts small blind $0.05
Alinyr: posts big blind $0.10
*** HOLE CARDS ***
ale9030: folds 
Wolveredo: folds 
tremsbuettel: calls $0.10
Shivas prana: folds 
letovpower: folds 
Alinyr: checks 
*** FLOP *** [Ts Ah Qc]
Alinyr: checks 
tremsbuettel: checks 
*** TURN *** [Ts Ah Qc] [9c]
Alinyr: checks 
tremsbuettel: checks 
*** RIVER *** [Ts Ah Qc 9c] [9d]
Alinyr: checks 
tremsbuettel: checks 
*** SHOW DOWN ***
Alinyr: shows [4d 5d] (a pair of Nines)
tremsbuettel: shows [Qh 8h] (two pair, Queens and Nines)
tremsbuettel collected $0.24 from pot
*** SUMMARY ***
Total pot $0.25 | Rake $0.01 
Board [Ts Ah Qc 9c 9d]
Seat 1: Wolveredo folded before Flop (didn't bet)
Seat 2: tremsbuettel showed [Qh 8h] and won ($0.24) with two pair, Queens and Nines
Seat 3: Shivas prana (button) folded before Flop (didn't bet)
Seat 4: letovpower (small blind) folded before Flop
Seat 5: Alinyr (big blind) showed [4d 5d] and lost with a pair of Nines
Seat 6: ale9030 folded before Flop (didn't bet)



PokerStars Hand #201503045316:  Hold'em No Limit ($0.05/$0.10 USD) - 2019/06/18 6:18:31 ET
Table 'Achird' 6-max Seat #4 is the button
Seat 1: Wolveredo ($11.02 in chips) 
Seat 2: tremsbuettel ($7 in chips) 
Seat 3: Shivas prana ($10 in chips) 
Seat 4: letovpower ($10.55 in chips) 
Seat 5: Alinyr ($47.71 in chips) 
Seat 6: ale9030 ($10 in chips) 
Alinyr: posts small blind $0.05
ale9030: posts big blind $0.10
*** HOLE CARDS ***
Wolveredo: folds 
tremsbuettel: folds 
Shivas prana: folds 
letovpower: folds 
Alinyr: folds 
Uncalled bet ($0.05) returned to ale9030
ale9030 collected $0.10 from pot
*** SUMMARY ***
Total pot $0.10 | Rake $0 
Seat 1: Wolveredo folded before Flop (didn't bet)
Seat 2: tremsbuettel folded before Flop (didn't bet)
Seat 3: Shivas prana folded before Flop (didn't bet)
Seat 4: letovpower (button) folded before Flop (didn't bet)
Seat 5: Alinyr (small blind) folded before Flop
Seat 6: ale9030 (big blind) collected ($0.10)



PokerStars Hand #201503049189:  Hold'em No Limit ($0.05/$0.10 USD) - 2019/06/18 6:18:46 ET
Table 'Achird' 6-max Seat #5 is the button
Seat 1: Wolveredo ($11.02 in chips) 
Seat 2: tremsbuettel ($7 in chips) 
Seat 3: Shivas prana ($10 in chips) 
Seat 4: letovpower ($10.55 in chips) 
Seat 5: Alinyr ($47.66 in chips) 
Seat 6: ale9030 ($10.05 in chips) 
ale9030: posts small blind $0.05
Wolveredo: posts big blind $0.10
*** HOLE CARDS ***
tremsbuettel: folds 
Shivas prana: folds 
letovpower: folds 
Alinyr: raises $0.15 to $0.25
ale9030: folds 
Wolveredo: calls $0.15
*** FLOP *** [As Js 5h]
Wolveredo: checks 
Alinyr: checks 
*** TURN *** [As Js 5h] [7h]
Wolveredo: bets $0.36
Alinyr: calls $0.36
*** RIVER *** [As Js 5h 7h] [3s]
Wolveredo: bets $1.17
Alinyr: folds 
Uncalled bet ($1.17) returned to Wolveredo
Wolveredo collected $1.21 from pot
Wolveredo: doesn't show hand 
*** SUMMARY ***
Total pot $1.27 | Rake $0.06 
Board [As Js 5h 7h 3s]
Seat 1: Wolveredo (big blind) collected ($1.21)
Seat 2: tremsbuettel folded before Flop (didn't bet)
Seat 3: Shivas prana folded before Flop (didn't bet)
Seat 4: letovpower folded before Flop (didn't bet)
Seat 5: Alinyr (button) folded on the River
Seat 6: ale9030 (small blind) folded before Flop



PokerStars Hand #201503064913:  Hold'em No Limit ($0.05/$0.10 USD) - 2019/06/18 6:19:44 ET
Table 'Achird' 6-max Seat #6 is the button
Seat 1: Wolveredo ($11.62 in chips) 
Seat 2: tremsbuettel ($7 in chips) 
Seat 3: Shivas prana ($10 in chips) 
Seat 4: letovpower ($10.55 in chips) 
Seat 5: Alinyr ($47.05 in chips) 
Seat 6: ale9030 ($10 in chips) 
Wolveredo: posts small blind $0.05
tremsbuettel: posts big blind $0.10
*** HOLE CARDS ***
Shivas prana: folds 
letovpower: raises $0.20 to $0.30
Alinyr: folds 
ale9030: folds 
Wolveredo: folds 
tremsbuettel: calls $0.20
*** FLOP *** [6h 9c 2s]
tremsbuettel: bets $0.10
letovpower: calls $0.10
*** TURN *** [6h 9c 2s] [3c]
tremsbuettel: bets $0.10
letovpower: calls $0.10
*** RIVER *** [6h 9c 2s 3c] [7s]
tremsbuettel: checks 
letovpower: checks 
*** SHOW DOWN ***
tremsbuettel: shows [Tc Qs] (high card Queen)
letovpower: shows [5c 5s] (a pair of Fives)
letovpower collected $1 from pot
*** SUMMARY ***
Total pot $1.05 | Rake $0.05 
Board [6h 9c 2s 3c 7s]
Seat 1: Wolveredo (small blind) folded before Flop
Seat 2: tremsbuettel (big blind) showed [Tc Qs] and lost with high card Queen
Seat 3: Shivas prana folded before Flop (didn't bet)
Seat 4: letovpower showed [5c 5s] and won ($1) with a pair of Fives
Seat 5: Alinyr folded before Flop (didn't bet)
Seat 6: ale9030 (button) folded before Flop (didn't bet)



PokerStars Hand #201503079851:  Hold'em No Limit ($0.05/$0.10 USD) - 2019/06/18 6:20:38 ET
Table 'Achird' 6-max Seat #1 is the button
Seat 1: Wolveredo ($11.57 in chips) 
Seat 2: tremsbuettel ($6.50 in chips) 
Seat 4: letovpower ($11.05 in chips) 
Seat 5: Alinyr ($47.05 in chips) 
Seat 6: ale9030 ($10 in chips) 
tremsbuettel: posts small blind $0.05
Shivas prana: is sitting out 
letovpower: posts big blind $0.10
*** HOLE CARDS ***
Alinyr: folds 
ale9030: folds 
Wolveredo: folds 
tremsbuettel: calls $0.05
letovpower: raises $0.25 to $0.35
tremsbuettel: calls $0.25
*** FLOP *** [Js 8s 4s]
tremsbuettel: bets $0.67
letovpower: folds 
Uncalled bet ($0.67) returned to tremsbuettel
tremsbuettel collected $0.67 from pot
tremsbuettel: doesn't show hand 
*** SUMMARY ***
Total pot $0.70 | Rake $0.03 
Board [Js 8s 4s]
Seat 1: Wolveredo (button) folded before Flop (didn't bet)
Seat 2: tremsbuettel (small blind) collected ($0.67)
Seat 4: letovpower (big blind) folded on the Flop
Seat 5: Alinyr folded before Flop (didn't bet)
Seat 6: ale9030 folded before Flop (didn't bet)



PokerStars Hand #201503088227:  Hold'em No Limit ($0.05/$0.10 USD) - 2019/06/18 6:21:09 ET
Table 'Achird' 6-max Seat #2 is the button
Seat 1: Wolveredo ($11.57 in chips) 
Seat 2: tremsbuettel ($6.82 in chips) 
Seat 4: letovpower ($10.70 in chips) 
Seat 5: Alinyr ($47.05 in chips) 
Seat 6: ale9030 ($10 in chips) 
letovpower: posts small blind $0.05
Alinyr: posts big blind $0.10
*** HOLE CARDS ***
ale9030: folds 
Wolveredo: folds 
tremsbuettel: calls $0.10
letovpower: folds 
Alinyr: raises $0.35 to $0.45
tremsbuettel: folds 
Uncalled bet ($0.35) returned to Alinyr
Alinyr collected $0.25 from pot
Alinyr: doesn't show hand 
*** SUMMARY ***
Total pot $0.25 | Rake $0 
Seat 1: Wolveredo folded before Flop (didn't bet)
Seat 2: tremsbuettel (button) folded before Flop
Seat 4: letovpower (small blind) folded before Flop
Seat 5: Alinyr (big blind) collected ($0.25)
Seat 6: ale9030 folded before Flop (didn't bet)



PokerStars Hand #201503093867:  Hold'em No Limit ($0.05/$0.10 USD) - 2019/06/18 6:21:29 ET
Table 'Achird' 6-max Seat #4 is the button
Seat 1: Wolveredo ($11.57 in chips) 
Seat 2: tremsbuettel ($6.72 in chips) 
Seat 4: letovpower ($10.65 in chips) 
Seat 5: Alinyr ($47.20 in chips) 
Seat 6: ale9030 ($10 in chips) 
Alinyr: posts small blind $0.05
ale9030: posts big blind $0.10
*** HOLE CARDS ***
Wolveredo: folds 
tremsbuettel: folds 
letovpower: raises $0.15 to $0.25
Alinyr: raises $0.75 to $1
ale9030: folds 
letovpower: folds 
Uncalled bet ($0.75) returned to Alinyr
Alinyr collected $0.60 from pot
Alinyr: doesn't show hand 
*** SUMMARY ***
Total pot $0.60 | Rake $0 
Seat 1: Wolveredo folded before Flop (didn't bet)
Seat 2: tremsbuettel folded before Flop (didn't bet)
Seat 4: letovpower (button) folded before Flop
Seat 5: Alinyr (small blind) collected ($0.60)
Seat 6: ale9030 (big blind) folded before Flop



PokerStars Hand #201503098944:  Hold'em No Limit ($0.05/$0.10 USD) - 2019/06/18 6:21:48 ET
Table 'Achird' 6-max Seat #5 is the button
Seat 1: Wolveredo ($11.57 in chips) 
Seat 2: tremsbuettel ($6.72 in chips) 
Seat 4: letovpower ($10.40 in chips) 
Seat 5: Alinyr ($47.55 in chips) 
Seat 6: ale9030 ($10 in chips) 
ale9030: posts small blind $0.05
Wolveredo: posts big blind $0.10
*** HOLE CARDS ***
tremsbuettel: calls $0.10
letovpower: folds 
Alinyr: folds 
ale9030: folds 
Wolveredo: checks 
*** FLOP *** [Qc Jc 6d]
Wolveredo: checks 
tremsbuettel: checks 
*** TURN *** [Qc Jc 6d] [Ah]
Wolveredo: checks 
tremsbuettel: bets $0.24
Wolveredo: folds 
Uncalled bet ($0.24) returned to tremsbuettel
tremsbuettel collected $0.24 from pot
tremsbuettel: doesn't show hand 
*** SUMMARY ***
Total pot $0.25 | Rake $0.01 
Board [Qc Jc 6d Ah]
Seat 1: Wolveredo (big blind) folded on the Turn
Seat 2: tremsbuettel collected ($0.24)
Seat 4: letovpower folded before Flop (didn't bet)
Seat 5: Alinyr (button) folded before Flop (didn't bet)
Seat 6: ale9030 (small blind) folded before Flop



PokerStars Hand #201503112927:  Hold'em No Limit ($0.05/$0.10 USD) - 2019/06/18 6:22:38 ET
Table 'Achird' 6-max Seat #6 is the button
Seat 1: Wolveredo ($11.47 in chips) 
Seat 2: tremsbuettel ($6.86 in chips) 
Seat 4: letovpower ($10.40 in chips) 
Seat 5: Alinyr ($47.55 in chips) 
Seat 6: ale9030 ($10 in chips) 
Wolveredo: posts small blind $0.05
tremsbuettel: posts big blind $0.10
*** HOLE CARDS ***
letovpower: folds 
Alinyr: folds 
ale9030: folds 
Wolveredo: raises $0.20 to $0.30
tremsbuettel: calls $0.20
*** FLOP *** [Jd 6c 9c]
Wolveredo: bets $0.39
tremsbuettel: folds 
Uncalled bet ($0.39) returned to Wolveredo
Wolveredo collected $0.57 from pot
Wolveredo: doesn't show hand 
*** SUMMARY ***
Total pot $0.60 | Rake $0.03 
Board [Jd 6c 9c]
Seat 1: Wolveredo (small blind) collected ($0.57)
Seat 2: tremsbuettel (big blind) folded on the Flop
Seat 4: letovpower folded before Flop (didn't bet)
Seat 5: Alinyr folded before Flop (didn't bet)
Seat 6: ale9030 (button) folded before Flop (didn't bet)



PokerStars Hand #201503119200:  Hold'em No Limit ($0.05/$0.10 USD) - 2019/06/18 6:23:02 ET
Table 'Achird' 6-max Seat #1 is the button
Seat 1: Wolveredo ($11.74 in chips) 
Seat 2: tremsbuettel ($6.56 in chips) 
Seat 4: letovpower ($10.40 in chips) 
Seat 5: Alinyr ($47.55 in chips) 
Seat 6: ale9030 ($10 in chips) 
tremsbuettel: posts small blind $0.05
letovpower: posts big blind $0.10
*** HOLE CARDS ***
Alinyr: folds 
ale9030: folds 
Wolveredo: raises $0.15 to $0.25
tremsbuettel: folds 
letovpower: folds 
Uncalled bet ($0.15) returned to Wolveredo
Wolveredo collected $0.25 from pot
Wolveredo: doesn't show hand 
*** SUMMARY ***
Total pot $0.25 | Rake $0 
Seat 1: Wolveredo (button) collected ($0.25)
Seat 2: tremsbuettel (small blind) folded before Flop
Seat 4: letovpower (big blind) folded before Flop
Seat 5: Alinyr folded before Flop (didn't bet)
Seat 6: ale9030 folded before Flop (didn't bet)



PokerStars Hand #201503123564:  Hold'em No Limit ($0.05/$0.10 USD) - 2019/06/18 6:23:18 ET
Table 'Achird' 6-max Seat #2 is the button
Seat 1: Wolveredo ($11.89 in chips) 
Seat 2: tremsbuettel ($6.51 in chips) 
Seat 4: letovpower ($10.30 in chips) 
Seat 5: Alinyr ($47.55 in chips) 
Seat 6: ale9030 ($10 in chips) 
letovpower: posts small blind $0.05
Alinyr: posts big blind $0.10
*** HOLE CARDS ***
ale9030: folds 
Wolveredo: folds 
tremsbuettel: folds 
letovpower: folds 
Uncalled bet ($0.05) returned to Alinyr
Alinyr collected $0.10 from pot
Alinyr: doesn't show hand 
*** SUMMARY ***
Total pot $0.10 | Rake $0 
Seat 1: Wolveredo folded before Flop (didn't bet)
Seat 2: tremsbuettel (button) folded before Flop (didn't bet)
Seat 4: letovpower (small blind) folded before Flop
Seat 5: Alinyr (big blind) collected ($0.10)
Seat 6: ale9030 folded before Flop (didn't bet)



PokerStars Hand #201503125905:  Hold'em No Limit ($0.05/$0.10 USD) - 2019/06/18 6:23:26 ET
Table 'Achird' 6-max Seat #4 is the button
Seat 1: Wolveredo ($11.89 in chips) 
Seat 2: tremsbuettel ($6.51 in chips) 
Seat 4: letovpower ($10.25 in chips) 
Seat 5: Alinyr ($47.60 in chips) 
Seat 6: ale9030 ($10 in chips) 
Alinyr: posts small blind $0.05
ale9030: posts big blind $0.10
*** HOLE CARDS ***
Wolveredo: folds 
tremsbuettel: folds 
letovpower: raises $0.15 to $0.25
Alinyr: folds 
ale9030: raises $0.75 to $1
letovpower: calls $0.75
*** FLOP *** [Jc 8h Jh]
ale9030: bets $0.98
letovpower: folds 
Uncalled bet ($0.98) returned to ale9030
ale9030 collected $1.96 from pot
*** SUMMARY ***
Total pot $2.05 | Rake $0.09 
Board [Jc 8h Jh]
Seat 1: Wolveredo folded before Flop (didn't bet)
Seat 2: tremsbuettel folded before Flop (didn't bet)
Seat 4: letovpower (button) folded on the Flop
Seat 5: Alinyr (small blind) folded before Flop
Seat 6: ale9030 (big blind) collected ($1.96)



PokerStars Hand #201503135481:  Hold'em No Limit ($0.05/$0.10 USD) - 2019/06/18 6:24:03 ET
Table 'Achird' 6-max Seat #5 is the button
Seat 1: Wolveredo ($11.89 in chips) 
Seat 2: tremsbuettel ($6.51 in chips) 
Seat 4: letovpower ($10 in chips) 
Seat 5: Alinyr ($47.55 in chips) 
Seat 6: ale9030 ($10.96 in chips) 
ale9030: posts small blind $0.05
Wolveredo: posts big blind $0.10
*** HOLE CARDS ***
tremsbuettel: folds 
letovpower: folds 
Alinyr: folds 
ale9030: calls $0.05
Wolveredo: checks 
*** FLOP *** [5d 8c Jh]
ale9030: bets $0.10
Wolveredo: folds 
Uncalled bet ($0.10) returned to ale9030
ale9030 collected $0.19 from pot
*** SUMMARY ***
Total pot $0.20 | Rake $0.01 
Board [5d 8c Jh]
Seat 1: Wolveredo (big blind) folded on the Flop
Seat 2: tremsbuettel folded before Flop (didn't bet)
Seat 4: letovpower folded before Flop (didn't bet)
Seat 5: Alinyr (button) folded before Flop (didn't bet)
Seat 6: ale9030 (small blind) collected ($0.19)



PokerStars Hand #201503141591:  Hold'em No Limit ($0.05/$0.10 USD) - 2019/06/18 6:24:25 ET
Table 'Achird' 6-max Seat #6 is the button
Seat 1: Wolveredo ($11.79 in chips) 
Seat 2: tremsbuettel ($6.51 in chips) 
Seat 4: letovpower ($10 in chips) 
Seat 5: Alinyr ($47.55 in chips) 
Seat 6: ale9030 ($11.05 in chips) 
Wolveredo: posts small blind $0.05
tremsbuettel: posts big blind $0.10
*** HOLE CARDS ***
letovpower: folds 
Alinyr: folds 
ale9030: folds 
Wolveredo: raises $0.20 to $0.30
tremsbuettel: folds 
Uncalled bet ($0.20) returned to Wolveredo
Wolveredo collected $0.20 from pot
Wolveredo: doesn't show hand 
*** SUMMARY ***
Total pot $0.20 | Rake $0 
Seat 1: Wolveredo (small blind) collected ($0.20)
Seat 2: tremsbuettel (big blind) folded before Flop
Seat 4: letovpower folded before Flop (didn't bet)
Seat 5: Alinyr folded before Flop (didn't bet)
Seat 6: ale9030 (button) folded before Flop (didn't bet)



PokerStars Hand #201503145267:  Hold'em No Limit ($0.05/$0.10 USD) - 2019/06/18 6:24:39 ET
Table 'Achird' 6-max Seat #1 is the button
Seat 1: Wolveredo ($11.89 in chips) 
Seat 2: tremsbuettel ($6.41 in chips) 
Seat 4: letovpower ($10 in chips) 
Seat 5: Alinyr ($47.55 in chips) 
Seat 6: ale9030 ($11.05 in chips) 
tremsbuettel: posts small blind $0.05
letovpower: posts big blind $0.10
*** HOLE CARDS ***
Alinyr: folds 
ale9030: folds 
Wolveredo: raises $0.15 to $0.25
tremsbuettel: folds 
letovpower: folds 
Uncalled bet ($0.15) returned to Wolveredo
Wolveredo collected $0.25 from pot
Wolveredo: doesn't show hand 
*** SUMMARY ***
Total pot $0.25 | Rake $0 
Seat 1: Wolveredo (button) collected ($0.25)
Seat 2: tremsbuettel (small blind) folded before Flop
Seat 4: letovpower (big blind) folded before Flop
Seat 5: Alinyr folded before Flop (didn't bet)
Seat 6: ale9030 folded before Flop (didn't bet)



PokerStars Hand #201503150915:  Hold'em No Limit ($0.05/$0.10 USD) - 2019/06/18 6:25:00 ET
Table 'Achird' 6-max Seat #2 is the button
Seat 1: Wolveredo ($12.04 in chips) 
Seat 2: tremsbuettel ($6.36 in chips) 
Seat 4: letovpower ($10 in chips) 
Seat 5: Alinyr ($47.55 in chips) 
Seat 6: ale9030 ($11.05 in chips) 
letovpower: posts small blind $0.05
Alinyr: posts big blind $0.10
*** HOLE CARDS ***
ale9030: raises $0.20 to $0.30
Wolveredo: folds 
tremsbuettel: calls $0.30
letovpower: raises $1.05 to $1.35
Alinyr: folds 
ale9030: folds 
tremsbuettel: calls $1.05
*** FLOP *** [Qh 6h 5c]
letovpower: checks 
tremsbuettel: checks 
*** TURN *** [Qh 6h 5c] [Qc]
letovpower: checks 
tremsbuettel: checks 
*** RIVER *** [Qh 6h 5c Qc] [Kh]
letovpower: checks 
tremsbuettel: checks 
*** SHOW DOWN ***
letovpower: shows [Td Tc] (two pair, Queens and Tens)
tremsbuettel: mucks hand 
letovpower collected $2.96 from pot
*** SUMMARY ***
Total pot $3.10 | Rake $0.14 
Board [Qh 6h 5c Qc Kh]
Seat 1: Wolveredo folded before Flop (didn't bet)
Seat 2: tremsbuettel (button) mucked
Seat 4: letovpower (small blind) showed [Td Tc] and won ($2.96) with two pair, Queens and Tens
Seat 5: Alinyr (big blind) folded before Flop
Seat 6: ale9030 folded before Flop



PokerStars Hand #201503164780:  Hold'em No Limit ($0.05/$0.10 USD) - 2019/06/18 6:25:51 ET
Table 'Achird' 6-max Seat #4 is the button
Seat 1: Wolveredo ($12.04 in chips) 
Seat 2: tremsbuettel ($5.01 in chips) 
Seat 4: letovpower ($11.61 in chips) 
Seat 5: Alinyr ($47.45 in chips) 
Seat 6: ale9030 ($10.75 in chips) 
Alinyr: posts small blind $0.05
ale9030: posts big blind $0.10
Shivas prana: sits out 
*** HOLE CARDS ***
Wolveredo: folds 
tremsbuettel: calls $0.10
letovpower: folds 
Alinyr: folds 
ale9030: checks 
*** FLOP *** [Jd 8c Qs]
ale9030: checks 
tremsbuettel: checks 
*** TURN *** [Jd 8c Qs] [Ks]
ale9030: checks 
tremsbuettel: checks 
*** RIVER *** [Jd 8c Qs Ks] [Qd]
ale9030: bets $0.24
tremsbuettel: folds 
Uncalled bet ($0.24) returned to ale9030
ale9030 collected $0.24 from pot
*** SUMMARY ***
Total pot $0.25 | Rake $0.01 
Board [Jd 8c Qs Ks Qd]
Seat 1: Wolveredo folded before Flop (didn't bet)
Seat 2: tremsbuettel folded on the River
Seat 4: letovpower (button) folded before Flop (didn't bet)
Seat 5: Alinyr (small blind) folded before Flop
Seat 6: ale9030 (big blind) collected ($0.24)



PokerStars Hand #201503174496:  Hold'em No Limit ($0.05/$0.10 USD) - 2019/06/18 6:26:27 ET
Table 'Achird' 6-max Seat #5 is the button
Seat 1: Wolveredo ($12.04 in chips) 
Seat 2: tremsbuettel ($4.91 in chips) 
Seat 4: letovpower ($11.61 in chips) 
Seat 5: Alinyr ($47.40 in chips) 
Seat 6: ale9030 ($10.89 in chips) 
ale9030: posts small blind $0.05
Wolveredo: posts big blind $0.10
Shivas prana: sits out 
*** HOLE CARDS ***
tremsbuettel: folds 
letovpower: folds 
Alinyr: folds 
ale9030: raises $0.20 to $0.30
Wolveredo: folds 
Uncalled bet ($0.20) returned to ale9030
ale9030 collected $0.20 from pot
*** SUMMARY ***
Total pot $0.20 | Rake $0 
Seat 1: Wolveredo (big blind) folded before Flop
Seat 2: tremsbuettel folded before Flop (didn't bet)
Seat 4: letovpower folded before Flop (didn't bet)
Seat 5: Alinyr (button) folded before Flop (didn't bet)
Seat 6: ale9030 (small blind) collected ($0.20)



PokerStars Hand #201503178956:  Hold'em No Limit ($0.05/$0.10 USD) - 2019/06/18 6:26:44 ET
Table 'Achird' 6-max Seat #6 is the button
Seat 1: Wolveredo ($11.94 in chips) 
Seat 2: tremsbuettel ($4.91 in chips) 
Seat 4: letovpower ($11.61 in chips) 
Seat 5: Alinyr ($47.40 in chips) 
Seat 6: ale9030 ($10.99 in chips) 
Wolveredo: posts small blind $0.05
tremsbuettel: posts big blind $0.10
Shivas prana: sits out 
*** HOLE CARDS ***
letovpower: folds 
Alinyr: raises $0.20 to $0.30
ale9030: folds 
Wolveredo: folds 
tremsbuettel: folds 
Uncalled bet ($0.20) returned to Alinyr
Alinyr collected $0.25 from pot
Alinyr: doesn't show hand 
*** SUMMARY ***
Total pot $0.25 | Rake $0 
Seat 1: Wolveredo (small blind) folded before Flop
Seat 2: tremsbuettel (big blind) folded before Flop
Seat 4: letovpower folded before Flop (didn't bet)
Seat 5: Alinyr collected ($0.25)
Seat 6: ale9030 (button) folded before Flop (didn't bet)



PokerStars Hand #201503185578:  Hold'em No Limit ($0.05/$0.10 USD) - 2019/06/18 6:27:09 ET
Table 'Achird' 6-max Seat #1 is the button
Seat 1: Wolveredo ($11.89 in chips) 
Seat 2: tremsbuettel ($4.81 in chips) 
Seat 3: Shivas prana ($10 in chips) 
Seat 4: letovpower ($11.61 in chips) 
Seat 5: Alinyr ($47.55 in chips) 
Seat 6: ale9030 ($10.99 in chips) 
tremsbuettel: posts small blind $0.05
Shivas prana: posts big blind $0.10
*** HOLE CARDS ***
letovpower: folds 
Alinyr: folds 
ale9030: raises $0.20 to $0.30
Wolveredo: folds 
tremsbuettel: calls $0.25
Shivas prana: calls $0.20
*** FLOP *** [7c Ad 6h]
tremsbuettel: checks 
Shivas prana: checks 
ale9030: checks 
*** TURN *** [7c Ad 6h] [5c]
tremsbuettel: checks 
Shivas prana: bets $0.44
ale9030: folds 
tremsbuettel: calls $0.44
*** RIVER *** [7c Ad 6h 5c] [Th]
tremsbuettel: checks 
Shivas prana: bets $1.15
tremsbuettel: folds 
Uncalled bet ($1.15) returned to Shivas prana
Shivas prana collected $1.70 from pot
Shivas prana: doesn't show hand 
*** SUMMARY ***
Total pot $1.78 | Rake $0.08 
Board [7c Ad 6h 5c Th]
Seat 1: Wolveredo (button) folded before Flop (didn't bet)
Seat 2: tremsbuettel (small blind) folded on the River
Seat 3: Shivas prana (big blind) collected ($1.70)
Seat 4: letovpower folded before Flop (didn't bet)
Seat 5: Alinyr folded before Flop (didn't bet)
Seat 6: ale9030 folded on the Turn



PokerStars Hand #201503201476:  Hold'em No Limit ($0.05/$0.10 USD) - 2019/06/18 6:28:08 ET
Table 'Achird' 6-max Seat #2 is the button
Seat 1: Wolveredo ($11.89 in chips) 
Seat 2: tremsbuettel ($4.07 in chips) 
Seat 3: Shivas prana ($10.96 in chips) 
Seat 4: letovpower ($11.61 in chips) 
Seat 5: Alinyr ($47.55 in chips) 
Seat 6: ale9030 ($10.69 in chips) 
Shivas prana: posts small blind $0.05
letovpower: posts big blind $0.10
*** HOLE CARDS ***
Alinyr: folds 
ale9030: folds 
Wolveredo: folds 
tremsbuettel: folds 
tremsbuettel leaves the table
Shivas prana: raises $0.20 to $0.30
letovpower: calls $0.20
*** FLOP *** [5d 5h Kc]
Shivas prana: checks 
letovpower: bets $0.19
Shivas prana: calls $0.19
*** TURN *** [5d 5h Kc] [7d]
jext joins the table at seat #2 
Shivas prana: checks 
jext leaves the table
letovpower: checks 
*** RIVER *** [5d 5h Kc 7d] [4c]
Shivas prana: checks 
letovpower: checks 
*** SHOW DOWN ***
Shivas prana: shows [Ac 9s] (a pair of Fives)
letovpower: mucks hand 
Shivas prana collected $0.94 from pot
*** SUMMARY ***
Total pot $0.98 | Rake $0.04 
Board [5d 5h Kc 7d 4c]
Seat 1: Wolveredo folded before Flop (didn't bet)
Seat 2: tremsbuettel (button) folded before Flop (didn't bet)
Seat 3: Shivas prana (small blind) showed [Ac 9s] and won ($0.94) with a pair of Fives
Seat 4: letovpower (big blind) mucked
Seat 5: Alinyr folded before Flop (didn't bet)
Seat 6: ale9030 folded before Flop (didn't bet)



PokerStars Hand #201503213412:  Hold'em No Limit ($0.05/$0.10 USD) - 2019/06/18 6:28:53 ET
Table 'Achird' 6-max Seat #3 is the button
Seat 1: Wolveredo ($11.89 in chips) 
Seat 3: Shivas prana ($11.41 in chips) 
Seat 4: letovpower ($11.12 in chips) 
Seat 5: Alinyr ($47.55 in chips) 
Seat 6: ale9030 ($10.69 in chips) 
letovpower: posts small blind $0.05
Alinyr: posts big blind $0.10
*** HOLE CARDS ***
MilliAtto joins the table at seat #2 
ale9030: folds 
Wolveredo: folds 
Shivas prana: raises $0.13 to $0.23
letovpower: folds 
Alinyr: calls $0.13
*** FLOP *** [8d 3h 2h]
Alinyr: checks 
Shivas prana: bets $0.20
Alinyr: raises $1.08 to $1.28
Shivas prana: calls $1.08
*** TURN *** [8d 3h 2h] [Kh]
Alinyr: checks 
Shivas prana: checks 
*** RIVER *** [8d 3h 2h Kh] [9c]
Alinyr: checks 
Shivas prana: checks 
*** SHOW DOWN ***
Alinyr: shows [2d 5d] (a pair of Deuces)
Shivas prana: shows [Th Ts] (a pair of Tens)
Shivas prana collected $2.93 from pot
*** SUMMARY ***
Total pot $3.07 | Rake $0.14 
Board [8d 3h 2h Kh 9c]
Seat 1: Wolveredo folded before Flop (didn't bet)
Seat 3: Shivas prana (button) showed [Th Ts] and won ($2.93) with a pair of Tens
Seat 4: letovpower (small blind) folded before Flop
Seat 5: Alinyr (big blind) showed [2d 5d] and lost with a pair of Deuces
Seat 6: ale9030 folded before Flop (didn't bet)



PokerStars Hand #201503231422:  Hold'em No Limit ($0.05/$0.10 USD) - 2019/06/18 6:30:00 ET
Table 'Achird' 6-max Seat #4 is the button
Seat 1: Wolveredo ($11.89 in chips) 
Seat 3: Shivas prana ($12.83 in chips) 
Seat 4: letovpower ($11.07 in chips) 
Seat 5: Alinyr ($46.04 in chips) 
Seat 6: ale9030 ($10.69 in chips) 
Alinyr: posts small blind $0.05
ale9030: posts big blind $0.10
*** HOLE CARDS ***
Wolveredo: folds 
Shivas prana: folds 
letovpower: folds 
Alinyr: folds 
Uncalled bet ($0.05) returned to ale9030
ale9030 collected $0.10 from pot
*** SUMMARY ***
Total pot $0.10 | Rake $0 
Seat 1: Wolveredo folded before Flop (didn't bet)
Seat 3: Shivas prana folded before Flop (didn't bet)
Seat 4: letovpower (button) folded before Flop (didn't bet)
Seat 5: Alinyr (small blind) folded before Flop
Seat 6: ale9030 (big blind) collected ($0.10)



PokerStars Hand #201503236003:  Hold'em No Limit ($0.05/$0.10 USD) - 2019/06/18 6:30:16 ET
Table 'Achird' 6-max Seat #5 is the button
Seat 1: Wolveredo ($11.89 in chips) 
Seat 3: Shivas prana ($12.83 in chips) 
Seat 4: letovpower ($11.07 in chips) 
Seat 5: Alinyr ($45.99 in chips) 
Seat 6: ale9030 ($10.74 in chips) 
ale9030: posts small blind $0.05
Wolveredo: posts big blind $0.10
*** HOLE CARDS ***
Shivas prana: folds 
letovpower: folds 
Alinyr: raises $0.15 to $0.25
ale9030: folds 
MilliAtto leaves the table
Delaynes joins the table at seat #2 
Delaynes leaves the table
Wolveredo: raises $0.70 to $0.95
Alinyr: folds 
Uncalled bet ($0.70) returned to Wolveredo
Wolveredo collected $0.55 from pot
Wolveredo: doesn't show hand 
*** SUMMARY ***
Total pot $0.55 | Rake $0 
Seat 1: Wolveredo (big blind) collected ($0.55)
Seat 3: Shivas prana folded before Flop (didn't bet)
Seat 4: letovpower folded before Flop (didn't bet)
Seat 5: Alinyr (button) folded before Flop
Seat 6: ale9030 (small blind) folded before Flop



PokerStars Hand #201503242731:  Hold'em No Limit ($0.05/$0.10 USD) - 2019/06/18 6:30:41 ET
Table 'Achird' 6-max Seat #6 is the button
Seat 1: Wolveredo ($12.19 in chips) 
Seat 4: letovpower ($11.07 in chips) 
Seat 5: Alinyr ($45.74 in chips) 
Seat 6: ale9030 ($10.69 in chips) 
Wolveredo: posts small blind $0.05
Shivas prana: is sitting out 
letovpower: posts big blind $0.10
*** HOLE CARDS ***
Shivas prana leaves the table
Alinyr: folds 
ale9030: folds 
Wolveredo: raises $0.20 to $0.30
letovpower: raises $0.70 to $1
Wolveredo: raises $1.25 to $2.25
letovpower: folds 
Uncalled bet ($1.25) returned to Wolveredo
Wolveredo collected $2 from pot
Wolveredo: doesn't show hand 
*** SUMMARY ***
Total pot $2 | Rake $0 
Seat 1: Wolveredo (small blind) collected ($2)
Seat 4: letovpower (big blind) folded before Flop
Seat 5: Alinyr folded before Flop (didn't bet)
Seat 6: ale9030 (button) folded before Flop (didn't bet)



