PokerStars Hand #201506187830:  Hold'em No Limit ($0.05/$0.10 USD) - 2019/06/18 9:08:59 ET
Table 'Moreau III' 6-max Seat #6 is the button
Seat 4: ehrmstyle ($39.32 in chips) 
Seat 6: Kalaboush ($7.06 in chips) 
Kalaboush: posts small blind $0.05
ehrmstyle: posts big blind $0.10
ehrmstyle: posts the ante $0.02
Kalaboush: posts the ante $0.02
*** HOLE CARDS ***
Kalaboush: folds 
Uncalled bet ($0.05) returned to ehrmstyle
ehrmstyle collected $0.14 from pot
ehrmstyle: doesn't show hand 
*** SUMMARY ***
Total pot $0.14 | Rake $0 
Seat 4: ehrmstyle (big blind) collected ($0.14)
Seat 6: Kalaboush (button) (small blind) folded before Flop



PokerStars Hand #201505682808:  Hold'em No Limit ($0.05/$0.10 USD) - 2019/06/18 8:45:17 ET
Table 'Moreau III' 6-max Seat #6 is the button
Seat 4: ehrmstyle ($11.17 in chips) 
Seat 6: Kalaboush ($10.62 in chips) 
Kalaboush: posts small blind $0.05
ehrmstyle: posts big blind $0.10
ehrmstyle: posts the ante $0.02
Kalaboush: posts the ante $0.02
*** HOLE CARDS ***
Kalaboush: raises $0.10 to $0.20
ehrmstyle: folds 
Uncalled bet ($0.10) returned to Kalaboush
Kalaboush collected $0.24 from pot
Kalaboush: doesn't show hand 
*** SUMMARY ***
Total pot $0.24 | Rake $0 
Seat 4: ehrmstyle (big blind) folded before Flop
Seat 6: Kalaboush (button) (small blind) collected ($0.24)



PokerStars Hand #201505685150:  Hold'em No Limit ($0.05/$0.10 USD) - 2019/06/18 8:45:25 ET
Table 'Moreau III' 6-max Seat #4 is the button
Seat 4: ehrmstyle ($11.05 in chips) 
Seat 6: Kalaboush ($10.74 in chips) 
ehrmstyle: posts small blind $0.05
Kalaboush: posts big blind $0.10
ehrmstyle: posts the ante $0.02
Kalaboush: posts the ante $0.02
*** HOLE CARDS ***
ehrmstyle: folds 
Uncalled bet ($0.05) returned to Kalaboush
Kalaboush collected $0.14 from pot
Kalaboush: doesn't show hand 
*** SUMMARY ***
Total pot $0.14 | Rake $0 
Seat 4: ehrmstyle (button) (small blind) folded before Flop
Seat 6: Kalaboush (big blind) collected ($0.14)



PokerStars Hand #201505690080:  Hold'em No Limit ($0.05/$0.10 USD) - 2019/06/18 8:45:39 ET
Table 'Moreau III' 6-max Seat #6 is the button
Seat 4: ehrmstyle ($10.98 in chips) 
Seat 6: Kalaboush ($10.81 in chips) 
Kalaboush: posts small blind $0.05
ehrmstyle: posts big blind $0.10
ehrmstyle: posts the ante $0.02
Kalaboush: posts the ante $0.02
*** HOLE CARDS ***
Kalaboush: raises $0.10 to $0.20
ehrmstyle: calls $0.10
*** FLOP *** [Ks Kd Th]
ehrmstyle: checks 
Kalaboush: bets $0.20
ehrmstyle: calls $0.20
*** TURN *** [Ks Kd Th] [6s]
ehrmstyle: checks 
Kalaboush: bets $0.40
ehrmstyle: calls $0.40
*** RIVER *** [Ks Kd Th 6s] [7h]
ehrmstyle: bets $1.57
Kalaboush: folds 
Uncalled bet ($1.57) returned to ehrmstyle
ehrmstyle collected $1.57 from pot
ehrmstyle: doesn't show hand 
*** SUMMARY ***
Total pot $1.64 | Rake $0.07 
Board [Ks Kd Th 6s 7h]
Seat 4: ehrmstyle (big blind) collected ($1.57)
Seat 6: Kalaboush (button) (small blind) folded on the River



PokerStars Hand #201505699851:  Hold'em No Limit ($0.05/$0.10 USD) - 2019/06/18 8:46:09 ET
Table 'Moreau III' 6-max Seat #4 is the button
Seat 4: ehrmstyle ($11.73 in chips) 
Seat 6: Kalaboush ($10 in chips) 
ehrmstyle: posts small blind $0.05
Kalaboush: posts big blind $0.10
ehrmstyle: posts the ante $0.02
Kalaboush: posts the ante $0.02
*** HOLE CARDS ***
ehrmstyle: raises $0.24 to $0.34
Kalaboush: raises $0.24 to $0.58
ehrmstyle: raises $1.20 to $1.78
Kalaboush: calls $1.20
*** FLOP *** [5h 4s 7s]
Kalaboush: checks 
ehrmstyle: bets $1.72
Kalaboush: calls $1.72
*** TURN *** [5h 4s 7s] [Td]
Kalaboush: checks 
ehrmstyle: checks 
*** RIVER *** [5h 4s 7s Td] [Ac]
Kalaboush: checks 
ehrmstyle: bets $3.36
Kalaboush: calls $3.36
*** SHOW DOWN ***
ehrmstyle: shows [As Js] (a pair of Aces)
Kalaboush: mucks hand 
ehrmstyle collected $13.26 from pot
*** SUMMARY ***
Total pot $13.76 | Rake $0.50 
Board [5h 4s 7s Td Ac]
Seat 4: ehrmstyle (button) (small blind) showed [As Js] and won ($13.26) with a pair of Aces
Seat 6: Kalaboush (big blind) mucked



PokerStars Hand #201505717315:  Hold'em No Limit ($0.05/$0.10 USD) - 2019/06/18 8:47:01 ET
Table 'Moreau III' 6-max Seat #6 is the button
Seat 4: ehrmstyle ($18.11 in chips) 
Seat 6: Kalaboush ($10 in chips) 
Kalaboush: posts small blind $0.05
ehrmstyle: posts big blind $0.10
ehrmstyle: posts the ante $0.02
Kalaboush: posts the ante $0.02
*** HOLE CARDS ***
Kalaboush: raises $0.10 to $0.20
ehrmstyle: calls $0.10
*** FLOP *** [3c Qc Ac]
ehrmstyle: checks 
Kalaboush: bets $0.10
ehrmstyle: calls $0.10
*** TURN *** [3c Qc Ac] [4h]
ehrmstyle: checks 
Kalaboush: checks 
*** RIVER *** [3c Qc Ac 4h] [Kd]
ehrmstyle: checks 
Kalaboush: checks 
*** SHOW DOWN ***
ehrmstyle: shows [2c Jh] (high card Ace)
Kalaboush: shows [Td 3d] (a pair of Threes)
Kalaboush collected $0.61 from pot
*** SUMMARY ***
Total pot $0.64 | Rake $0.03 
Board [3c Qc Ac 4h Kd]
Seat 4: ehrmstyle (big blind) showed [2c Jh] and lost with high card Ace
Seat 6: Kalaboush (button) (small blind) showed [Td 3d] and won ($0.61) with a pair of Threes



PokerStars Hand #201505726720:  Hold'em No Limit ($0.05/$0.10 USD) - 2019/06/18 8:47:29 ET
Table 'Moreau III' 6-max Seat #4 is the button
Seat 4: ehrmstyle ($17.79 in chips) 
Seat 6: Kalaboush ($10.29 in chips) 
ehrmstyle: posts small blind $0.05
Kalaboush: posts big blind $0.10
ehrmstyle: posts the ante $0.02
Kalaboush: posts the ante $0.02
*** HOLE CARDS ***
ehrmstyle: folds 
Uncalled bet ($0.05) returned to Kalaboush
Kalaboush collected $0.14 from pot
Kalaboush: doesn't show hand 
*** SUMMARY ***
Total pot $0.14 | Rake $0 
Seat 4: ehrmstyle (button) (small blind) folded before Flop
Seat 6: Kalaboush (big blind) collected ($0.14)



PokerStars Hand #201505728642:  Hold'em No Limit ($0.05/$0.10 USD) - 2019/06/18 8:47:34 ET
Table 'Moreau III' 6-max Seat #6 is the button
Seat 4: ehrmstyle ($17.72 in chips) 
Seat 6: Kalaboush ($10.36 in chips) 
Kalaboush: posts small blind $0.05
ehrmstyle: posts big blind $0.10
ehrmstyle: posts the ante $0.02
Kalaboush: posts the ante $0.02
*** HOLE CARDS ***
Kalaboush: folds 
Uncalled bet ($0.05) returned to ehrmstyle
ehrmstyle collected $0.14 from pot
ehrmstyle: doesn't show hand 
*** SUMMARY ***
Total pot $0.14 | Rake $0 
Seat 4: ehrmstyle (big blind) collected ($0.14)
Seat 6: Kalaboush (button) (small blind) folded before Flop



PokerStars Hand #201505730358:  Hold'em No Limit ($0.05/$0.10 USD) - 2019/06/18 8:47:39 ET
Table 'Moreau III' 6-max Seat #4 is the button
Seat 4: ehrmstyle ($17.79 in chips) 
Seat 6: Kalaboush ($10.29 in chips) 
ehrmstyle: posts small blind $0.05
Kalaboush: posts big blind $0.10
ehrmstyle: posts the ante $0.02
Kalaboush: posts the ante $0.02
*** HOLE CARDS ***
ehrmstyle: raises $0.20 to $0.30
Kalaboush: raises $0.60 to $0.90
ehrmstyle: folds 
Uncalled bet ($0.60) returned to Kalaboush
Kalaboush collected $0.64 from pot
Kalaboush: doesn't show hand 
*** SUMMARY ***
Total pot $0.64 | Rake $0 
Seat 4: ehrmstyle (button) (small blind) folded before Flop
Seat 6: Kalaboush (big blind) collected ($0.64)



PokerStars Hand #201505735098:  Hold'em No Limit ($0.05/$0.10 USD) - 2019/06/18 8:47:54 ET
Table 'Moreau III' 6-max Seat #6 is the button
Seat 4: ehrmstyle ($17.47 in chips) 
Seat 6: Kalaboush ($10.61 in chips) 
Kalaboush: posts small blind $0.05
ehrmstyle: posts big blind $0.10
ehrmstyle: posts the ante $0.02
Kalaboush: posts the ante $0.02
*** HOLE CARDS ***
Kalaboush: raises $0.24 to $0.34
ehrmstyle: folds 
Uncalled bet ($0.24) returned to Kalaboush
Kalaboush collected $0.24 from pot
Kalaboush: doesn't show hand 
*** SUMMARY ***
Total pot $0.24 | Rake $0 
Seat 4: ehrmstyle (big blind) folded before Flop
Seat 6: Kalaboush (button) (small blind) collected ($0.24)



PokerStars Hand #201505737609:  Hold'em No Limit ($0.05/$0.10 USD) - 2019/06/18 8:48:01 ET
Table 'Moreau III' 6-max Seat #4 is the button
Seat 4: ehrmstyle ($17.35 in chips) 
Seat 6: Kalaboush ($10.73 in chips) 
ehrmstyle: posts small blind $0.05
Kalaboush: posts big blind $0.10
ehrmstyle: posts the ante $0.02
Kalaboush: posts the ante $0.02
*** HOLE CARDS ***
ehrmstyle: raises $0.20 to $0.30
Kalaboush: calls $0.20
*** FLOP *** [2c 9c 8h]
Kalaboush: checks 
ehrmstyle: bets $0.31
Kalaboush: folds 
Uncalled bet ($0.31) returned to ehrmstyle
ehrmstyle collected $0.61 from pot
ehrmstyle: doesn't show hand 
*** SUMMARY ***
Total pot $0.64 | Rake $0.03 
Board [2c 9c 8h]
Seat 4: ehrmstyle (button) (small blind) collected ($0.61)
Seat 6: Kalaboush (big blind) folded on the Flop



PokerStars Hand #201505744815:  Hold'em No Limit ($0.05/$0.10 USD) - 2019/06/18 8:48:23 ET
Table 'Moreau III' 6-max Seat #6 is the button
Seat 4: ehrmstyle ($17.64 in chips) 
Seat 6: Kalaboush ($10.41 in chips) 
Kalaboush: posts small blind $0.05
ehrmstyle: posts big blind $0.10
ehrmstyle: posts the ante $0.02
Kalaboush: posts the ante $0.02
*** HOLE CARDS ***
Kalaboush: folds 
Uncalled bet ($0.05) returned to ehrmstyle
ehrmstyle collected $0.14 from pot
ehrmstyle: doesn't show hand 
*** SUMMARY ***
Total pot $0.14 | Rake $0 
Seat 4: ehrmstyle (big blind) collected ($0.14)
Seat 6: Kalaboush (button) (small blind) folded before Flop



PokerStars Hand #201505746504:  Hold'em No Limit ($0.05/$0.10 USD) - 2019/06/18 8:48:28 ET
Table 'Moreau III' 6-max Seat #4 is the button
Seat 4: ehrmstyle ($17.71 in chips) 
Seat 6: Kalaboush ($10.34 in chips) 
ehrmstyle: posts small blind $0.05
Kalaboush: posts big blind $0.10
ehrmstyle: posts the ante $0.02
Kalaboush: posts the ante $0.02
*** HOLE CARDS ***
ehrmstyle: raises $0.20 to $0.30
Kalaboush: folds 
Uncalled bet ($0.20) returned to ehrmstyle
ehrmstyle collected $0.24 from pot
ehrmstyle: doesn't show hand 
*** SUMMARY ***
Total pot $0.24 | Rake $0 
Seat 4: ehrmstyle (button) (small blind) collected ($0.24)
Seat 6: Kalaboush (big blind) folded before Flop



PokerStars Hand #201505748811:  Hold'em No Limit ($0.05/$0.10 USD) - 2019/06/18 8:48:35 ET
Table 'Moreau III' 6-max Seat #6 is the button
Seat 4: ehrmstyle ($17.83 in chips) 
Seat 6: Kalaboush ($10.22 in chips) 
Kalaboush: posts small blind $0.05
ehrmstyle: posts big blind $0.10
ehrmstyle: posts the ante $0.02
Kalaboush: posts the ante $0.02
*** HOLE CARDS ***
Kalaboush: raises $0.24 to $0.34
ehrmstyle: folds 
Uncalled bet ($0.24) returned to Kalaboush
Kalaboush collected $0.24 from pot
Kalaboush: doesn't show hand 
*** SUMMARY ***
Total pot $0.24 | Rake $0 
Seat 4: ehrmstyle (big blind) folded before Flop
Seat 6: Kalaboush (button) (small blind) collected ($0.24)



PokerStars Hand #201505751833:  Hold'em No Limit ($0.05/$0.10 USD) - 2019/06/18 8:48:44 ET
Table 'Moreau III' 6-max Seat #4 is the button
Seat 4: ehrmstyle ($17.71 in chips) 
Seat 6: Kalaboush ($10.34 in chips) 
ehrmstyle: posts small blind $0.05
Kalaboush: posts big blind $0.10
ehrmstyle: posts the ante $0.02
Kalaboush: posts the ante $0.02
*** HOLE CARDS ***
ehrmstyle: raises $0.20 to $0.30
Kalaboush: folds 
Uncalled bet ($0.20) returned to ehrmstyle
ehrmstyle collected $0.24 from pot
ehrmstyle: doesn't show hand 
*** SUMMARY ***
Total pot $0.24 | Rake $0 
Seat 4: ehrmstyle (button) (small blind) collected ($0.24)
Seat 6: Kalaboush (big blind) folded before Flop



PokerStars Hand #201505754326:  Hold'em No Limit ($0.05/$0.10 USD) - 2019/06/18 8:48:51 ET
Table 'Moreau III' 6-max Seat #6 is the button
Seat 4: ehrmstyle ($17.83 in chips) 
Seat 6: Kalaboush ($10.22 in chips) 
Kalaboush: posts small blind $0.05
ehrmstyle: posts big blind $0.10
ehrmstyle: posts the ante $0.02
Kalaboush: posts the ante $0.02
*** HOLE CARDS ***
Kalaboush: folds 
Uncalled bet ($0.05) returned to ehrmstyle
ehrmstyle collected $0.14 from pot
ehrmstyle: doesn't show hand 
*** SUMMARY ***
Total pot $0.14 | Rake $0 
Seat 4: ehrmstyle (big blind) collected ($0.14)
Seat 6: Kalaboush (button) (small blind) folded before Flop



PokerStars Hand #201505756091:  Hold'em No Limit ($0.05/$0.10 USD) - 2019/06/18 8:48:56 ET
Table 'Moreau III' 6-max Seat #4 is the button
Seat 4: ehrmstyle ($17.90 in chips) 
Seat 6: Kalaboush ($10.15 in chips) 
ehrmstyle: posts small blind $0.05
Kalaboush: posts big blind $0.10
ehrmstyle: posts the ante $0.02
Kalaboush: posts the ante $0.02
*** HOLE CARDS ***
ehrmstyle: raises $0.20 to $0.30
Kalaboush: raises $0.64 to $0.94
ehrmstyle: calls $0.64
*** FLOP *** [Th 9h 3h]
Kalaboush: bets $0.90
ehrmstyle: calls $0.90
*** TURN *** [Th 9h 3h] [5h]
Kalaboush: bets $1.80
ehrmstyle: calls $1.80
*** RIVER *** [Th 9h 3h 5h] [6s]
Kalaboush: bets $3.50
ehrmstyle: calls $3.50
*** SHOW DOWN ***
Kalaboush: shows [Kh As] (a flush, King high)
ehrmstyle: mucks hand 
Kalaboush collected $13.82 from pot
*** SUMMARY ***
Total pot $14.32 | Rake $0.50 
Board [Th 9h 3h 5h 6s]
Seat 4: ehrmstyle (button) (small blind) mucked
Seat 6: Kalaboush (big blind) showed [Kh As] and won ($13.82) with a flush, King high



PokerStars Hand #201505766082:  Hold'em No Limit ($0.05/$0.10 USD) - 2019/06/18 8:49:27 ET
Table 'Moreau III' 6-max Seat #6 is the button
Seat 4: ehrmstyle ($10.74 in chips) 
Seat 6: Kalaboush ($16.81 in chips) 
Kalaboush: posts small blind $0.05
ehrmstyle: posts big blind $0.10
ehrmstyle: posts the ante $0.02
Kalaboush: posts the ante $0.02
*** HOLE CARDS ***
Kalaboush: raises $0.10 to $0.20
ehrmstyle: raises $0.10 to $0.30
Kalaboush: calls $0.10
*** FLOP *** [Jh 3c 8c]
ehrmstyle: checks 
Kalaboush: checks 
*** TURN *** [Jh 3c 8c] [2h]
ehrmstyle: checks 
Kalaboush: checks 
*** RIVER *** [Jh 3c 8c 2h] [4c]
ehrmstyle: checks 
Kalaboush: bets $0.20
ehrmstyle: folds 
Uncalled bet ($0.20) returned to Kalaboush
Kalaboush collected $0.61 from pot
Kalaboush: doesn't show hand 
*** SUMMARY ***
Total pot $0.64 | Rake $0.03 
Board [Jh 3c 8c 2h 4c]
Seat 4: ehrmstyle (big blind) folded on the River
Seat 6: Kalaboush (button) (small blind) collected ($0.61)



PokerStars Hand #201505778803:  Hold'em No Limit ($0.05/$0.10 USD) - 2019/06/18 8:50:05 ET
Table 'Moreau III' 6-max Seat #4 is the button
Seat 4: ehrmstyle ($10.42 in chips) 
Seat 6: Kalaboush ($17.10 in chips) 
ehrmstyle: posts small blind $0.05
Kalaboush: posts big blind $0.10
ehrmstyle: posts the ante $0.02
Kalaboush: posts the ante $0.02
*** HOLE CARDS ***
ehrmstyle: raises $0.20 to $0.30
Kalaboush: calls $0.20
*** FLOP *** [5d As 8h]
Kalaboush: checks 
ehrmstyle: bets $0.31
Kalaboush: folds 
Uncalled bet ($0.31) returned to ehrmstyle
ehrmstyle collected $0.61 from pot
ehrmstyle: doesn't show hand 
*** SUMMARY ***
Total pot $0.64 | Rake $0.03 
Board [5d As 8h]
Seat 4: ehrmstyle (button) (small blind) collected ($0.61)
Seat 6: Kalaboush (big blind) folded on the Flop



PokerStars Hand #201505783892:  Hold'em No Limit ($0.05/$0.10 USD) - 2019/06/18 8:50:21 ET
Table 'Moreau III' 6-max Seat #6 is the button
Seat 4: ehrmstyle ($10.71 in chips) 
Seat 6: Kalaboush ($16.78 in chips) 
Kalaboush: posts small blind $0.05
ehrmstyle: posts big blind $0.10
ehrmstyle: posts the ante $0.02
Kalaboush: posts the ante $0.02
*** HOLE CARDS ***
Kalaboush: folds 
Uncalled bet ($0.05) returned to ehrmstyle
ehrmstyle collected $0.14 from pot
ehrmstyle: doesn't show hand 
*** SUMMARY ***
Total pot $0.14 | Rake $0 
Seat 4: ehrmstyle (big blind) collected ($0.14)
Seat 6: Kalaboush (button) (small blind) folded before Flop



PokerStars Hand #201505785609:  Hold'em No Limit ($0.05/$0.10 USD) - 2019/06/18 8:50:26 ET
Table 'Moreau III' 6-max Seat #4 is the button
Seat 4: ehrmstyle ($10.78 in chips) 
Seat 6: Kalaboush ($16.71 in chips) 
ehrmstyle: posts small blind $0.05
Kalaboush: posts big blind $0.10
ehrmstyle: posts the ante $0.02
Kalaboush: posts the ante $0.02
*** HOLE CARDS ***
ehrmstyle: raises $0.20 to $0.30
Kalaboush: calls $0.20
*** FLOP *** [7c Kd Jc]
Kalaboush: checks 
ehrmstyle: checks 
*** TURN *** [7c Kd Jc] [4s]
Kalaboush: checks 
ehrmstyle: bets $0.31
Kalaboush: calls $0.31
*** RIVER *** [7c Kd Jc 4s] [Qc]
Kalaboush: bets $0.10
ehrmstyle: calls $0.10
*** SHOW DOWN ***
Kalaboush: shows [8c Jd] (a pair of Jacks)
ehrmstyle: mucks hand 
Kalaboush collected $1.39 from pot
*** SUMMARY ***
Total pot $1.46 | Rake $0.07 
Board [7c Kd Jc 4s Qc]
Seat 4: ehrmstyle (button) (small blind) mucked
Seat 6: Kalaboush (big blind) showed [8c Jd] and won ($1.39) with a pair of Jacks



PokerStars Hand #201505796031:  Hold'em No Limit ($0.05/$0.10 USD) - 2019/06/18 8:50:57 ET
Table 'Moreau III' 6-max Seat #6 is the button
Seat 4: ehrmstyle ($10.05 in chips) 
Seat 6: Kalaboush ($17.37 in chips) 
Kalaboush: posts small blind $0.05
ehrmstyle: posts big blind $0.10
ehrmstyle: posts the ante $0.02
Kalaboush: posts the ante $0.02
*** HOLE CARDS ***
Kalaboush: raises $0.10 to $0.20
ehrmstyle: folds 
Uncalled bet ($0.10) returned to Kalaboush
Kalaboush collected $0.24 from pot
Kalaboush: doesn't show hand 
*** SUMMARY ***
Total pot $0.24 | Rake $0 
Seat 4: ehrmstyle (big blind) folded before Flop
Seat 6: Kalaboush (button) (small blind) collected ($0.24)



PokerStars Hand #201505799570:  Hold'em No Limit ($0.05/$0.10 USD) - 2019/06/18 8:51:08 ET
Table 'Moreau III' 6-max Seat #4 is the button
Seat 4: ehrmstyle ($9.93 in chips) 
Seat 6: Kalaboush ($17.49 in chips) 
ehrmstyle: posts small blind $0.05
Kalaboush: posts big blind $0.10
ehrmstyle: posts the ante $0.02
Kalaboush: posts the ante $0.02
*** HOLE CARDS ***
ehrmstyle: raises $0.20 to $0.30
Kalaboush: calls $0.20
*** FLOP *** [7c 6h Jh]
Kalaboush: checks 
ehrmstyle: bets $0.31
Kalaboush: calls $0.31
*** TURN *** [7c 6h Jh] [6d]
Kalaboush: checks 
ehrmstyle: bets $0.60
Kalaboush: raises $1.20 to $1.80
ehrmstyle: calls $1.20
*** RIVER *** [7c 6h Jh 6d] [2s]
Kalaboush: bets $2.30
ehrmstyle: calls $2.30
*** SHOW DOWN ***
Kalaboush: shows [As 6c] (three of a kind, Sixes)
ehrmstyle: mucks hand 
Kalaboush collected $9.03 from pot
*** SUMMARY ***
Total pot $9.46 | Rake $0.43 
Board [7c 6h Jh 6d 2s]
Seat 4: ehrmstyle (button) (small blind) mucked
Seat 6: Kalaboush (big blind) showed [As 6c] and won ($9.03) with three of a kind, Sixes



PokerStars Hand #201505808221:  Hold'em No Limit ($0.05/$0.10 USD) - 2019/06/18 8:51:34 ET
Table 'Moreau III' 6-max Seat #6 is the button
Seat 4: ehrmstyle ($5.20 in chips) 
Seat 6: Kalaboush ($21.79 in chips) 
Kalaboush: posts small blind $0.05
ehrmstyle: posts big blind $0.10
ehrmstyle: posts the ante $0.02
Kalaboush: posts the ante $0.02
*** HOLE CARDS ***
Kalaboush: raises $0.20 to $0.30
ehrmstyle: folds 
Uncalled bet ($0.20) returned to Kalaboush
Kalaboush collected $0.24 from pot
Kalaboush: doesn't show hand 
*** SUMMARY ***
Total pot $0.24 | Rake $0 
Seat 4: ehrmstyle (big blind) folded before Flop
Seat 6: Kalaboush (button) (small blind) collected ($0.24)



PokerStars Hand #201505812156:  Hold'em No Limit ($0.05/$0.10 USD) - 2019/06/18 8:51:46 ET
Table 'Moreau III' 6-max Seat #4 is the button
Seat 4: ehrmstyle ($10 in chips) 
Seat 6: Kalaboush ($21.91 in chips) 
ehrmstyle: posts small blind $0.05
Kalaboush: posts big blind $0.10
ehrmstyle: posts the ante $0.02
Kalaboush: posts the ante $0.02
*** HOLE CARDS ***
ehrmstyle: raises $0.20 to $0.30
Kalaboush: folds 
Uncalled bet ($0.20) returned to ehrmstyle
ehrmstyle collected $0.24 from pot
ehrmstyle: doesn't show hand 
*** SUMMARY ***
Total pot $0.24 | Rake $0 
Seat 4: ehrmstyle (button) (small blind) collected ($0.24)
Seat 6: Kalaboush (big blind) folded before Flop



PokerStars Hand #201505814450:  Hold'em No Limit ($0.05/$0.10 USD) - 2019/06/18 8:51:53 ET
Table 'Moreau III' 6-max Seat #6 is the button
Seat 4: ehrmstyle ($10.12 in chips) 
Seat 6: Kalaboush ($21.79 in chips) 
Kalaboush: posts small blind $0.05
ehrmstyle: posts big blind $0.10
ehrmstyle: posts the ante $0.02
Kalaboush: posts the ante $0.02
*** HOLE CARDS ***
Kalaboush: raises $0.20 to $0.30
ehrmstyle: calls $0.20
*** FLOP *** [7s Kh 4s]
ehrmstyle: checks 
Kalaboush: checks 
*** TURN *** [7s Kh 4s] [Jh]
ehrmstyle: checks 
Kalaboush: checks 
*** RIVER *** [7s Kh 4s Jh] [Ac]
ehrmstyle: bets $0.61
Kalaboush: calls $0.61
*** SHOW DOWN ***
ehrmstyle: shows [4d Ad] (two pair, Aces and Fours)
Kalaboush: mucks hand 
ehrmstyle collected $1.78 from pot
*** SUMMARY ***
Total pot $1.86 | Rake $0.08 
Board [7s Kh 4s Jh Ac]
Seat 4: ehrmstyle (big blind) showed [4d Ad] and won ($1.78) with two pair, Aces and Fours
Seat 6: Kalaboush (button) (small blind) mucked



PokerStars Hand #201505822888:  Hold'em No Limit ($0.05/$0.10 USD) - 2019/06/18 8:52:18 ET
Table 'Moreau III' 6-max Seat #4 is the button
Seat 4: ehrmstyle ($10.97 in chips) 
Seat 6: Kalaboush ($20.86 in chips) 
ehrmstyle: posts small blind $0.05
Kalaboush: posts big blind $0.10
ehrmstyle: posts the ante $0.02
Kalaboush: posts the ante $0.02
*** HOLE CARDS ***
ehrmstyle: folds 
Uncalled bet ($0.05) returned to Kalaboush
Kalaboush collected $0.14 from pot
Kalaboush: doesn't show hand 
*** SUMMARY ***
Total pot $0.14 | Rake $0 
Seat 4: ehrmstyle (button) (small blind) folded before Flop
Seat 6: Kalaboush (big blind) collected ($0.14)



PokerStars Hand #201505824904:  Hold'em No Limit ($0.05/$0.10 USD) - 2019/06/18 8:52:24 ET
Table 'Moreau III' 6-max Seat #6 is the button
Seat 4: ehrmstyle ($10.90 in chips) 
Seat 6: Kalaboush ($20.93 in chips) 
Kalaboush: posts small blind $0.05
ehrmstyle: posts big blind $0.10
ehrmstyle: posts the ante $0.02
Kalaboush: posts the ante $0.02
*** HOLE CARDS ***
Kalaboush: raises $0.20 to $0.30
ehrmstyle: calls $0.20
*** FLOP *** [2s 5s Kh]
ehrmstyle: checks 
Kalaboush: bets $0.30
ehrmstyle: calls $0.30
*** TURN *** [2s 5s Kh] [7h]
ehrmstyle: checks 
Kalaboush: checks 
*** RIVER *** [2s 5s Kh 7h] [6h]
ehrmstyle: bets $0.59
Kalaboush: folds 
Uncalled bet ($0.59) returned to ehrmstyle
ehrmstyle collected $1.18 from pot
ehrmstyle: doesn't show hand 
*** SUMMARY ***
Total pot $1.24 | Rake $0.06 
Board [2s 5s Kh 7h 6h]
Seat 4: ehrmstyle (big blind) collected ($1.18)
Seat 6: Kalaboush (button) (small blind) folded on the River



PokerStars Hand #201505834639:  Hold'em No Limit ($0.05/$0.10 USD) - 2019/06/18 8:52:53 ET
Table 'Moreau III' 6-max Seat #4 is the button
Seat 4: ehrmstyle ($11.46 in chips) 
Seat 6: Kalaboush ($20.31 in chips) 
ehrmstyle: posts small blind $0.05
Kalaboush: posts big blind $0.10
ehrmstyle: posts the ante $0.02
Kalaboush: posts the ante $0.02
*** HOLE CARDS ***
ehrmstyle: raises $0.20 to $0.30
Kalaboush: folds 
Uncalled bet ($0.20) returned to ehrmstyle
ehrmstyle collected $0.24 from pot
ehrmstyle: doesn't show hand 
*** SUMMARY ***
Total pot $0.24 | Rake $0 
Seat 4: ehrmstyle (button) (small blind) collected ($0.24)
Seat 6: Kalaboush (big blind) folded before Flop



PokerStars Hand #201505836819:  Hold'em No Limit ($0.05/$0.10 USD) - 2019/06/18 8:53:00 ET
Table 'Moreau III' 6-max Seat #6 is the button
Seat 4: ehrmstyle ($11.58 in chips) 
Seat 6: Kalaboush ($20.19 in chips) 
Kalaboush: posts small blind $0.05
ehrmstyle: posts big blind $0.10
ehrmstyle: posts the ante $0.02
Kalaboush: posts the ante $0.02
*** HOLE CARDS ***
Kalaboush: raises $0.10 to $0.20
ehrmstyle: raises $0.44 to $0.64
Kalaboush: calls $0.44
*** FLOP *** [Kd 9s Jc]
ehrmstyle: bets $0.63
Kalaboush: calls $0.63
*** TURN *** [Kd 9s Jc] [Qd]
ehrmstyle: bets $1.23
Kalaboush: raises $1.23 to $2.46
ehrmstyle: raises $7.83 to $10.29 and is all-in
Kalaboush: calls $7.83
*** RIVER *** [Kd 9s Jc Qd] [4c]
*** SHOW DOWN ***
ehrmstyle: shows [Ah Td] (a straight, Ten to Ace)
Kalaboush: shows [Tc 5c] (a straight, Nine to King)
ehrmstyle collected $22.66 from pot
*** SUMMARY ***
Total pot $23.16 | Rake $0.50 
Board [Kd 9s Jc Qd 4c]
Seat 4: ehrmstyle (big blind) showed [Ah Td] and won ($22.66) with a straight, Ten to Ace
Seat 6: Kalaboush (button) (small blind) showed [Tc 5c] and lost with a straight, Nine to King



PokerStars Hand #201505851825:  Hold'em No Limit ($0.05/$0.10 USD) - 2019/06/18 8:53:44 ET
Table 'Moreau III' 6-max Seat #4 is the button
Seat 4: ehrmstyle ($22.66 in chips) 
Seat 6: Kalaboush ($10 in chips) 
ehrmstyle: posts small blind $0.05
Kalaboush: posts big blind $0.10
ehrmstyle: posts the ante $0.02
Kalaboush: posts the ante $0.02
*** HOLE CARDS ***
ehrmstyle: raises $0.20 to $0.30
Kalaboush: calls $0.20
*** FLOP *** [8h Qs 9h]
Kalaboush: checks 
ehrmstyle: bets $0.31
Kalaboush: folds 
Uncalled bet ($0.31) returned to ehrmstyle
ehrmstyle collected $0.61 from pot
ehrmstyle: doesn't show hand 
*** SUMMARY ***
Total pot $0.64 | Rake $0.03 
Board [8h Qs 9h]
Seat 4: ehrmstyle (button) (small blind) collected ($0.61)
Seat 6: Kalaboush (big blind) folded on the Flop



PokerStars Hand #201505857346:  Hold'em No Limit ($0.05/$0.10 USD) - 2019/06/18 8:54:01 ET
Table 'Moreau III' 6-max Seat #6 is the button
Seat 4: ehrmstyle ($22.95 in chips) 
Seat 6: Kalaboush ($10 in chips) 
Kalaboush: posts small blind $0.05
ehrmstyle: posts big blind $0.10
ehrmstyle: posts the ante $0.02
Kalaboush: posts the ante $0.02
*** HOLE CARDS ***
Kalaboush: raises $0.20 to $0.30
ehrmstyle: folds 
Uncalled bet ($0.20) returned to Kalaboush
Kalaboush collected $0.24 from pot
Kalaboush: doesn't show hand 
*** SUMMARY ***
Total pot $0.24 | Rake $0 
Seat 4: ehrmstyle (big blind) folded before Flop
Seat 6: Kalaboush (button) (small blind) collected ($0.24)



PokerStars Hand #201505859779:  Hold'em No Limit ($0.05/$0.10 USD) - 2019/06/18 8:54:08 ET
Table 'Moreau III' 6-max Seat #4 is the button
Seat 4: ehrmstyle ($22.83 in chips) 
Seat 6: Kalaboush ($10.12 in chips) 
ehrmstyle: posts small blind $0.05
Kalaboush: posts big blind $0.10
ehrmstyle: posts the ante $0.02
Kalaboush: posts the ante $0.02
*** HOLE CARDS ***
ehrmstyle: folds 
Uncalled bet ($0.05) returned to Kalaboush
Kalaboush collected $0.14 from pot
Kalaboush: doesn't show hand 
*** SUMMARY ***
Total pot $0.14 | Rake $0 
Seat 4: ehrmstyle (button) (small blind) folded before Flop
Seat 6: Kalaboush (big blind) collected ($0.14)



PokerStars Hand #201505861559:  Hold'em No Limit ($0.05/$0.10 USD) - 2019/06/18 8:54:13 ET
Table 'Moreau III' 6-max Seat #6 is the button
Seat 4: ehrmstyle ($22.76 in chips) 
Seat 6: Kalaboush ($10.19 in chips) 
Kalaboush: posts small blind $0.05
ehrmstyle: posts big blind $0.10
ehrmstyle: posts the ante $0.02
Kalaboush: posts the ante $0.02
*** HOLE CARDS ***
Kalaboush: raises $0.10 to $0.20
ehrmstyle: folds 
Uncalled bet ($0.10) returned to Kalaboush
Kalaboush collected $0.24 from pot
Kalaboush: doesn't show hand 
*** SUMMARY ***
Total pot $0.24 | Rake $0 
Seat 4: ehrmstyle (big blind) folded before Flop
Seat 6: Kalaboush (button) (small blind) collected ($0.24)



PokerStars Hand #201505864065:  Hold'em No Limit ($0.05/$0.10 USD) - 2019/06/18 8:54:21 ET
Table 'Moreau III' 6-max Seat #4 is the button
Seat 4: ehrmstyle ($22.64 in chips) 
Seat 6: Kalaboush ($10.31 in chips) 
ehrmstyle: posts small blind $0.05
Kalaboush: posts big blind $0.10
ehrmstyle: posts the ante $0.02
Kalaboush: posts the ante $0.02
*** HOLE CARDS ***
ehrmstyle: raises $0.20 to $0.30
Kalaboush: folds 
Uncalled bet ($0.20) returned to ehrmstyle
ehrmstyle collected $0.24 from pot
ehrmstyle: doesn't show hand 
*** SUMMARY ***
Total pot $0.24 | Rake $0 
Seat 4: ehrmstyle (button) (small blind) collected ($0.24)
Seat 6: Kalaboush (big blind) folded before Flop



PokerStars Hand #201505866870:  Hold'em No Limit ($0.05/$0.10 USD) - 2019/06/18 8:54:29 ET
Table 'Moreau III' 6-max Seat #6 is the button
Seat 4: ehrmstyle ($22.76 in chips) 
Seat 6: Kalaboush ($10.19 in chips) 
Kalaboush: posts small blind $0.05
ehrmstyle: posts big blind $0.10
ehrmstyle: posts the ante $0.02
Kalaboush: posts the ante $0.02
*** HOLE CARDS ***
Kalaboush: raises $0.10 to $0.20
ehrmstyle: folds 
Uncalled bet ($0.10) returned to Kalaboush
Kalaboush collected $0.24 from pot
Kalaboush: doesn't show hand 
*** SUMMARY ***
Total pot $0.24 | Rake $0 
Seat 4: ehrmstyle (big blind) folded before Flop
Seat 6: Kalaboush (button) (small blind) collected ($0.24)



PokerStars Hand #201505870269:  Hold'em No Limit ($0.05/$0.10 USD) - 2019/06/18 8:54:39 ET
Table 'Moreau III' 6-max Seat #4 is the button
Seat 4: ehrmstyle ($22.64 in chips) 
Seat 6: Kalaboush ($10.31 in chips) 
ehrmstyle: posts small blind $0.05
Kalaboush: posts big blind $0.10
ehrmstyle: posts the ante $0.02
Kalaboush: posts the ante $0.02
*** HOLE CARDS ***
ehrmstyle: raises $0.20 to $0.30
Kalaboush: raises $0.64 to $0.94
ehrmstyle: calls $0.64
*** FLOP *** [5c 8d Td]
Kalaboush: bets $0.90
ehrmstyle: calls $0.90
*** TURN *** [5c 8d Td] [5h]
Kalaboush: bets $1.80
ehrmstyle: raises $1.80 to $3.60
Kalaboush: calls $1.80
*** RIVER *** [5c 8d Td 5h] [3h]
Kalaboush: checks 
ehrmstyle: bets $5.22
Kalaboush: calls $4.85 and is all-in
Uncalled bet ($0.37) returned to ehrmstyle
*** SHOW DOWN ***
ehrmstyle: shows [4c 5s] (three of a kind, Fives)
Kalaboush: shows [Qc Tc] (two pair, Tens and Fives)
ehrmstyle collected $20.12 from pot
*** SUMMARY ***
Total pot $20.62 | Rake $0.50 
Board [5c 8d Td 5h 3h]
Seat 4: ehrmstyle (button) (small blind) showed [4c 5s] and won ($20.12) with three of a kind, Fives
Seat 6: Kalaboush (big blind) showed [Qc Tc] and lost with two pair, Tens and Fives



PokerStars Hand #201505884401:  Hold'em No Limit ($0.05/$0.10 USD) - 2019/06/18 8:55:23 ET
Table 'Moreau III' 6-max Seat #6 is the button
Seat 4: ehrmstyle ($32.45 in chips) 
Seat 6: Kalaboush ($10 in chips) 
Kalaboush: posts small blind $0.05
ehrmstyle: posts big blind $0.10
ehrmstyle: posts the ante $0.02
Kalaboush: posts the ante $0.02
*** HOLE CARDS ***
Kalaboush: raises $0.20 to $0.30
ehrmstyle: folds 
Uncalled bet ($0.20) returned to Kalaboush
Kalaboush collected $0.24 from pot
Kalaboush: doesn't show hand 
*** SUMMARY ***
Total pot $0.24 | Rake $0 
Seat 4: ehrmstyle (big blind) folded before Flop
Seat 6: Kalaboush (button) (small blind) collected ($0.24)



PokerStars Hand #201505887216:  Hold'em No Limit ($0.05/$0.10 USD) - 2019/06/18 8:55:33 ET
Table 'Moreau III' 6-max Seat #4 is the button
Seat 4: ehrmstyle ($32.33 in chips) 
Seat 6: Kalaboush ($10.12 in chips) 
ehrmstyle: posts small blind $0.05
Kalaboush: posts big blind $0.10
ehrmstyle: posts the ante $0.02
Kalaboush: posts the ante $0.02
*** HOLE CARDS ***
ehrmstyle: raises $0.20 to $0.30
Kalaboush: raises $0.64 to $0.94
ehrmstyle: calls $0.64
*** FLOP *** [4c 2h 6d]
Kalaboush: bets $0.10
ehrmstyle: calls $0.10
*** TURN *** [4c 2h 6d] [2c]
Kalaboush: bets $0.10
ehrmstyle: calls $0.10
*** RIVER *** [4c 2h 6d 2c] [Ts]
Kalaboush: bets $0.10
ehrmstyle: calls $0.10
*** SHOW DOWN ***
Kalaboush: shows [Kh 7h] (a pair of Deuces)
ehrmstyle: shows [8s Ad] (a pair of Deuces - Ace kicker)
ehrmstyle collected $2.41 from pot
*** SUMMARY ***
Total pot $2.52 | Rake $0.11 
Board [4c 2h 6d 2c Ts]
Seat 4: ehrmstyle (button) (small blind) showed [8s Ad] and won ($2.41) with a pair of Deuces
Seat 6: Kalaboush (big blind) showed [Kh 7h] and lost with a pair of Deuces



PokerStars Hand #201505894245:  Hold'em No Limit ($0.05/$0.10 USD) - 2019/06/18 8:55:58 ET
Table 'Moreau III' 6-max Seat #6 is the button
Seat 4: ehrmstyle ($33.48 in chips) 
Seat 6: Kalaboush ($10 in chips) 
Kalaboush: posts small blind $0.05
ehrmstyle: posts big blind $0.10
ehrmstyle: posts the ante $0.02
Kalaboush: posts the ante $0.02
*** HOLE CARDS ***
Kalaboush: raises $0.10 to $0.20
ehrmstyle: calls $0.10
*** FLOP *** [Ad 9d 3c]
ehrmstyle: checks 
Kalaboush: checks 
*** TURN *** [Ad 9d 3c] [As]
ehrmstyle: checks 
Kalaboush: checks 
*** RIVER *** [Ad 9d 3c As] [Jh]
ehrmstyle: checks 
Kalaboush: checks 
*** SHOW DOWN ***
ehrmstyle: shows [7h Td] (a pair of Aces)
Kalaboush: shows [6c Kd] (a pair of Aces - King kicker)
Kalaboush collected $0.42 from pot
*** SUMMARY ***
Total pot $0.44 | Rake $0.02 
Board [Ad 9d 3c As Jh]
Seat 4: ehrmstyle (big blind) showed [7h Td] and lost with a pair of Aces
Seat 6: Kalaboush (button) (small blind) showed [6c Kd] and won ($0.42) with a pair of Aces



PokerStars Hand #201505897868:  Hold'em No Limit ($0.05/$0.10 USD) - 2019/06/18 8:56:10 ET
Table 'Moreau III' 6-max Seat #4 is the button
Seat 4: ehrmstyle ($33.26 in chips) 
Seat 6: Kalaboush ($10.20 in chips) 
ehrmstyle: posts small blind $0.05
Kalaboush: posts big blind $0.10
ehrmstyle: posts the ante $0.02
Kalaboush: posts the ante $0.02
*** HOLE CARDS ***
ehrmstyle: raises $0.20 to $0.30
Kalaboush: calls $0.20
*** FLOP *** [5h 6h 7h]
Kalaboush: checks 
ehrmstyle: bets $0.61
Kalaboush: calls $0.61
*** TURN *** [5h 6h 7h] [4d]
Kalaboush: checks 
ehrmstyle: bets $0.89
Kalaboush: raises $0.89 to $1.78
ehrmstyle: calls $0.89
*** RIVER *** [5h 6h 7h 4d] [6s]
Kalaboush: bets $0.10
ehrmstyle: raises $2.69 to $2.79
Kalaboush: calls $2.69
*** SHOW DOWN ***
ehrmstyle: shows [8s Js] (a straight, Four to Eight)
Kalaboush: shows [8h Td] (a straight, Four to Eight)
Kalaboush collected $5.25 from pot
ehrmstyle collected $5.25 from pot
*** SUMMARY ***
Total pot $11 | Rake $0.50 
Board [5h 6h 7h 4d 6s]
Seat 4: ehrmstyle (button) (small blind) showed [8s Js] and won ($5.25) with a straight, Four to Eight
Seat 6: Kalaboush (big blind) showed [8h Td] and won ($5.25) with a straight, Four to Eight



PokerStars Hand #201505908236:  Hold'em No Limit ($0.05/$0.10 USD) - 2019/06/18 8:56:47 ET
Table 'Moreau III' 6-max Seat #6 is the button
Seat 4: ehrmstyle ($33.01 in chips) 
Seat 6: Kalaboush ($10 in chips) 
Kalaboush: posts small blind $0.05
ehrmstyle: posts big blind $0.10
ehrmstyle: posts the ante $0.02
Kalaboush: posts the ante $0.02
*** HOLE CARDS ***
Kalaboush: raises $0.20 to $0.30
ehrmstyle: folds 
Uncalled bet ($0.20) returned to Kalaboush
Kalaboush collected $0.24 from pot
Kalaboush: doesn't show hand 
*** SUMMARY ***
Total pot $0.24 | Rake $0 
Seat 4: ehrmstyle (big blind) folded before Flop
Seat 6: Kalaboush (button) (small blind) collected ($0.24)



PokerStars Hand #201505910844:  Hold'em No Limit ($0.05/$0.10 USD) - 2019/06/18 8:56:55 ET
Table 'Moreau III' 6-max Seat #4 is the button
Seat 4: ehrmstyle ($32.89 in chips) 
Seat 6: Kalaboush ($10.12 in chips) 
ehrmstyle: posts small blind $0.05
Kalaboush: posts big blind $0.10
ehrmstyle: posts the ante $0.02
Kalaboush: posts the ante $0.02
*** HOLE CARDS ***
ehrmstyle: raises $0.20 to $0.30
Kalaboush: calls $0.20
*** FLOP *** [6d Kc 5h]
Kalaboush: checks 
ehrmstyle: checks 
*** TURN *** [6d Kc 5h] [7s]
Kalaboush: checks 
ehrmstyle: checks 
*** RIVER *** [6d Kc 5h 7s] [As]
Kalaboush: checks 
ehrmstyle: bets $0.31
Kalaboush: folds 
Uncalled bet ($0.31) returned to ehrmstyle
ehrmstyle collected $0.61 from pot
ehrmstyle: doesn't show hand 
*** SUMMARY ***
Total pot $0.64 | Rake $0.03 
Board [6d Kc 5h 7s As]
Seat 4: ehrmstyle (button) (small blind) collected ($0.61)
Seat 6: Kalaboush (big blind) folded on the River



PokerStars Hand #201505917392:  Hold'em No Limit ($0.05/$0.10 USD) - 2019/06/18 8:57:18 ET
Table 'Moreau III' 6-max Seat #6 is the button
Seat 4: ehrmstyle ($33.18 in chips) 
Seat 6: Kalaboush ($10 in chips) 
Kalaboush: posts small blind $0.05
ehrmstyle: posts big blind $0.10
ehrmstyle: posts the ante $0.02
Kalaboush: posts the ante $0.02
*** HOLE CARDS ***
Kalaboush: folds 
Uncalled bet ($0.05) returned to ehrmstyle
ehrmstyle collected $0.14 from pot
ehrmstyle: doesn't show hand 
*** SUMMARY ***
Total pot $0.14 | Rake $0 
Seat 4: ehrmstyle (big blind) collected ($0.14)
Seat 6: Kalaboush (button) (small blind) folded before Flop



PokerStars Hand #201505918972:  Hold'em No Limit ($0.05/$0.10 USD) - 2019/06/18 8:57:23 ET
Table 'Moreau III' 6-max Seat #4 is the button
Seat 4: ehrmstyle ($33.25 in chips) 
Seat 6: Kalaboush ($10 in chips) 
ehrmstyle: posts small blind $0.05
Kalaboush: posts big blind $0.10
ehrmstyle: posts the ante $0.02
Kalaboush: posts the ante $0.02
*** HOLE CARDS ***
ehrmstyle: raises $0.20 to $0.30
Kalaboush: folds 
Uncalled bet ($0.20) returned to ehrmstyle
ehrmstyle collected $0.24 from pot
ehrmstyle: doesn't show hand 
*** SUMMARY ***
Total pot $0.24 | Rake $0 
Seat 4: ehrmstyle (button) (small blind) collected ($0.24)
Seat 6: Kalaboush (big blind) folded before Flop



PokerStars Hand #201505921309:  Hold'em No Limit ($0.05/$0.10 USD) - 2019/06/18 8:57:32 ET
Table 'Moreau III' 6-max Seat #6 is the button
Seat 4: ehrmstyle ($33.37 in chips) 
Seat 6: Kalaboush ($10 in chips) 
Kalaboush: posts small blind $0.05
ehrmstyle: posts big blind $0.10
ehrmstyle: posts the ante $0.02
Kalaboush: posts the ante $0.02
*** HOLE CARDS ***
Kalaboush: folds 
Uncalled bet ($0.05) returned to ehrmstyle
ehrmstyle collected $0.14 from pot
ehrmstyle: doesn't show hand 
*** SUMMARY ***
Total pot $0.14 | Rake $0 
Seat 4: ehrmstyle (big blind) collected ($0.14)
Seat 6: Kalaboush (button) (small blind) folded before Flop



PokerStars Hand #201505922746:  Hold'em No Limit ($0.05/$0.10 USD) - 2019/06/18 8:57:37 ET
Table 'Moreau III' 6-max Seat #4 is the button
Seat 4: ehrmstyle ($33.44 in chips) 
Seat 6: Kalaboush ($10 in chips) 
ehrmstyle: posts small blind $0.05
Kalaboush: posts big blind $0.10
ehrmstyle: posts the ante $0.02
Kalaboush: posts the ante $0.02
*** HOLE CARDS ***
ehrmstyle: raises $0.20 to $0.30
Kalaboush: folds 
Uncalled bet ($0.20) returned to ehrmstyle
ehrmstyle collected $0.24 from pot
ehrmstyle: doesn't show hand 
*** SUMMARY ***
Total pot $0.24 | Rake $0 
Seat 4: ehrmstyle (button) (small blind) collected ($0.24)
Seat 6: Kalaboush (big blind) folded before Flop



PokerStars Hand #201505924706:  Hold'em No Limit ($0.05/$0.10 USD) - 2019/06/18 8:57:44 ET
Table 'Moreau III' 6-max Seat #6 is the button
Seat 4: ehrmstyle ($33.56 in chips) 
Seat 6: Kalaboush ($10 in chips) 
Kalaboush: posts small blind $0.05
ehrmstyle: posts big blind $0.10
ehrmstyle: posts the ante $0.02
Kalaboush: posts the ante $0.02
*** HOLE CARDS ***
Kalaboush: folds 
Uncalled bet ($0.05) returned to ehrmstyle
ehrmstyle collected $0.14 from pot
ehrmstyle: doesn't show hand 
*** SUMMARY ***
Total pot $0.14 | Rake $0 
Seat 4: ehrmstyle (big blind) collected ($0.14)
Seat 6: Kalaboush (button) (small blind) folded before Flop



PokerStars Hand #201505926206:  Hold'em No Limit ($0.05/$0.10 USD) - 2019/06/18 8:57:49 ET
Table 'Moreau III' 6-max Seat #4 is the button
Seat 4: ehrmstyle ($33.63 in chips) 
Seat 6: Kalaboush ($10 in chips) 
ehrmstyle: posts small blind $0.05
Kalaboush: posts big blind $0.10
ehrmstyle: posts the ante $0.02
Kalaboush: posts the ante $0.02
*** HOLE CARDS ***
ehrmstyle: folds 
Uncalled bet ($0.05) returned to Kalaboush
Kalaboush collected $0.14 from pot
Kalaboush: doesn't show hand 
*** SUMMARY ***
Total pot $0.14 | Rake $0 
Seat 4: ehrmstyle (button) (small blind) folded before Flop
Seat 6: Kalaboush (big blind) collected ($0.14)



PokerStars Hand #201505927921:  Hold'em No Limit ($0.05/$0.10 USD) - 2019/06/18 8:57:55 ET
Table 'Moreau III' 6-max Seat #6 is the button
Seat 4: ehrmstyle ($33.56 in chips) 
Seat 6: Kalaboush ($10.07 in chips) 
Kalaboush: posts small blind $0.05
ehrmstyle: posts big blind $0.10
ehrmstyle: posts the ante $0.02
Kalaboush: posts the ante $0.02
*** HOLE CARDS ***
Kalaboush: raises $0.10 to $0.20
ehrmstyle: folds 
Uncalled bet ($0.10) returned to Kalaboush
Kalaboush collected $0.24 from pot
Kalaboush: doesn't show hand 
*** SUMMARY ***
Total pot $0.24 | Rake $0 
Seat 4: ehrmstyle (big blind) folded before Flop
Seat 6: Kalaboush (button) (small blind) collected ($0.24)



PokerStars Hand #201505930483:  Hold'em No Limit ($0.05/$0.10 USD) - 2019/06/18 8:58:05 ET
Table 'Moreau III' 6-max Seat #4 is the button
Seat 4: ehrmstyle ($33.44 in chips) 
Seat 6: Kalaboush ($10.19 in chips) 
ehrmstyle: posts small blind $0.05
Kalaboush: posts big blind $0.10
ehrmstyle: posts the ante $0.02
Kalaboush: posts the ante $0.02
*** HOLE CARDS ***
ehrmstyle: folds 
Uncalled bet ($0.05) returned to Kalaboush
Kalaboush collected $0.14 from pot
Kalaboush: doesn't show hand 
*** SUMMARY ***
Total pot $0.14 | Rake $0 
Seat 4: ehrmstyle (button) (small blind) folded before Flop
Seat 6: Kalaboush (big blind) collected ($0.14)



PokerStars Hand #201505932444:  Hold'em No Limit ($0.05/$0.10 USD) - 2019/06/18 8:58:11 ET
Table 'Moreau III' 6-max Seat #6 is the button
Seat 4: ehrmstyle ($33.37 in chips) 
Seat 6: Kalaboush ($10.26 in chips) 
Kalaboush: posts small blind $0.05
ehrmstyle: posts big blind $0.10
ehrmstyle: posts the ante $0.02
Kalaboush: posts the ante $0.02
*** HOLE CARDS ***
Kalaboush: raises $0.24 to $0.34
ehrmstyle: folds 
Uncalled bet ($0.24) returned to Kalaboush
Kalaboush collected $0.24 from pot
Kalaboush: doesn't show hand 
*** SUMMARY ***
Total pot $0.24 | Rake $0 
Seat 4: ehrmstyle (big blind) folded before Flop
Seat 6: Kalaboush (button) (small blind) collected ($0.24)



PokerStars Hand #201505934599:  Hold'em No Limit ($0.05/$0.10 USD) - 2019/06/18 8:58:18 ET
Table 'Moreau III' 6-max Seat #4 is the button
Seat 4: ehrmstyle ($33.25 in chips) 
Seat 6: Kalaboush ($10.38 in chips) 
ehrmstyle: posts small blind $0.05
Kalaboush: posts big blind $0.10
ehrmstyle: posts the ante $0.02
Kalaboush: posts the ante $0.02
*** HOLE CARDS ***
ehrmstyle: folds 
Uncalled bet ($0.05) returned to Kalaboush
Kalaboush collected $0.14 from pot
Kalaboush: doesn't show hand 
*** SUMMARY ***
Total pot $0.14 | Rake $0 
Seat 4: ehrmstyle (button) (small blind) folded before Flop
Seat 6: Kalaboush (big blind) collected ($0.14)



PokerStars Hand #201505936179:  Hold'em No Limit ($0.05/$0.10 USD) - 2019/06/18 8:58:24 ET
Table 'Moreau III' 6-max Seat #6 is the button
Seat 4: ehrmstyle ($33.18 in chips) 
Seat 6: Kalaboush ($10.45 in chips) 
Kalaboush: posts small blind $0.05
ehrmstyle: posts big blind $0.10
ehrmstyle: posts the ante $0.02
Kalaboush: posts the ante $0.02
*** HOLE CARDS ***
Kalaboush: folds 
Uncalled bet ($0.05) returned to ehrmstyle
ehrmstyle collected $0.14 from pot
ehrmstyle: doesn't show hand 
*** SUMMARY ***
Total pot $0.14 | Rake $0 
Seat 4: ehrmstyle (big blind) collected ($0.14)
Seat 6: Kalaboush (button) (small blind) folded before Flop



PokerStars Hand #201505937614:  Hold'em No Limit ($0.05/$0.10 USD) - 2019/06/18 8:58:29 ET
Table 'Moreau III' 6-max Seat #4 is the button
Seat 4: ehrmstyle ($33.25 in chips) 
Seat 6: Kalaboush ($10.38 in chips) 
ehrmstyle: posts small blind $0.05
Kalaboush: posts big blind $0.10
ehrmstyle: posts the ante $0.02
Kalaboush: posts the ante $0.02
*** HOLE CARDS ***
ehrmstyle: raises $0.24 to $0.34
Kalaboush: folds 
Uncalled bet ($0.24) returned to ehrmstyle
ehrmstyle collected $0.24 from pot
ehrmstyle: doesn't show hand 
*** SUMMARY ***
Total pot $0.24 | Rake $0 
Seat 4: ehrmstyle (button) (small blind) collected ($0.24)
Seat 6: Kalaboush (big blind) folded before Flop



PokerStars Hand #201505939894:  Hold'em No Limit ($0.05/$0.10 USD) - 2019/06/18 8:58:37 ET
Table 'Moreau III' 6-max Seat #6 is the button
Seat 4: ehrmstyle ($33.37 in chips) 
Seat 6: Kalaboush ($10.26 in chips) 
Kalaboush: posts small blind $0.05
ehrmstyle: posts big blind $0.10
ehrmstyle: posts the ante $0.02
Kalaboush: posts the ante $0.02
*** HOLE CARDS ***
Kalaboush: raises $0.10 to $0.20
ehrmstyle: raises $0.44 to $0.64
Kalaboush: calls $0.44
*** FLOP *** [Kh Qs 2c]
ehrmstyle: bets $0.63
Kalaboush: folds 
Uncalled bet ($0.63) returned to ehrmstyle
ehrmstyle collected $1.26 from pot
ehrmstyle: doesn't show hand 
*** SUMMARY ***
Total pot $1.32 | Rake $0.06 
Board [Kh Qs 2c]
Seat 4: ehrmstyle (big blind) collected ($1.26)
Seat 6: Kalaboush (button) (small blind) folded on the Flop



PokerStars Hand #201505945268:  Hold'em No Limit ($0.05/$0.10 USD) - 2019/06/18 8:58:55 ET
Table 'Moreau III' 6-max Seat #4 is the button
Seat 4: ehrmstyle ($33.97 in chips) 
Seat 6: Kalaboush ($10 in chips) 
ehrmstyle: posts small blind $0.05
Kalaboush: posts big blind $0.10
ehrmstyle: posts the ante $0.02
Kalaboush: posts the ante $0.02
*** HOLE CARDS ***
ehrmstyle: raises $0.20 to $0.30
Kalaboush: calls $0.20
*** FLOP *** [Qh Ks 3c]
Kalaboush: checks 
ehrmstyle: checks 
*** TURN *** [Qh Ks 3c] [2c]
Kalaboush: checks 
ehrmstyle: checks 
*** RIVER *** [Qh Ks 3c 2c] [7h]
Kalaboush: checks 
ehrmstyle: checks 
*** SHOW DOWN ***
Kalaboush: shows [4s Ah] (high card Ace)
ehrmstyle: mucks hand 
Kalaboush collected $0.61 from pot
*** SUMMARY ***
Total pot $0.64 | Rake $0.03 
Board [Qh Ks 3c 2c 7h]
Seat 4: ehrmstyle (button) (small blind) mucked
Seat 6: Kalaboush (big blind) showed [4s Ah] and won ($0.61) with high card Ace



PokerStars Hand #201505951539:  Hold'em No Limit ($0.05/$0.10 USD) - 2019/06/18 8:59:17 ET
Table 'Moreau III' 6-max Seat #6 is the button
Seat 4: ehrmstyle ($33.65 in chips) 
Seat 6: Kalaboush ($10.29 in chips) 
Kalaboush: posts small blind $0.05
ehrmstyle: posts big blind $0.10
ehrmstyle: posts the ante $0.02
Kalaboush: posts the ante $0.02
*** HOLE CARDS ***
Kalaboush: folds 
Uncalled bet ($0.05) returned to ehrmstyle
ehrmstyle collected $0.14 from pot
ehrmstyle: doesn't show hand 
*** SUMMARY ***
Total pot $0.14 | Rake $0 
Seat 4: ehrmstyle (big blind) collected ($0.14)
Seat 6: Kalaboush (button) (small blind) folded before Flop



PokerStars Hand #201505953198:  Hold'em No Limit ($0.05/$0.10 USD) - 2019/06/18 8:59:22 ET
Table 'Moreau III' 6-max Seat #4 is the button
Seat 4: ehrmstyle ($33.72 in chips) 
Seat 6: Kalaboush ($10.22 in chips) 
ehrmstyle: posts small blind $0.05
Kalaboush: posts big blind $0.10
ehrmstyle: posts the ante $0.02
Kalaboush: posts the ante $0.02
*** HOLE CARDS ***
ehrmstyle: raises $0.24 to $0.34
Kalaboush: calls $0.24
*** FLOP *** [Kh As 4h]
Kalaboush: checks 
ehrmstyle: checks 
*** TURN *** [Kh As 4h] [8h]
Kalaboush: checks 
ehrmstyle: checks 
*** RIVER *** [Kh As 4h 8h] [4d]
Kalaboush: bets $0.30
ehrmstyle: folds 
Uncalled bet ($0.30) returned to Kalaboush
Kalaboush collected $0.69 from pot
Kalaboush: doesn't show hand 
*** SUMMARY ***
Total pot $0.72 | Rake $0.03 
Board [Kh As 4h 8h 4d]
Seat 4: ehrmstyle (button) (small blind) folded on the River
Seat 6: Kalaboush (big blind) collected ($0.69)



PokerStars Hand #201505962497:  Hold'em No Limit ($0.05/$0.10 USD) - 2019/06/18 8:59:54 ET
Table 'Moreau III' 6-max Seat #6 is the button
Seat 4: ehrmstyle ($33.36 in chips) 
Seat 6: Kalaboush ($10.55 in chips) 
Kalaboush: posts small blind $0.05
ehrmstyle: posts big blind $0.10
ehrmstyle: posts the ante $0.02
Kalaboush: posts the ante $0.02
*** HOLE CARDS ***
Kalaboush: raises $0.20 to $0.30
ehrmstyle: calls $0.20
*** FLOP *** [Qc 5d 6c]
ehrmstyle: checks 
Kalaboush: bets $0.30
ehrmstyle: calls $0.30
*** TURN *** [Qc 5d 6c] [9s]
ehrmstyle: checks 
Kalaboush: checks 
*** RIVER *** [Qc 5d 6c 9s] [Td]
ehrmstyle: bets $0.59
Kalaboush: calls $0.59
*** SHOW DOWN ***
ehrmstyle: shows [2c 2d] (a pair of Deuces)
Kalaboush: shows [8h 8s] (a pair of Eights)
Kalaboush collected $2.31 from pot
*** SUMMARY ***
Total pot $2.42 | Rake $0.11 
Board [Qc 5d 6c 9s Td]
Seat 4: ehrmstyle (big blind) showed [2c 2d] and lost with a pair of Deuces
Seat 6: Kalaboush (button) (small blind) showed [8h 8s] and won ($2.31) with a pair of Eights



PokerStars Hand #201505983437:  Hold'em No Limit ($0.05/$0.10 USD) - 2019/06/18 9:00:18 ET
Table 'Moreau III' 6-max Seat #4 is the button
Seat 4: ehrmstyle ($32.15 in chips) 
Seat 6: Kalaboush ($11.65 in chips) 
ehrmstyle: posts small blind $0.05
Kalaboush: posts big blind $0.10
ehrmstyle: posts the ante $0.02
Kalaboush: posts the ante $0.02
*** HOLE CARDS ***
ehrmstyle: raises $0.20 to $0.30
Kalaboush: calls $0.20
*** FLOP *** [9c 8c Jh]
Kalaboush: checks 
ehrmstyle: bets $0.31
Kalaboush: folds 
Uncalled bet ($0.31) returned to ehrmstyle
ehrmstyle collected $0.61 from pot
ehrmstyle: doesn't show hand 
*** SUMMARY ***
Total pot $0.64 | Rake $0.03 
Board [9c 8c Jh]
Seat 4: ehrmstyle (button) (small blind) collected ($0.61)
Seat 6: Kalaboush (big blind) folded on the Flop



PokerStars Hand #201505988066:  Hold'em No Limit ($0.05/$0.10 USD) - 2019/06/18 9:00:32 ET
Table 'Moreau III' 6-max Seat #6 is the button
Seat 4: ehrmstyle ($32.44 in chips) 
Seat 6: Kalaboush ($11.33 in chips) 
Kalaboush: posts small blind $0.05
ehrmstyle: posts big blind $0.10
ehrmstyle: posts the ante $0.02
Kalaboush: posts the ante $0.02
*** HOLE CARDS ***
Kalaboush: raises $0.24 to $0.34
ehrmstyle: calls $0.24
*** FLOP *** [9d 2c 7h]
ehrmstyle: checks 
Kalaboush: bets $0.30
ehrmstyle: calls $0.30
*** TURN *** [9d 2c 7h] [Ts]
ehrmstyle: checks 
Kalaboush: checks 
*** RIVER *** [9d 2c 7h Ts] [Kh]
ehrmstyle: bets $31.78 and is all-in
Kalaboush: folds 
Uncalled bet ($31.78) returned to ehrmstyle
ehrmstyle collected $1.26 from pot
ehrmstyle: doesn't show hand 
*** SUMMARY ***
Total pot $1.32 | Rake $0.06 
Board [9d 2c 7h Ts Kh]
Seat 4: ehrmstyle (big blind) collected ($1.26)
Seat 6: Kalaboush (button) (small blind) folded on the River



PokerStars Hand #201506002654:  Hold'em No Limit ($0.05/$0.10 USD) - 2019/06/18 9:01:00 ET
Table 'Moreau III' 6-max Seat #4 is the button
Seat 4: ehrmstyle ($33.04 in chips) 
Seat 6: Kalaboush ($10.67 in chips) 
ehrmstyle: posts small blind $0.05
Kalaboush: posts big blind $0.10
ehrmstyle: posts the ante $0.02
Kalaboush: posts the ante $0.02
*** HOLE CARDS ***
ehrmstyle: folds 
Uncalled bet ($0.05) returned to Kalaboush
Kalaboush collected $0.14 from pot
Kalaboush: doesn't show hand 
*** SUMMARY ***
Total pot $0.14 | Rake $0 
Seat 4: ehrmstyle (button) (small blind) folded before Flop
Seat 6: Kalaboush (big blind) collected ($0.14)



PokerStars Hand #201506004403:  Hold'em No Limit ($0.05/$0.10 USD) - 2019/06/18 9:01:05 ET
Table 'Moreau III' 6-max Seat #6 is the button
Seat 4: ehrmstyle ($32.97 in chips) 
Seat 6: Kalaboush ($10.74 in chips) 
Kalaboush: posts small blind $0.05
ehrmstyle: posts big blind $0.10
ehrmstyle: posts the ante $0.02
Kalaboush: posts the ante $0.02
*** HOLE CARDS ***
Kalaboush: calls $0.05
ehrmstyle: checks 
*** FLOP *** [Tc Jd 4d]
ehrmstyle: checks 
Kalaboush: checks 
*** TURN *** [Tc Jd 4d] [5s]
ehrmstyle: bets $0.10
Kalaboush: folds 
Uncalled bet ($0.10) returned to ehrmstyle
ehrmstyle collected $0.23 from pot
ehrmstyle: doesn't show hand 
*** SUMMARY ***
Total pot $0.24 | Rake $0.01 
Board [Tc Jd 4d 5s]
Seat 4: ehrmstyle (big blind) collected ($0.23)
Seat 6: Kalaboush (button) (small blind) folded on the Turn



PokerStars Hand #201506009771:  Hold'em No Limit ($0.05/$0.10 USD) - 2019/06/18 9:01:22 ET
Table 'Moreau III' 6-max Seat #4 is the button
Seat 4: ehrmstyle ($33.08 in chips) 
Seat 6: Kalaboush ($10.62 in chips) 
ehrmstyle: posts small blind $0.05
Kalaboush: posts big blind $0.10
ehrmstyle: posts the ante $0.02
Kalaboush: posts the ante $0.02
*** HOLE CARDS ***
ehrmstyle: raises $0.24 to $0.34
Kalaboush: folds 
Uncalled bet ($0.24) returned to ehrmstyle
ehrmstyle collected $0.24 from pot
ehrmstyle: doesn't show hand 
*** SUMMARY ***
Total pot $0.24 | Rake $0 
Seat 4: ehrmstyle (button) (small blind) collected ($0.24)
Seat 6: Kalaboush (big blind) folded before Flop



PokerStars Hand #201506023743:  Hold'em No Limit ($0.05/$0.10 USD) - 2019/06/18 9:01:37 ET
Table 'Moreau III' 6-max Seat #6 is the button
Seat 4: ehrmstyle ($33.20 in chips) 
Seat 6: Kalaboush ($10.50 in chips) 
Kalaboush: posts small blind $0.05
ehrmstyle: posts big blind $0.10
ehrmstyle: posts the ante $0.02
Kalaboush: posts the ante $0.02
*** HOLE CARDS ***
Kalaboush: raises $0.20 to $0.30
ehrmstyle: calls $0.20
*** FLOP *** [Qs 3c 7d]
ehrmstyle: checks 
Kalaboush: checks 
*** TURN *** [Qs 3c 7d] [7h]
ehrmstyle: checks 
Kalaboush: checks 
*** RIVER *** [Qs 3c 7d 7h] [5d]
ehrmstyle: bets $32.88 and is all-in
Kalaboush: folds 
Uncalled bet ($32.88) returned to ehrmstyle
ehrmstyle collected $0.61 from pot
ehrmstyle: doesn't show hand 
*** SUMMARY ***
Total pot $0.64 | Rake $0.03 
Board [Qs 3c 7d 7h 5d]
Seat 4: ehrmstyle (big blind) collected ($0.61)
Seat 6: Kalaboush (button) (small blind) folded on the River



PokerStars Hand #201506037039:  Hold'em No Limit ($0.05/$0.10 USD) - 2019/06/18 9:02:09 ET
Table 'Moreau III' 6-max Seat #4 is the button
Seat 4: ehrmstyle ($33.49 in chips) 
Seat 6: Kalaboush ($10.18 in chips) 
ehrmstyle: posts small blind $0.05
Kalaboush: posts big blind $0.10
ehrmstyle: posts the ante $0.02
Kalaboush: posts the ante $0.02
*** HOLE CARDS ***
ehrmstyle: raises $0.24 to $0.34
Kalaboush: folds 
Uncalled bet ($0.24) returned to ehrmstyle
ehrmstyle collected $0.24 from pot
ehrmstyle: doesn't show hand 
*** SUMMARY ***
Total pot $0.24 | Rake $0 
Seat 4: ehrmstyle (button) (small blind) collected ($0.24)
Seat 6: Kalaboush (big blind) folded before Flop



PokerStars Hand #201506039169:  Hold'em No Limit ($0.05/$0.10 USD) - 2019/06/18 9:02:16 ET
Table 'Moreau III' 6-max Seat #6 is the button
Seat 4: ehrmstyle ($33.61 in chips) 
Seat 6: Kalaboush ($10.06 in chips) 
Kalaboush: posts small blind $0.05
ehrmstyle: posts big blind $0.10
ehrmstyle: posts the ante $0.02
Kalaboush: posts the ante $0.02
*** HOLE CARDS ***
Kalaboush: folds 
Uncalled bet ($0.05) returned to ehrmstyle
ehrmstyle collected $0.14 from pot
ehrmstyle: doesn't show hand 
*** SUMMARY ***
Total pot $0.14 | Rake $0 
Seat 4: ehrmstyle (big blind) collected ($0.14)
Seat 6: Kalaboush (button) (small blind) folded before Flop



PokerStars Hand #201506041076:  Hold'em No Limit ($0.05/$0.10 USD) - 2019/06/18 9:02:21 ET
Table 'Moreau III' 6-max Seat #4 is the button
Seat 4: ehrmstyle ($33.68 in chips) 
Seat 6: Kalaboush ($10 in chips) 
ehrmstyle: posts small blind $0.05
Kalaboush: posts big blind $0.10
ehrmstyle: posts the ante $0.02
Kalaboush: posts the ante $0.02
*** HOLE CARDS ***
ehrmstyle: raises $0.20 to $0.30
Kalaboush: calls $0.20
*** FLOP *** [Ah 2h 4s]
Kalaboush: checks 
ehrmstyle: bets $0.31
Kalaboush: calls $0.31
*** TURN *** [Ah 2h 4s] [7h]
Kalaboush: checks 
ehrmstyle: bets $0.60
Kalaboush: calls $0.60
*** RIVER *** [Ah 2h 4s 7h] [9h]
Kalaboush: checks 
ehrmstyle: bets $1.18
Kalaboush: calls $1.18
*** SHOW DOWN ***
ehrmstyle: shows [4h Jd] (a flush, Ace high)
Kalaboush: mucks hand 
ehrmstyle collected $4.60 from pot
*** SUMMARY ***
Total pot $4.82 | Rake $0.22 
Board [Ah 2h 4s 7h 9h]
Seat 4: ehrmstyle (button) (small blind) showed [4h Jd] and won ($4.60) with a flush, Ace high
Seat 6: Kalaboush (big blind) mucked



PokerStars Hand #201506056064:  Hold'em No Limit ($0.05/$0.10 USD) - 2019/06/18 9:02:49 ET
Table 'Moreau III' 6-max Seat #6 is the button
Seat 4: ehrmstyle ($35.87 in chips) 
Seat 6: Kalaboush ($10 in chips) 
Kalaboush: posts small blind $0.05
ehrmstyle: posts big blind $0.10
ehrmstyle: posts the ante $0.02
Kalaboush: posts the ante $0.02
*** HOLE CARDS ***
Kalaboush: raises $0.10 to $0.20
ehrmstyle: folds 
Uncalled bet ($0.10) returned to Kalaboush
Kalaboush collected $0.24 from pot
Kalaboush: doesn't show hand 
*** SUMMARY ***
Total pot $0.24 | Rake $0 
Seat 4: ehrmstyle (big blind) folded before Flop
Seat 6: Kalaboush (button) (small blind) collected ($0.24)



PokerStars Hand #201506061563:  Hold'em No Limit ($0.05/$0.10 USD) - 2019/06/18 9:03:05 ET
Table 'Moreau III' 6-max Seat #4 is the button
Seat 4: ehrmstyle ($35.75 in chips) 
Seat 6: Kalaboush ($10.12 in chips) 
ehrmstyle: posts small blind $0.05
Kalaboush: posts big blind $0.10
ehrmstyle: posts the ante $0.02
Kalaboush: posts the ante $0.02
*** HOLE CARDS ***
ehrmstyle: raises $0.20 to $0.30
Kalaboush: folds 
Uncalled bet ($0.20) returned to ehrmstyle
ehrmstyle collected $0.24 from pot
ehrmstyle: doesn't show hand 
*** SUMMARY ***
Total pot $0.24 | Rake $0 
Seat 4: ehrmstyle (button) (small blind) collected ($0.24)
Seat 6: Kalaboush (big blind) folded before Flop



PokerStars Hand #201506066289:  Hold'em No Limit ($0.05/$0.10 USD) - 2019/06/18 9:03:18 ET
Table 'Moreau III' 6-max Seat #6 is the button
Seat 4: ehrmstyle ($35.87 in chips) 
Seat 6: Kalaboush ($10 in chips) 
Kalaboush: posts small blind $0.05
ehrmstyle: posts big blind $0.10
ehrmstyle: posts the ante $0.02
Kalaboush: posts the ante $0.02
*** HOLE CARDS ***
Kalaboush: raises $0.24 to $0.34
ehrmstyle: calls $0.24
*** FLOP *** [Tc 5s Qs]
ehrmstyle: checks 
Kalaboush: bets $0.70
ehrmstyle: folds 
Uncalled bet ($0.70) returned to Kalaboush
Kalaboush collected $0.69 from pot
Kalaboush: doesn't show hand 
*** SUMMARY ***
Total pot $0.72 | Rake $0.03 
Board [Tc 5s Qs]
Seat 4: ehrmstyle (big blind) folded on the Flop
Seat 6: Kalaboush (button) (small blind) collected ($0.69)



PokerStars Hand #201506071806:  Hold'em No Limit ($0.05/$0.10 USD) - 2019/06/18 9:03:34 ET
Table 'Moreau III' 6-max Seat #4 is the button
Seat 4: ehrmstyle ($35.51 in chips) 
Seat 6: Kalaboush ($10.33 in chips) 
ehrmstyle: posts small blind $0.05
Kalaboush: posts big blind $0.10
ehrmstyle: posts the ante $0.02
Kalaboush: posts the ante $0.02
*** HOLE CARDS ***
ehrmstyle: raises $0.20 to $0.30
Kalaboush: folds 
Uncalled bet ($0.20) returned to ehrmstyle
ehrmstyle collected $0.24 from pot
ehrmstyle: doesn't show hand 
*** SUMMARY ***
Total pot $0.24 | Rake $0 
Seat 4: ehrmstyle (button) (small blind) collected ($0.24)
Seat 6: Kalaboush (big blind) folded before Flop



PokerStars Hand #201506077240:  Hold'em No Limit ($0.05/$0.10 USD) - 2019/06/18 9:03:43 ET
Table 'Moreau III' 6-max Seat #6 is the button
Seat 4: ehrmstyle ($35.63 in chips) 
Seat 6: Kalaboush ($10.21 in chips) 
Kalaboush: posts small blind $0.05
ehrmstyle: posts big blind $0.10
ehrmstyle: posts the ante $0.02
Kalaboush: posts the ante $0.02
*** HOLE CARDS ***
Kalaboush: folds 
Uncalled bet ($0.05) returned to ehrmstyle
ehrmstyle collected $0.14 from pot
ehrmstyle: doesn't show hand 
*** SUMMARY ***
Total pot $0.14 | Rake $0 
Seat 4: ehrmstyle (big blind) collected ($0.14)
Seat 6: Kalaboush (button) (small blind) folded before Flop



PokerStars Hand #201506078985:  Hold'em No Limit ($0.05/$0.10 USD) - 2019/06/18 9:03:48 ET
Table 'Moreau III' 6-max Seat #4 is the button
Seat 4: ehrmstyle ($35.70 in chips) 
Seat 6: Kalaboush ($10.14 in chips) 
ehrmstyle: posts small blind $0.05
Kalaboush: posts big blind $0.10
ehrmstyle: posts the ante $0.02
Kalaboush: posts the ante $0.02
*** HOLE CARDS ***
ehrmstyle: raises $0.20 to $0.30
Kalaboush: raises $0.64 to $0.94
ehrmstyle: calls $0.64
*** FLOP *** [6h Js Ts]
Kalaboush: bets $1.80
ehrmstyle: folds 
Uncalled bet ($1.80) returned to Kalaboush
Kalaboush collected $1.83 from pot
Kalaboush: doesn't show hand 
*** SUMMARY ***
Total pot $1.92 | Rake $0.09 
Board [6h Js Ts]
Seat 4: ehrmstyle (button) (small blind) folded on the Flop
Seat 6: Kalaboush (big blind) collected ($1.83)



PokerStars Hand #201506085588:  Hold'em No Limit ($0.05/$0.10 USD) - 2019/06/18 9:04:07 ET
Table 'Moreau III' 6-max Seat #6 is the button
Seat 4: ehrmstyle ($34.74 in chips) 
Seat 6: Kalaboush ($11.01 in chips) 
Kalaboush: posts small blind $0.05
ehrmstyle: posts big blind $0.10
ehrmstyle: posts the ante $0.02
Kalaboush: posts the ante $0.02
*** HOLE CARDS ***
Kalaboush: folds 
Uncalled bet ($0.05) returned to ehrmstyle
ehrmstyle collected $0.14 from pot
ehrmstyle: doesn't show hand 
*** SUMMARY ***
Total pot $0.14 | Rake $0 
Seat 4: ehrmstyle (big blind) collected ($0.14)
Seat 6: Kalaboush (button) (small blind) folded before Flop



PokerStars Hand #201506087258:  Hold'em No Limit ($0.05/$0.10 USD) - 2019/06/18 9:04:12 ET
Table 'Moreau III' 6-max Seat #4 is the button
Seat 4: ehrmstyle ($34.81 in chips) 
Seat 6: Kalaboush ($10.94 in chips) 
ehrmstyle: posts small blind $0.05
Kalaboush: posts big blind $0.10
ehrmstyle: posts the ante $0.02
Kalaboush: posts the ante $0.02
*** HOLE CARDS ***
ehrmstyle: raises $0.20 to $0.30
Kalaboush: calls $0.20
*** FLOP *** [Js 6s Kd]
Kalaboush: checks 
ehrmstyle: bets $0.40
Kalaboush: calls $0.40
*** TURN *** [Js 6s Kd] [4s]
Kalaboush: checks 
ehrmstyle: bets $0.69
Kalaboush: calls $0.69
*** RIVER *** [Js 6s Kd 4s] [Tc]
Kalaboush: checks 
ehrmstyle: bets $1.35
Kalaboush: calls $1.35
*** SHOW DOWN ***
ehrmstyle: shows [8s Kc] (a pair of Kings)
Kalaboush: mucks hand 
ehrmstyle collected $5.27 from pot
*** SUMMARY ***
Total pot $5.52 | Rake $0.25 
Board [Js 6s Kd 4s Tc]
Seat 4: ehrmstyle (button) (small blind) showed [8s Kc] and won ($5.27) with a pair of Kings
Seat 6: Kalaboush (big blind) mucked



PokerStars Hand #201506100172:  Hold'em No Limit ($0.05/$0.10 USD) - 2019/06/18 9:04:46 ET
Table 'Moreau III' 6-max Seat #6 is the button
Seat 4: ehrmstyle ($37.32 in chips) 
Seat 6: Kalaboush ($9.36 in chips) 
Kalaboush: posts small blind $0.05
ehrmstyle: posts big blind $0.10
ehrmstyle: posts the ante $0.02
Kalaboush: posts the ante $0.02
*** HOLE CARDS ***
Kalaboush: folds 
Uncalled bet ($0.05) returned to ehrmstyle
ehrmstyle collected $0.14 from pot
ehrmstyle: doesn't show hand 
*** SUMMARY ***
Total pot $0.14 | Rake $0 
Seat 4: ehrmstyle (big blind) collected ($0.14)
Seat 6: Kalaboush (button) (small blind) folded before Flop



PokerStars Hand #201506101803:  Hold'em No Limit ($0.05/$0.10 USD) - 2019/06/18 9:04:51 ET
Table 'Moreau III' 6-max Seat #4 is the button
Seat 4: ehrmstyle ($37.39 in chips) 
Seat 6: Kalaboush ($9.29 in chips) 
ehrmstyle: posts small blind $0.05
Kalaboush: posts big blind $0.10
ehrmstyle: posts the ante $0.02
Kalaboush: posts the ante $0.02
*** HOLE CARDS ***
ehrmstyle: raises $0.20 to $0.30
Kalaboush: folds 
Uncalled bet ($0.20) returned to ehrmstyle
ehrmstyle collected $0.24 from pot
ehrmstyle: doesn't show hand 
*** SUMMARY ***
Total pot $0.24 | Rake $0 
Seat 4: ehrmstyle (button) (small blind) collected ($0.24)
Seat 6: Kalaboush (big blind) folded before Flop



PokerStars Hand #201506105630:  Hold'em No Limit ($0.05/$0.10 USD) - 2019/06/18 9:05:02 ET
Table 'Moreau III' 6-max Seat #6 is the button
Seat 4: ehrmstyle ($37.51 in chips) 
Seat 6: Kalaboush ($9.17 in chips) 
Kalaboush: posts small blind $0.05
ehrmstyle: posts big blind $0.10
ehrmstyle: posts the ante $0.02
Kalaboush: posts the ante $0.02
*** HOLE CARDS ***
Kalaboush: raises $0.20 to $0.30
ehrmstyle: calls $0.20
*** FLOP *** [7c Kh 5c]
ehrmstyle: bets $0.31
Kalaboush: calls $0.31
*** TURN *** [7c Kh 5c] [7h]
ehrmstyle: bets $0.60
Kalaboush: folds 
Uncalled bet ($0.60) returned to ehrmstyle
ehrmstyle collected $1.20 from pot
ehrmstyle: doesn't show hand 
*** SUMMARY ***
Total pot $1.26 | Rake $0.06 
Board [7c Kh 5c 7h]
Seat 4: ehrmstyle (big blind) collected ($1.20)
Seat 6: Kalaboush (button) (small blind) folded on the Turn



PokerStars Hand #201506112654:  Hold'em No Limit ($0.05/$0.10 USD) - 2019/06/18 9:05:22 ET
Table 'Moreau III' 6-max Seat #4 is the button
Seat 4: ehrmstyle ($38.08 in chips) 
Seat 6: Kalaboush ($8.54 in chips) 
ehrmstyle: posts small blind $0.05
Kalaboush: posts big blind $0.10
ehrmstyle: posts the ante $0.02
Kalaboush: posts the ante $0.02
*** HOLE CARDS ***
ehrmstyle: raises $0.20 to $0.30
Kalaboush: calls $0.20
*** FLOP *** [6h 9s 6s]
Kalaboush: checks 
ehrmstyle: bets $0.31
Kalaboush: folds 
Uncalled bet ($0.31) returned to ehrmstyle
ehrmstyle collected $0.61 from pot
ehrmstyle: doesn't show hand 
*** SUMMARY ***
Total pot $0.64 | Rake $0.03 
Board [6h 9s 6s]
Seat 4: ehrmstyle (button) (small blind) collected ($0.61)
Seat 6: Kalaboush (big blind) folded on the Flop



PokerStars Hand #201506118441:  Hold'em No Limit ($0.05/$0.10 USD) - 2019/06/18 9:05:39 ET
Table 'Moreau III' 6-max Seat #6 is the button
Seat 4: ehrmstyle ($38.37 in chips) 
Seat 6: Kalaboush ($8.22 in chips) 
Kalaboush: posts small blind $0.05
ehrmstyle: posts big blind $0.10
ehrmstyle: posts the ante $0.02
Kalaboush: posts the ante $0.02
*** HOLE CARDS ***
Kalaboush: folds 
Uncalled bet ($0.05) returned to ehrmstyle
ehrmstyle collected $0.14 from pot
ehrmstyle: doesn't show hand 
*** SUMMARY ***
Total pot $0.14 | Rake $0 
Seat 4: ehrmstyle (big blind) collected ($0.14)
Seat 6: Kalaboush (button) (small blind) folded before Flop



PokerStars Hand #201506120702:  Hold'em No Limit ($0.05/$0.10 USD) - 2019/06/18 9:05:44 ET
Table 'Moreau III' 6-max Seat #4 is the button
Seat 4: ehrmstyle ($38.44 in chips) 
Seat 6: Kalaboush ($8.15 in chips) 
ehrmstyle: posts small blind $0.05
Kalaboush: posts big blind $0.10
ehrmstyle: posts the ante $0.02
Kalaboush: posts the ante $0.02
*** HOLE CARDS ***
ehrmstyle: raises $0.20 to $0.30
Kalaboush: calls $0.20
*** FLOP *** [Kc Jd 2c]
Kalaboush: checks 
ehrmstyle: checks 
*** TURN *** [Kc Jd 2c] [Tc]
Kalaboush: checks 
ehrmstyle: checks 
*** RIVER *** [Kc Jd 2c Tc] [2s]
Kalaboush: checks 
ehrmstyle: checks 
*** SHOW DOWN ***
Kalaboush: shows [6h 6d] (two pair, Sixes and Deuces)
ehrmstyle: mucks hand 
Kalaboush collected $0.61 from pot
*** SUMMARY ***
Total pot $0.64 | Rake $0.03 
Board [Kc Jd 2c Tc 2s]
Seat 4: ehrmstyle (button) (small blind) mucked
Seat 6: Kalaboush (big blind) showed [6h 6d] and won ($0.61) with two pair, Sixes and Deuces



PokerStars Hand #201506126995:  Hold'em No Limit ($0.05/$0.10 USD) - 2019/06/18 9:06:03 ET
Table 'Moreau III' 6-max Seat #6 is the button
Seat 4: ehrmstyle ($38.12 in chips) 
Seat 6: Kalaboush ($8.44 in chips) 
Kalaboush: posts small blind $0.05
ehrmstyle: posts big blind $0.10
ehrmstyle: posts the ante $0.02
Kalaboush: posts the ante $0.02
*** HOLE CARDS ***
Kalaboush: folds 
Uncalled bet ($0.05) returned to ehrmstyle
ehrmstyle collected $0.14 from pot
ehrmstyle: doesn't show hand 
*** SUMMARY ***
Total pot $0.14 | Rake $0 
Seat 4: ehrmstyle (big blind) collected ($0.14)
Seat 6: Kalaboush (button) (small blind) folded before Flop



PokerStars Hand #201506128673:  Hold'em No Limit ($0.05/$0.10 USD) - 2019/06/18 9:06:08 ET
Table 'Moreau III' 6-max Seat #4 is the button
Seat 4: ehrmstyle ($38.19 in chips) 
Seat 6: Kalaboush ($8.37 in chips) 
ehrmstyle: posts small blind $0.05
Kalaboush: posts big blind $0.10
ehrmstyle: posts the ante $0.02
Kalaboush: posts the ante $0.02
*** HOLE CARDS ***
ehrmstyle: folds 
Uncalled bet ($0.05) returned to Kalaboush
Kalaboush collected $0.14 from pot
Kalaboush: doesn't show hand 
*** SUMMARY ***
Total pot $0.14 | Rake $0 
Seat 4: ehrmstyle (button) (small blind) folded before Flop
Seat 6: Kalaboush (big blind) collected ($0.14)



PokerStars Hand #201506130693:  Hold'em No Limit ($0.05/$0.10 USD) - 2019/06/18 9:06:13 ET
Table 'Moreau III' 6-max Seat #6 is the button
Seat 4: ehrmstyle ($38.12 in chips) 
Seat 6: Kalaboush ($8.44 in chips) 
Kalaboush: posts small blind $0.05
ehrmstyle: posts big blind $0.10
ehrmstyle: posts the ante $0.02
Kalaboush: posts the ante $0.02
*** HOLE CARDS ***
Kalaboush: raises $0.20 to $0.30
ehrmstyle: folds 
Uncalled bet ($0.20) returned to Kalaboush
Kalaboush collected $0.24 from pot
Kalaboush: doesn't show hand 
*** SUMMARY ***
Total pot $0.24 | Rake $0 
Seat 4: ehrmstyle (big blind) folded before Flop
Seat 6: Kalaboush (button) (small blind) collected ($0.24)



PokerStars Hand #201506133177:  Hold'em No Limit ($0.05/$0.10 USD) - 2019/06/18 9:06:21 ET
Table 'Moreau III' 6-max Seat #4 is the button
Seat 4: ehrmstyle ($38 in chips) 
Seat 6: Kalaboush ($8.56 in chips) 
ehrmstyle: posts small blind $0.05
Kalaboush: posts big blind $0.10
ehrmstyle: posts the ante $0.02
Kalaboush: posts the ante $0.02
*** HOLE CARDS ***
ehrmstyle: raises $0.20 to $0.30
Kalaboush: folds 
Uncalled bet ($0.20) returned to ehrmstyle
ehrmstyle collected $0.24 from pot
ehrmstyle: doesn't show hand 
*** SUMMARY ***
Total pot $0.24 | Rake $0 
Seat 4: ehrmstyle (button) (small blind) collected ($0.24)
Seat 6: Kalaboush (big blind) folded before Flop



PokerStars Hand #201506136227:  Hold'em No Limit ($0.05/$0.10 USD) - 2019/06/18 9:06:30 ET
Table 'Moreau III' 6-max Seat #6 is the button
Seat 4: ehrmstyle ($38.12 in chips) 
Seat 6: Kalaboush ($8.44 in chips) 
Kalaboush: posts small blind $0.05
ehrmstyle: posts big blind $0.10
ehrmstyle: posts the ante $0.02
Kalaboush: posts the ante $0.02
*** HOLE CARDS ***
Kalaboush: raises $0.20 to $0.30
ehrmstyle: calls $0.20
*** FLOP *** [6d 7h As]
ehrmstyle: bets $0.31
Kalaboush: raises $0.59 to $0.90
ehrmstyle: calls $0.59
*** TURN *** [6d 7h As] [7d]
ehrmstyle: checks 
Kalaboush: checks 
*** RIVER *** [6d 7h As 7d] [4h]
ehrmstyle: bets $1.17
Kalaboush: folds 
Uncalled bet ($1.17) returned to ehrmstyle
ehrmstyle collected $2.33 from pot
ehrmstyle: doesn't show hand 
*** SUMMARY ***
Total pot $2.44 | Rake $0.11 
Board [6d 7h As 7d 4h]
Seat 4: ehrmstyle (big blind) collected ($2.33)
Seat 6: Kalaboush (button) (small blind) folded on the River



PokerStars Hand #201506149781:  Hold'em No Limit ($0.05/$0.10 USD) - 2019/06/18 9:07:08 ET
Table 'Moreau III' 6-max Seat #4 is the button
Seat 4: ehrmstyle ($39.23 in chips) 
Seat 6: Kalaboush ($7.22 in chips) 
ehrmstyle: posts small blind $0.05
Kalaboush: posts big blind $0.10
ehrmstyle: posts the ante $0.02
Kalaboush: posts the ante $0.02
*** HOLE CARDS ***
ehrmstyle: folds 
Uncalled bet ($0.05) returned to Kalaboush
Kalaboush collected $0.14 from pot
Kalaboush: doesn't show hand 
*** SUMMARY ***
Total pot $0.14 | Rake $0 
Seat 4: ehrmstyle (button) (small blind) folded before Flop
Seat 6: Kalaboush (big blind) collected ($0.14)



PokerStars Hand #201506152371:  Hold'em No Limit ($0.05/$0.10 USD) - 2019/06/18 9:07:16 ET
Table 'Moreau III' 6-max Seat #6 is the button
Seat 4: ehrmstyle ($39.16 in chips) 
Seat 6: Kalaboush ($7.29 in chips) 
Kalaboush: posts small blind $0.05
ehrmstyle: posts big blind $0.10
ehrmstyle: posts the ante $0.02
Kalaboush: posts the ante $0.02
*** HOLE CARDS ***
Kalaboush: folds 
Uncalled bet ($0.05) returned to ehrmstyle
ehrmstyle collected $0.14 from pot
ehrmstyle: doesn't show hand 
*** SUMMARY ***
Total pot $0.14 | Rake $0 
Seat 4: ehrmstyle (big blind) collected ($0.14)
Seat 6: Kalaboush (button) (small blind) folded before Flop



PokerStars Hand #201506153990:  Hold'em No Limit ($0.05/$0.10 USD) - 2019/06/18 9:07:21 ET
Table 'Moreau III' 6-max Seat #4 is the button
Seat 4: ehrmstyle ($39.23 in chips) 
Seat 6: Kalaboush ($7.22 in chips) 
ehrmstyle: posts small blind $0.05
Kalaboush: posts big blind $0.10
ehrmstyle: posts the ante $0.02
Kalaboush: posts the ante $0.02
*** HOLE CARDS ***
ehrmstyle: raises $0.20 to $0.30
Kalaboush: folds 
Uncalled bet ($0.20) returned to ehrmstyle
ehrmstyle collected $0.24 from pot
ehrmstyle: doesn't show hand 
*** SUMMARY ***
Total pot $0.24 | Rake $0 
Seat 4: ehrmstyle (button) (small blind) collected ($0.24)
Seat 6: Kalaboush (big blind) folded before Flop



PokerStars Hand #201506156575:  Hold'em No Limit ($0.05/$0.10 USD) - 2019/06/18 9:07:28 ET
Table 'Moreau III' 6-max Seat #6 is the button
Seat 4: ehrmstyle ($39.35 in chips) 
Seat 6: Kalaboush ($7.10 in chips) 
Kalaboush: posts small blind $0.05
ehrmstyle: posts big blind $0.10
ehrmstyle: posts the ante $0.02
Kalaboush: posts the ante $0.02
*** HOLE CARDS ***
Kalaboush: folds 
Uncalled bet ($0.05) returned to ehrmstyle
ehrmstyle collected $0.14 from pot
ehrmstyle: doesn't show hand 
*** SUMMARY ***
Total pot $0.14 | Rake $0 
Seat 4: ehrmstyle (big blind) collected ($0.14)
Seat 6: Kalaboush (button) (small blind) folded before Flop



PokerStars Hand #201506158305:  Hold'em No Limit ($0.05/$0.10 USD) - 2019/06/18 9:07:33 ET
Table 'Moreau III' 6-max Seat #4 is the button
Seat 4: ehrmstyle ($39.42 in chips) 
Seat 6: Kalaboush ($7.03 in chips) 
ehrmstyle: posts small blind $0.05
Kalaboush: posts big blind $0.10
ehrmstyle: posts the ante $0.02
Kalaboush: posts the ante $0.02
*** HOLE CARDS ***
ehrmstyle: raises $0.20 to $0.30
Kalaboush: calls $0.20
*** FLOP *** [Kc Td 9d]
Kalaboush: checks 
ehrmstyle: checks 
*** TURN *** [Kc Td 9d] [4h]
Kalaboush: checks 
ehrmstyle: checks 
*** RIVER *** [Kc Td 9d 4h] [Jc]
Kalaboush: checks 
ehrmstyle: bets $0.31
Kalaboush: folds 
Uncalled bet ($0.31) returned to ehrmstyle
ehrmstyle collected $0.61 from pot
ehrmstyle: doesn't show hand 
*** SUMMARY ***
Total pot $0.64 | Rake $0.03 
Board [Kc Td 9d 4h Jc]
Seat 4: ehrmstyle (button) (small blind) collected ($0.61)
Seat 6: Kalaboush (big blind) folded on the River



PokerStars Hand #201506167162:  Hold'em No Limit ($0.05/$0.10 USD) - 2019/06/18 9:07:59 ET
Table 'Moreau III' 6-max Seat #6 is the button
Seat 4: ehrmstyle ($39.71 in chips) 
Seat 6: Kalaboush ($6.71 in chips) 
Kalaboush: posts small blind $0.05
ehrmstyle: posts big blind $0.10
ehrmstyle: posts the ante $0.02
Kalaboush: posts the ante $0.02
*** HOLE CARDS ***
Kalaboush: calls $0.05
ehrmstyle: checks 
*** FLOP *** [Kd 5s Qs]
ehrmstyle: checks 
Kalaboush: checks 
*** TURN *** [Kd 5s Qs] [2d]
ehrmstyle: checks 
Kalaboush: checks 
*** RIVER *** [Kd 5s Qs 2d] [Ac]
ehrmstyle: checks 
Kalaboush: checks 
*** SHOW DOWN ***
ehrmstyle: shows [8s 2s] (a pair of Deuces)
Kalaboush: mucks hand 
ehrmstyle collected $0.23 from pot
*** SUMMARY ***
Total pot $0.24 | Rake $0.01 
Board [Kd 5s Qs 2d Ac]
Seat 4: ehrmstyle (big blind) showed [8s 2s] and won ($0.23) with a pair of Deuces
Seat 6: Kalaboush (button) (small blind) mucked



PokerStars Hand #201506172330:  Hold'em No Limit ($0.05/$0.10 USD) - 2019/06/18 9:08:14 ET
Table 'Moreau III' 6-max Seat #4 is the button
Seat 4: ehrmstyle ($39.82 in chips) 
Seat 6: Kalaboush ($6.59 in chips) 
ehrmstyle: posts small blind $0.05
Kalaboush: posts big blind $0.10
ehrmstyle: posts the ante $0.02
Kalaboush: posts the ante $0.02
*** HOLE CARDS ***
ehrmstyle: raises $0.20 to $0.30
Kalaboush: folds 
Uncalled bet ($0.20) returned to ehrmstyle
ehrmstyle collected $0.24 from pot
ehrmstyle: doesn't show hand 
*** SUMMARY ***
Total pot $0.24 | Rake $0 
Seat 4: ehrmstyle (button) (small blind) collected ($0.24)
Seat 6: Kalaboush (big blind) folded before Flop



PokerStars Hand #201506174966:  Hold'em No Limit ($0.05/$0.10 USD) - 2019/06/18 9:08:22 ET
Table 'Moreau III' 6-max Seat #6 is the button
Seat 4: ehrmstyle ($39.94 in chips) 
Seat 6: Kalaboush ($6.47 in chips) 
Kalaboush: posts small blind $0.05
ehrmstyle: posts big blind $0.10
ehrmstyle: posts the ante $0.02
Kalaboush: posts the ante $0.02
*** HOLE CARDS ***
Kalaboush: raises $0.24 to $0.34
ehrmstyle: calls $0.24
*** FLOP *** [2c 9c 4d]
ehrmstyle: checks 
Kalaboush: checks 
*** TURN *** [2c 9c 4d] [Ad]
ehrmstyle: checks 
Kalaboush: bets $0.30
ehrmstyle: folds 
Uncalled bet ($0.30) returned to Kalaboush
Kalaboush collected $0.69 from pot
Kalaboush: doesn't show hand 
*** SUMMARY ***
Total pot $0.72 | Rake $0.03 
Board [2c 9c 4d Ad]
Seat 4: ehrmstyle (big blind) folded on the Turn
Seat 6: Kalaboush (button) (small blind) collected ($0.69)



PokerStars Hand #201506180241:  Hold'em No Limit ($0.05/$0.10 USD) - 2019/06/18 9:08:37 ET
Table 'Moreau III' 6-max Seat #4 is the button
Seat 4: ehrmstyle ($39.58 in chips) 
Seat 6: Kalaboush ($6.80 in chips) 
ehrmstyle: posts small blind $0.05
Kalaboush: posts big blind $0.10
ehrmstyle: posts the ante $0.02
Kalaboush: posts the ante $0.02
*** HOLE CARDS ***
ehrmstyle: folds 
Uncalled bet ($0.05) returned to Kalaboush
Kalaboush collected $0.14 from pot
Kalaboush: doesn't show hand 
*** SUMMARY ***
Total pot $0.14 | Rake $0 
Seat 4: ehrmstyle (button) (small blind) folded before Flop
Seat 6: Kalaboush (big blind) collected ($0.14)



PokerStars Hand #201506182867:  Hold'em No Limit ($0.05/$0.10 USD) - 2019/06/18 9:08:45 ET
Table 'Moreau III' 6-max Seat #6 is the button
Seat 4: ehrmstyle ($39.51 in chips) 
Seat 6: Kalaboush ($6.87 in chips) 
Kalaboush: posts small blind $0.05
ehrmstyle: posts big blind $0.10
ehrmstyle: posts the ante $0.02
Kalaboush: posts the ante $0.02
*** HOLE CARDS ***
Kalaboush: raises $0.24 to $0.34
ehrmstyle: folds 
Uncalled bet ($0.24) returned to Kalaboush
Kalaboush collected $0.24 from pot
Kalaboush: doesn't show hand 
*** SUMMARY ***
Total pot $0.24 | Rake $0 
Seat 4: ehrmstyle (big blind) folded before Flop
Seat 6: Kalaboush (button) (small blind) collected ($0.24)



PokerStars Hand #201506185658:  Hold'em No Limit ($0.05/$0.10 USD) - 2019/06/18 9:08:53 ET
Table 'Moreau III' 6-max Seat #4 is the button
Seat 4: ehrmstyle ($39.39 in chips) 
Seat 6: Kalaboush ($6.99 in chips) 
ehrmstyle: posts small blind $0.05
Kalaboush: posts big blind $0.10
ehrmstyle: posts the ante $0.02
Kalaboush: posts the ante $0.02
*** HOLE CARDS ***
ehrmstyle: folds 
Uncalled bet ($0.05) returned to Kalaboush
Kalaboush collected $0.14 from pot
Kalaboush: doesn't show hand 
*** SUMMARY ***
Total pot $0.14 | Rake $0 
Seat 4: ehrmstyle (button) (small blind) folded before Flop
Seat 6: Kalaboush (big blind) collected ($0.14)



PokerStars Hand #201506189516:  Hold'em No Limit ($0.05/$0.10 USD) - 2019/06/18 9:09:04 ET
Table 'Moreau III' 6-max Seat #4 is the button
Seat 4: ehrmstyle ($39.39 in chips) 
Seat 6: Kalaboush ($6.99 in chips) 
ehrmstyle: posts small blind $0.05
Kalaboush: posts big blind $0.10
ehrmstyle: posts the ante $0.02
Kalaboush: posts the ante $0.02
*** HOLE CARDS ***
ehrmstyle: raises $0.20 to $0.30
Kalaboush: calls $0.20
*** FLOP *** [Jc 5h 2d]
Kalaboush: checks 
ehrmstyle: checks 
*** TURN *** [Jc 5h 2d] [Js]
Kalaboush: checks 
ehrmstyle: bets $0.31
Kalaboush: calls $0.31
*** RIVER *** [Jc 5h 2d Js] [Jh]
Kalaboush: bets $0.60
ehrmstyle: calls $0.60
*** SHOW DOWN ***
Kalaboush: shows [5s 6c] (a full house, Jacks full of Fives)
ehrmstyle: mucks hand 
Kalaboush collected $2.35 from pot
*** SUMMARY ***
Total pot $2.46 | Rake $0.11 
Board [Jc 5h 2d Js Jh]
Seat 4: ehrmstyle (button) (small blind) mucked
Seat 6: Kalaboush (big blind) showed [5s 6c] and won ($2.35) with a full house, Jacks full of Fives



PokerStars Hand #201506200971:  Hold'em No Limit ($0.05/$0.10 USD) - 2019/06/18 9:09:37 ET
Table 'Moreau III' 6-max Seat #6 is the button
Seat 4: ehrmstyle ($38.16 in chips) 
Seat 6: Kalaboush ($8.11 in chips) 
Kalaboush: posts small blind $0.05
ehrmstyle: posts big blind $0.10
ehrmstyle: posts the ante $0.02
Kalaboush: posts the ante $0.02
*** HOLE CARDS ***
Kalaboush: folds 
Uncalled bet ($0.05) returned to ehrmstyle
ehrmstyle collected $0.14 from pot
ehrmstyle: doesn't show hand 
*** SUMMARY ***
Total pot $0.14 | Rake $0 
Seat 4: ehrmstyle (big blind) collected ($0.14)
Seat 6: Kalaboush (button) (small blind) folded before Flop



PokerStars Hand #201506202677:  Hold'em No Limit ($0.05/$0.10 USD) - 2019/06/18 9:09:42 ET
Table 'Moreau III' 6-max Seat #4 is the button
Seat 4: ehrmstyle ($38.23 in chips) 
Seat 6: Kalaboush ($8.04 in chips) 
ehrmstyle: posts small blind $0.05
Kalaboush: posts big blind $0.10
ehrmstyle: posts the ante $0.02
Kalaboush: posts the ante $0.02
*** HOLE CARDS ***
ehrmstyle: raises $0.20 to $0.30
Kalaboush: folds 
Uncalled bet ($0.20) returned to ehrmstyle
ehrmstyle collected $0.24 from pot
ehrmstyle: doesn't show hand 
*** SUMMARY ***
Total pot $0.24 | Rake $0 
Seat 4: ehrmstyle (button) (small blind) collected ($0.24)
Seat 6: Kalaboush (big blind) folded before Flop



PokerStars Hand #201506205244:  Hold'em No Limit ($0.05/$0.10 USD) - 2019/06/18 9:09:50 ET
Table 'Moreau III' 6-max Seat #6 is the button
Seat 4: ehrmstyle ($38.35 in chips) 
Seat 6: Kalaboush ($7.92 in chips) 
Kalaboush: posts small blind $0.05
ehrmstyle: posts big blind $0.10
ehrmstyle: posts the ante $0.02
Kalaboush: posts the ante $0.02
*** HOLE CARDS ***
Kalaboush: folds 
Uncalled bet ($0.05) returned to ehrmstyle
ehrmstyle collected $0.14 from pot
ehrmstyle: doesn't show hand 
*** SUMMARY ***
Total pot $0.14 | Rake $0 
Seat 4: ehrmstyle (big blind) collected ($0.14)
Seat 6: Kalaboush (button) (small blind) folded before Flop



PokerStars Hand #201506207472:  Hold'em No Limit ($0.05/$0.10 USD) - 2019/06/18 9:09:57 ET
Table 'Moreau III' 6-max Seat #4 is the button
Seat 4: ehrmstyle ($38.42 in chips) 
Seat 6: Kalaboush ($7.85 in chips) 
ehrmstyle: posts small blind $0.05
Kalaboush: posts big blind $0.10
ehrmstyle: posts the ante $0.02
Kalaboush: posts the ante $0.02
*** HOLE CARDS ***
ehrmstyle: raises $0.20 to $0.30
Kalaboush: folds 
Uncalled bet ($0.20) returned to ehrmstyle
ehrmstyle collected $0.24 from pot
ehrmstyle: doesn't show hand 
*** SUMMARY ***
Total pot $0.24 | Rake $0 
Seat 4: ehrmstyle (button) (small blind) collected ($0.24)
Seat 6: Kalaboush (big blind) folded before Flop



PokerStars Hand #201506210391:  Hold'em No Limit ($0.05/$0.10 USD) - 2019/06/18 9:10:05 ET
Table 'Moreau III' 6-max Seat #6 is the button
Seat 4: ehrmstyle ($38.54 in chips) 
Seat 6: Kalaboush ($7.73 in chips) 
Kalaboush: posts small blind $0.05
ehrmstyle: posts big blind $0.10
ehrmstyle: posts the ante $0.02
Kalaboush: posts the ante $0.02
*** HOLE CARDS ***
Kalaboush: folds 
Uncalled bet ($0.05) returned to ehrmstyle
ehrmstyle collected $0.14 from pot
ehrmstyle: doesn't show hand 
*** SUMMARY ***
Total pot $0.14 | Rake $0 
Seat 4: ehrmstyle (big blind) collected ($0.14)
Seat 6: Kalaboush (button) (small blind) folded before Flop



PokerStars Hand #201506212249:  Hold'em No Limit ($0.05/$0.10 USD) - 2019/06/18 9:10:10 ET
Table 'Moreau III' 6-max Seat #4 is the button
Seat 4: ehrmstyle ($38.61 in chips) 
Seat 6: Kalaboush ($7.66 in chips) 
ehrmstyle: posts small blind $0.05
Kalaboush: posts big blind $0.10
ehrmstyle: posts the ante $0.02
Kalaboush: posts the ante $0.02
*** HOLE CARDS ***
ehrmstyle: folds 
Uncalled bet ($0.05) returned to Kalaboush
Kalaboush collected $0.14 from pot
Kalaboush: doesn't show hand 
*** SUMMARY ***
Total pot $0.14 | Rake $0 
Seat 4: ehrmstyle (button) (small blind) folded before Flop
Seat 6: Kalaboush (big blind) collected ($0.14)



PokerStars Hand #201506214730:  Hold'em No Limit ($0.05/$0.10 USD) - 2019/06/18 9:10:17 ET
Table 'Moreau III' 6-max Seat #6 is the button
Seat 4: ehrmstyle ($38.54 in chips) 
Seat 6: Kalaboush ($7.73 in chips) 
Kalaboush: posts small blind $0.05
ehrmstyle: posts big blind $0.10
ehrmstyle: posts the ante $0.02
Kalaboush: posts the ante $0.02
*** HOLE CARDS ***
Kalaboush: raises $0.24 to $0.34
ehrmstyle: folds 
Uncalled bet ($0.24) returned to Kalaboush
Kalaboush collected $0.24 from pot
Kalaboush: doesn't show hand 
*** SUMMARY ***
Total pot $0.24 | Rake $0 
Seat 4: ehrmstyle (big blind) folded before Flop
Seat 6: Kalaboush (button) (small blind) collected ($0.24)



PokerStars Hand #201506218634:  Hold'em No Limit ($0.05/$0.10 USD) - 2019/06/18 9:10:29 ET
Table 'Moreau III' 6-max Seat #4 is the button
Seat 4: ehrmstyle ($38.42 in chips) 
Seat 6: Kalaboush ($7.85 in chips) 
ehrmstyle: posts small blind $0.05
Kalaboush: posts big blind $0.10
ehrmstyle: posts the ante $0.02
Kalaboush: posts the ante $0.02
*** HOLE CARDS ***
ehrmstyle: raises $0.20 to $0.30
Kalaboush: folds 
Uncalled bet ($0.20) returned to ehrmstyle
ehrmstyle collected $0.24 from pot
ehrmstyle: doesn't show hand 
*** SUMMARY ***
Total pot $0.24 | Rake $0 
Seat 4: ehrmstyle (button) (small blind) collected ($0.24)
Seat 6: Kalaboush (big blind) folded before Flop



PokerStars Hand #201506221393:  Hold'em No Limit ($0.05/$0.10 USD) - 2019/06/18 9:10:37 ET
Table 'Moreau III' 6-max Seat #6 is the button
Seat 4: ehrmstyle ($38.54 in chips) 
Seat 6: Kalaboush ($7.73 in chips) 
Kalaboush: posts small blind $0.05
ehrmstyle: posts big blind $0.10
ehrmstyle: posts the ante $0.02
Kalaboush: posts the ante $0.02
*** HOLE CARDS ***
Kalaboush: folds 
Uncalled bet ($0.05) returned to ehrmstyle
ehrmstyle collected $0.14 from pot
ehrmstyle: doesn't show hand 
*** SUMMARY ***
Total pot $0.14 | Rake $0 
Seat 4: ehrmstyle (big blind) collected ($0.14)
Seat 6: Kalaboush (button) (small blind) folded before Flop



PokerStars Hand #201506223050:  Hold'em No Limit ($0.05/$0.10 USD) - 2019/06/18 9:10:42 ET
Table 'Moreau III' 6-max Seat #4 is the button
Seat 4: ehrmstyle ($38.61 in chips) 
Seat 6: Kalaboush ($7.66 in chips) 
ehrmstyle: posts small blind $0.05
Kalaboush: posts big blind $0.10
ehrmstyle: posts the ante $0.02
Kalaboush: posts the ante $0.02
*** HOLE CARDS ***
ehrmstyle: raises $0.20 to $0.30
Kalaboush: folds 
Uncalled bet ($0.20) returned to ehrmstyle
ehrmstyle collected $0.24 from pot
ehrmstyle: doesn't show hand 
*** SUMMARY ***
Total pot $0.24 | Rake $0 
Seat 4: ehrmstyle (button) (small blind) collected ($0.24)
Seat 6: Kalaboush (big blind) folded before Flop



PokerStars Hand #201506225421:  Hold'em No Limit ($0.05/$0.10 USD) - 2019/06/18 9:10:48 ET
Table 'Moreau III' 6-max Seat #6 is the button
Seat 4: ehrmstyle ($38.73 in chips) 
Seat 6: Kalaboush ($7.54 in chips) 
Kalaboush: posts small blind $0.05
ehrmstyle: posts big blind $0.10
ehrmstyle: posts the ante $0.02
Kalaboush: posts the ante $0.02
*** HOLE CARDS ***
Kalaboush: raises $0.20 to $0.30
ehrmstyle: calls $0.20
*** FLOP *** [7c Qh Jh]
ehrmstyle: checks 
Kalaboush: checks 
*** TURN *** [7c Qh Jh] [Kh]
ehrmstyle: checks 
Kalaboush: checks 
*** RIVER *** [7c Qh Jh Kh] [Qs]
ehrmstyle: checks 
Kalaboush: checks 
*** SHOW DOWN ***
ehrmstyle: shows [Ah 4c] (a pair of Queens)
Kalaboush: mucks hand 
ehrmstyle collected $0.61 from pot
*** SUMMARY ***
Total pot $0.64 | Rake $0.03 
Board [7c Qh Jh Kh Qs]
Seat 4: ehrmstyle (big blind) showed [Ah 4c] and won ($0.61) with a pair of Queens
Seat 6: Kalaboush (button) (small blind) mucked



PokerStars Hand #201506231462:  Hold'em No Limit ($0.05/$0.10 USD) - 2019/06/18 9:11:06 ET
Table 'Moreau III' 6-max Seat #4 is the button
Seat 4: ehrmstyle ($39.02 in chips) 
Seat 6: Kalaboush ($7.22 in chips) 
ehrmstyle: posts small blind $0.05
Kalaboush: posts big blind $0.10
ehrmstyle: posts the ante $0.02
Kalaboush: posts the ante $0.02
*** HOLE CARDS ***
ehrmstyle: raises $0.20 to $0.30
Kalaboush: folds 
Uncalled bet ($0.20) returned to ehrmstyle
ehrmstyle collected $0.24 from pot
ehrmstyle: doesn't show hand 
*** SUMMARY ***
Total pot $0.24 | Rake $0 
Seat 4: ehrmstyle (button) (small blind) collected ($0.24)
Seat 6: Kalaboush (big blind) folded before Flop



PokerStars Hand #201506234420:  Hold'em No Limit ($0.05/$0.10 USD) - 2019/06/18 9:11:15 ET
Table 'Moreau III' 6-max Seat #6 is the button
Seat 4: ehrmstyle ($39.14 in chips) 
Seat 6: Kalaboush ($7.10 in chips) 
Kalaboush: posts small blind $0.05
ehrmstyle: posts big blind $0.10
ehrmstyle: posts the ante $0.02
Kalaboush: posts the ante $0.02
*** HOLE CARDS ***
Kalaboush: raises $0.20 to $0.30
ehrmstyle: calls $0.20
*** FLOP *** [2d 9s 4d]
ehrmstyle: checks 
Kalaboush: bets $0.30
ehrmstyle: folds 
Uncalled bet ($0.30) returned to Kalaboush
Kalaboush collected $0.61 from pot
Kalaboush: doesn't show hand 
*** SUMMARY ***
Total pot $0.64 | Rake $0.03 
Board [2d 9s 4d]
Seat 4: ehrmstyle (big blind) folded on the Flop
Seat 6: Kalaboush (button) (small blind) collected ($0.61)



PokerStars Hand #201506239361:  Hold'em No Limit ($0.05/$0.10 USD) - 2019/06/18 9:11:29 ET
Table 'Moreau III' 6-max Seat #4 is the button
Seat 4: ehrmstyle ($38.82 in chips) 
Seat 6: Kalaboush ($7.39 in chips) 
ehrmstyle: posts small blind $0.05
Kalaboush: posts big blind $0.10
ehrmstyle: posts the ante $0.02
Kalaboush: posts the ante $0.02
*** HOLE CARDS ***
ehrmstyle: raises $0.20 to $0.30
Kalaboush: folds 
Uncalled bet ($0.20) returned to ehrmstyle
ehrmstyle collected $0.24 from pot
ehrmstyle: doesn't show hand 
*** SUMMARY ***
Total pot $0.24 | Rake $0 
Seat 4: ehrmstyle (button) (small blind) collected ($0.24)
Seat 6: Kalaboush (big blind) folded before Flop



PokerStars Hand #201506243313:  Hold'em No Limit ($0.05/$0.10 USD) - 2019/06/18 9:11:41 ET
Table 'Moreau III' 6-max Seat #6 is the button
Seat 4: ehrmstyle ($38.94 in chips) 
Seat 6: Kalaboush ($7.27 in chips) 
Kalaboush: posts small blind $0.05
ehrmstyle: posts big blind $0.10
ehrmstyle: posts the ante $0.02
Kalaboush: posts the ante $0.02
*** HOLE CARDS ***
Kalaboush: folds 
Uncalled bet ($0.05) returned to ehrmstyle
ehrmstyle collected $0.14 from pot
ehrmstyle: doesn't show hand 
*** SUMMARY ***
Total pot $0.14 | Rake $0 
Seat 4: ehrmstyle (big blind) collected ($0.14)
Seat 6: Kalaboush (button) (small blind) folded before Flop



PokerStars Hand #201506245178:  Hold'em No Limit ($0.05/$0.10 USD) - 2019/06/18 9:11:46 ET
Table 'Moreau III' 6-max Seat #4 is the button
Seat 4: ehrmstyle ($39.01 in chips) 
Seat 6: Kalaboush ($7.20 in chips) 
ehrmstyle: posts small blind $0.05
Kalaboush: posts big blind $0.10
ehrmstyle: posts the ante $0.02
Kalaboush: posts the ante $0.02
*** HOLE CARDS ***
ehrmstyle: raises $0.20 to $0.30
Kalaboush: folds 
Uncalled bet ($0.20) returned to ehrmstyle
ehrmstyle collected $0.24 from pot
ehrmstyle: doesn't show hand 
*** SUMMARY ***
Total pot $0.24 | Rake $0 
Seat 4: ehrmstyle (button) (small blind) collected ($0.24)
Seat 6: Kalaboush (big blind) folded before Flop



PokerStars Hand #201506247773:  Hold'em No Limit ($0.05/$0.10 USD) - 2019/06/18 9:11:54 ET
Table 'Moreau III' 6-max Seat #6 is the button
Seat 4: ehrmstyle ($39.13 in chips) 
Seat 6: Kalaboush ($7.08 in chips) 
Kalaboush: posts small blind $0.05
ehrmstyle: posts big blind $0.10
ehrmstyle: posts the ante $0.02
Kalaboush: posts the ante $0.02
*** HOLE CARDS ***
Kalaboush: raises $0.10 to $0.20
ehrmstyle: calls $0.10
*** FLOP *** [4h 3c Tc]
ehrmstyle: checks 
Kalaboush: checks 
*** TURN *** [4h 3c Tc] [3s]
ehrmstyle: bets $0.21
Kalaboush: folds 
Uncalled bet ($0.21) returned to ehrmstyle
ehrmstyle collected $0.42 from pot
ehrmstyle: doesn't show hand 
*** SUMMARY ***
Total pot $0.44 | Rake $0.02 
Board [4h 3c Tc 3s]
Seat 4: ehrmstyle (big blind) collected ($0.42)
Seat 6: Kalaboush (button) (small blind) folded on the Turn



PokerStars Hand #201506254483:  Hold'em No Limit ($0.05/$0.10 USD) - 2019/06/18 9:12:13 ET
Table 'Moreau III' 6-max Seat #4 is the button
Seat 4: ehrmstyle ($39.33 in chips) 
Seat 6: Kalaboush ($6.86 in chips) 
ehrmstyle: posts small blind $0.05
Kalaboush: posts big blind $0.10
ehrmstyle: posts the ante $0.02
Kalaboush: posts the ante $0.02
*** HOLE CARDS ***
ehrmstyle: raises $0.20 to $0.30
Kalaboush: calls $0.20
*** FLOP *** [Jc 2c Ad]
Kalaboush: checks 
ehrmstyle: bets $0.31
Kalaboush: calls $0.31
*** TURN *** [Jc 2c Ad] [9d]
Kalaboush: checks 
ehrmstyle: bets $0.80
Kalaboush: calls $0.80
*** RIVER *** [Jc 2c Ad 9d] [Kc]
Kalaboush: bets $1.40
ehrmstyle: raises $5.53 to $6.93
Kalaboush: calls $4.03 and is all-in
Uncalled bet ($1.50) returned to ehrmstyle
*** SHOW DOWN ***
ehrmstyle: shows [Ah Js] (two pair, Aces and Jacks)
Kalaboush: shows [8c Tc] (a flush, King high)
Kalaboush collected $13.22 from pot
*** SUMMARY ***
Total pot $13.72 | Rake $0.50 
Board [Jc 2c Ad 9d Kc]
Seat 4: ehrmstyle (button) (small blind) showed [Ah Js] and lost with two pair, Aces and Jacks
Seat 6: Kalaboush (big blind) showed [8c Tc] and won ($13.22) with a flush, King high



PokerStars Hand #201506265716:  Hold'em No Limit ($0.05/$0.10 USD) - 2019/06/18 9:12:46 ET
Table 'Moreau III' 6-max Seat #6 is the button
Seat 4: ehrmstyle ($32.47 in chips) 
Seat 6: Kalaboush ($13.22 in chips) 
Kalaboush: posts small blind $0.05
ehrmstyle: posts big blind $0.10
ehrmstyle: posts the ante $0.02
Kalaboush: posts the ante $0.02
*** HOLE CARDS ***
Kalaboush: raises $0.10 to $0.20
ehrmstyle: calls $0.10
*** FLOP *** [Js 7c Ad]
ehrmstyle: checks 
Kalaboush: bets $0.20
ehrmstyle: folds 
Uncalled bet ($0.20) returned to Kalaboush
Kalaboush collected $0.42 from pot
Kalaboush: doesn't show hand 
*** SUMMARY ***
Total pot $0.44 | Rake $0.02 
Board [Js 7c Ad]
Seat 4: ehrmstyle (big blind) folded on the Flop
Seat 6: Kalaboush (button) (small blind) collected ($0.42)



PokerStars Hand #201506271965:  Hold'em No Limit ($0.05/$0.10 USD) - 2019/06/18 9:13:04 ET
Table 'Moreau III' 6-max Seat #4 is the button
Seat 4: ehrmstyle ($32.25 in chips) 
Seat 6: Kalaboush ($13.42 in chips) 
ehrmstyle: posts small blind $0.05
Kalaboush: posts big blind $0.10
ehrmstyle: posts the ante $0.02
Kalaboush: posts the ante $0.02
*** HOLE CARDS ***
ehrmstyle: raises $0.20 to $0.30
Kalaboush: folds 
Uncalled bet ($0.20) returned to ehrmstyle
ehrmstyle collected $0.24 from pot
ehrmstyle: doesn't show hand 
*** SUMMARY ***
Total pot $0.24 | Rake $0 
Seat 4: ehrmstyle (button) (small blind) collected ($0.24)
Seat 6: Kalaboush (big blind) folded before Flop



PokerStars Hand #201506274551:  Hold'em No Limit ($0.05/$0.10 USD) - 2019/06/18 9:13:12 ET
Table 'Moreau III' 6-max Seat #6 is the button
Seat 4: ehrmstyle ($32.37 in chips) 
Seat 6: Kalaboush ($13.30 in chips) 
Kalaboush: posts small blind $0.05
ehrmstyle: posts big blind $0.10
ehrmstyle: posts the ante $0.02
Kalaboush: posts the ante $0.02
*** HOLE CARDS ***
Kalaboush: folds 
Uncalled bet ($0.05) returned to ehrmstyle
ehrmstyle collected $0.14 from pot
ehrmstyle: doesn't show hand 
*** SUMMARY ***
Total pot $0.14 | Rake $0 
Seat 4: ehrmstyle (big blind) collected ($0.14)
Seat 6: Kalaboush (button) (small blind) folded before Flop



PokerStars Hand #201506276234:  Hold'em No Limit ($0.05/$0.10 USD) - 2019/06/18 9:13:17 ET
Table 'Moreau III' 6-max Seat #4 is the button
Seat 4: ehrmstyle ($32.44 in chips) 
Seat 6: Kalaboush ($13.23 in chips) 
ehrmstyle: posts small blind $0.05
Kalaboush: posts big blind $0.10
ehrmstyle: posts the ante $0.02
Kalaboush: posts the ante $0.02
*** HOLE CARDS ***
ehrmstyle: raises $0.20 to $0.30
Kalaboush: folds 
Uncalled bet ($0.20) returned to ehrmstyle
ehrmstyle collected $0.24 from pot
ehrmstyle: doesn't show hand 
*** SUMMARY ***
Total pot $0.24 | Rake $0 
Seat 4: ehrmstyle (button) (small blind) collected ($0.24)
Seat 6: Kalaboush (big blind) folded before Flop



PokerStars Hand #201506279652:  Hold'em No Limit ($0.05/$0.10 USD) - 2019/06/18 9:13:27 ET
Table 'Moreau III' 6-max Seat #6 is the button
Seat 4: ehrmstyle ($32.56 in chips) 
Seat 6: Kalaboush ($13.11 in chips) 
Kalaboush: posts small blind $0.05
ehrmstyle: posts big blind $0.10
ehrmstyle: posts the ante $0.02
Kalaboush: posts the ante $0.02
*** HOLE CARDS ***
Kalaboush: raises $0.20 to $0.30
ehrmstyle: calls $0.20
*** FLOP *** [5c Kh 3s]
ehrmstyle: checks 
Kalaboush: bets $0.30
ehrmstyle: folds 
Uncalled bet ($0.30) returned to Kalaboush
Kalaboush collected $0.61 from pot
Kalaboush: doesn't show hand 
*** SUMMARY ***
Total pot $0.64 | Rake $0.03 
Board [5c Kh 3s]
Seat 4: ehrmstyle (big blind) folded on the Flop
Seat 6: Kalaboush (button) (small blind) collected ($0.61)



PokerStars Hand #201506285292:  Hold'em No Limit ($0.05/$0.10 USD) - 2019/06/18 9:13:43 ET
Table 'Moreau III' 6-max Seat #4 is the button
Seat 4: ehrmstyle ($32.24 in chips) 
Seat 6: Kalaboush ($13.40 in chips) 
ehrmstyle: posts small blind $0.05
Kalaboush: posts big blind $0.10
ehrmstyle: posts the ante $0.02
Kalaboush: posts the ante $0.02
*** HOLE CARDS ***
ehrmstyle: raises $0.20 to $0.30
Kalaboush: folds 
Uncalled bet ($0.20) returned to ehrmstyle
ehrmstyle collected $0.24 from pot
ehrmstyle: doesn't show hand 
*** SUMMARY ***
Total pot $0.24 | Rake $0 
Seat 4: ehrmstyle (button) (small blind) collected ($0.24)
Seat 6: Kalaboush (big blind) folded before Flop



PokerStars Hand #201506287742:  Hold'em No Limit ($0.05/$0.10 USD) - 2019/06/18 9:13:50 ET
Table 'Moreau III' 6-max Seat #6 is the button
Seat 4: ehrmstyle ($32.36 in chips) 
Seat 6: Kalaboush ($13.28 in chips) 
Kalaboush: posts small blind $0.05
ehrmstyle: posts big blind $0.10
ehrmstyle: posts the ante $0.02
Kalaboush: posts the ante $0.02
*** HOLE CARDS ***
Kalaboush: folds 
Uncalled bet ($0.05) returned to ehrmstyle
ehrmstyle collected $0.14 from pot
ehrmstyle: doesn't show hand 
*** SUMMARY ***
Total pot $0.14 | Rake $0 
Seat 4: ehrmstyle (big blind) collected ($0.14)
Seat 6: Kalaboush (button) (small blind) folded before Flop



PokerStars Hand #201506289460:  Hold'em No Limit ($0.05/$0.10 USD) - 2019/06/18 9:13:55 ET
Table 'Moreau III' 6-max Seat #4 is the button
Seat 4: ehrmstyle ($32.43 in chips) 
Seat 6: Kalaboush ($13.21 in chips) 
ehrmstyle: posts small blind $0.05
Kalaboush: posts big blind $0.10
ehrmstyle: posts the ante $0.02
Kalaboush: posts the ante $0.02
*** HOLE CARDS ***
ehrmstyle: raises $0.20 to $0.30
Kalaboush: raises $0.64 to $0.94
ehrmstyle: calls $0.64
*** FLOP *** [Kd 3c 8s]
Kalaboush: bets $1.80
ehrmstyle: folds 
Uncalled bet ($1.80) returned to Kalaboush
Kalaboush collected $1.83 from pot
Kalaboush: doesn't show hand 
*** SUMMARY ***
Total pot $1.92 | Rake $0.09 
Board [Kd 3c 8s]
Seat 4: ehrmstyle (button) (small blind) folded on the Flop
Seat 6: Kalaboush (big blind) collected ($1.83)



PokerStars Hand #201506295093:  Hold'em No Limit ($0.05/$0.10 USD) - 2019/06/18 9:14:11 ET
Table 'Moreau III' 6-max Seat #6 is the button
Seat 4: ehrmstyle ($31.47 in chips) 
Seat 6: Kalaboush ($14.08 in chips) 
Kalaboush: posts small blind $0.05
ehrmstyle: posts big blind $0.10
ehrmstyle: posts the ante $0.02
Kalaboush: posts the ante $0.02
*** HOLE CARDS ***
Kalaboush: folds 
Uncalled bet ($0.05) returned to ehrmstyle
ehrmstyle collected $0.14 from pot
ehrmstyle: doesn't show hand 
*** SUMMARY ***
Total pot $0.14 | Rake $0 
Seat 4: ehrmstyle (big blind) collected ($0.14)
Seat 6: Kalaboush (button) (small blind) folded before Flop



PokerStars Hand #201506296876:  Hold'em No Limit ($0.05/$0.10 USD) - 2019/06/18 9:14:17 ET
Table 'Moreau III' 6-max Seat #4 is the button
Seat 4: ehrmstyle ($31.54 in chips) 
Seat 6: Kalaboush ($14.01 in chips) 
ehrmstyle: posts small blind $0.05
Kalaboush: posts big blind $0.10
ehrmstyle: posts the ante $0.02
Kalaboush: posts the ante $0.02
*** HOLE CARDS ***
ehrmstyle: raises $0.20 to $0.30
Kalaboush: calls $0.20
*** FLOP *** [6d 8h 6c]
Kalaboush: checks 
ehrmstyle: bets $0.31
Kalaboush: folds 
Uncalled bet ($0.31) returned to ehrmstyle
ehrmstyle collected $0.61 from pot
ehrmstyle: doesn't show hand 
*** SUMMARY ***
Total pot $0.64 | Rake $0.03 
Board [6d 8h 6c]
Seat 4: ehrmstyle (button) (small blind) collected ($0.61)
Seat 6: Kalaboush (big blind) folded on the Flop



PokerStars Hand #201506302041:  Hold'em No Limit ($0.05/$0.10 USD) - 2019/06/18 9:14:32 ET
Table 'Moreau III' 6-max Seat #6 is the button
Seat 4: ehrmstyle ($31.83 in chips) 
Seat 6: Kalaboush ($13.69 in chips) 
Kalaboush: posts small blind $0.05
ehrmstyle: posts big blind $0.10
ehrmstyle: posts the ante $0.02
Kalaboush: posts the ante $0.02
*** HOLE CARDS ***
Kalaboush: folds 
Uncalled bet ($0.05) returned to ehrmstyle
ehrmstyle collected $0.14 from pot
ehrmstyle: doesn't show hand 
*** SUMMARY ***
Total pot $0.14 | Rake $0 
Seat 4: ehrmstyle (big blind) collected ($0.14)
Seat 6: Kalaboush (button) (small blind) folded before Flop



PokerStars Hand #201506303780:  Hold'em No Limit ($0.05/$0.10 USD) - 2019/06/18 9:14:37 ET
Table 'Moreau III' 6-max Seat #4 is the button
Seat 4: ehrmstyle ($31.90 in chips) 
Seat 6: Kalaboush ($13.62 in chips) 
ehrmstyle: posts small blind $0.05
Kalaboush: posts big blind $0.10
ehrmstyle: posts the ante $0.02
Kalaboush: posts the ante $0.02
*** HOLE CARDS ***
ehrmstyle: raises $0.20 to $0.30
Kalaboush: folds 
Uncalled bet ($0.20) returned to ehrmstyle
ehrmstyle collected $0.24 from pot
ehrmstyle: doesn't show hand 
*** SUMMARY ***
Total pot $0.24 | Rake $0 
Seat 4: ehrmstyle (button) (small blind) collected ($0.24)
Seat 6: Kalaboush (big blind) folded before Flop



PokerStars Hand #201506306159:  Hold'em No Limit ($0.05/$0.10 USD) - 2019/06/18 9:14:44 ET
Table 'Moreau III' 6-max Seat #6 is the button
Seat 4: ehrmstyle ($32.02 in chips) 
Seat 6: Kalaboush ($13.50 in chips) 
Kalaboush: posts small blind $0.05
ehrmstyle: posts big blind $0.10
ehrmstyle: posts the ante $0.02
Kalaboush: posts the ante $0.02
*** HOLE CARDS ***
Kalaboush: raises $0.20 to $0.30
ehrmstyle: calls $0.20
*** FLOP *** [7h 5d 8c]
ehrmstyle: checks 
Kalaboush: bets $0.30
ehrmstyle: folds 
Uncalled bet ($0.30) returned to Kalaboush
Kalaboush collected $0.61 from pot
Kalaboush: doesn't show hand 
*** SUMMARY ***
Total pot $0.64 | Rake $0.03 
Board [7h 5d 8c]
Seat 4: ehrmstyle (big blind) folded on the Flop
Seat 6: Kalaboush (button) (small blind) collected ($0.61)



PokerStars Hand #201506311415:  Hold'em No Limit ($0.05/$0.10 USD) - 2019/06/18 9:14:58 ET
Table 'Moreau III' 6-max Seat #4 is the button
Seat 4: ehrmstyle ($31.70 in chips) 
Seat 6: Kalaboush ($13.79 in chips) 
ehrmstyle: posts small blind $0.05
Kalaboush: posts big blind $0.10
ehrmstyle: posts the ante $0.02
Kalaboush: posts the ante $0.02
*** HOLE CARDS ***
ehrmstyle: raises $0.20 to $0.30
Kalaboush: calls $0.20
*** FLOP *** [Td 5c 2c]
Kalaboush: checks 
ehrmstyle: checks 
*** TURN *** [Td 5c 2c] [3h]
Kalaboush: bets $0.30
ehrmstyle: folds 
Uncalled bet ($0.30) returned to Kalaboush
Kalaboush collected $0.61 from pot
Kalaboush: doesn't show hand 
*** SUMMARY ***
Total pot $0.64 | Rake $0.03 
Board [Td 5c 2c 3h]
Seat 4: ehrmstyle (button) (small blind) folded on the Turn
Seat 6: Kalaboush (big blind) collected ($0.61)



PokerStars Hand #201506320435:  Hold'em No Limit ($0.05/$0.10 USD) - 2019/06/18 9:15:25 ET
Table 'Moreau III' 6-max Seat #6 is the button
Seat 4: ehrmstyle ($31.38 in chips) 
Seat 6: Kalaboush ($14.08 in chips) 
Kalaboush: posts small blind $0.05
ehrmstyle: posts big blind $0.10
ehrmstyle: posts the ante $0.02
Kalaboush: posts the ante $0.02
*** HOLE CARDS ***
Kalaboush: raises $0.20 to $0.30
ehrmstyle: calls $0.20
*** FLOP *** [6d Jc 4h]
ehrmstyle: bets $0.31
Kalaboush: calls $0.31
*** TURN *** [6d Jc 4h] [Jh]
ehrmstyle: bets $0.60
Kalaboush: folds 
Uncalled bet ($0.60) returned to ehrmstyle
ehrmstyle collected $1.20 from pot
ehrmstyle: doesn't show hand 
*** SUMMARY ***
Total pot $1.26 | Rake $0.06 
Board [6d Jc 4h Jh]
Seat 4: ehrmstyle (big blind) collected ($1.20)
Seat 6: Kalaboush (button) (small blind) folded on the Turn



PokerStars Hand #201506326428:  Hold'em No Limit ($0.05/$0.10 USD) - 2019/06/18 9:15:42 ET
Table 'Moreau III' 6-max Seat #4 is the button
Seat 4: ehrmstyle ($31.95 in chips) 
Seat 6: Kalaboush ($13.45 in chips) 
ehrmstyle: posts small blind $0.05
Kalaboush: posts big blind $0.10
ehrmstyle: posts the ante $0.02
Kalaboush: posts the ante $0.02
*** HOLE CARDS ***
ehrmstyle: raises $0.20 to $0.30
Kalaboush: calls $0.20
*** FLOP *** [Ts Th Ac]
Kalaboush: checks 
ehrmstyle: checks 
*** TURN *** [Ts Th Ac] [Qc]
Kalaboush: checks 
ehrmstyle: checks 
*** RIVER *** [Ts Th Ac Qc] [6h]
Kalaboush: bets $0.10
ehrmstyle: folds 
Uncalled bet ($0.10) returned to Kalaboush
Kalaboush collected $0.61 from pot
Kalaboush: doesn't show hand 
*** SUMMARY ***
Total pot $0.64 | Rake $0.03 
Board [Ts Th Ac Qc 6h]
Seat 4: ehrmstyle (button) (small blind) folded on the River
Seat 6: Kalaboush (big blind) collected ($0.61)



PokerStars Hand #201506342220:  Hold'em No Limit ($0.05/$0.10 USD) - 2019/06/18 9:16:28 ET
Table 'Moreau III' 6-max Seat #6 is the button
Seat 4: ehrmstyle ($31.63 in chips) 
Seat 6: Kalaboush ($13.74 in chips) 
Kalaboush: posts small blind $0.05
ehrmstyle: posts big blind $0.10
ehrmstyle: posts the ante $0.02
Kalaboush: posts the ante $0.02
*** HOLE CARDS ***
Kalaboush: raises $0.20 to $0.30
ehrmstyle: calls $0.20
*** FLOP *** [Qc 2d Qs]
ehrmstyle: checks 
Kalaboush: bets $0.30
ehrmstyle: folds 
Uncalled bet ($0.30) returned to Kalaboush
Kalaboush collected $0.61 from pot
Kalaboush: doesn't show hand 
*** SUMMARY ***
Total pot $0.64 | Rake $0.03 
Board [Qc 2d Qs]
Seat 4: ehrmstyle (big blind) folded on the Flop
Seat 6: Kalaboush (button) (small blind) collected ($0.61)



PokerStars Hand #201506352585:  Hold'em No Limit ($0.05/$0.10 USD) - 2019/06/18 9:16:58 ET
Table 'Moreau III' 6-max Seat #4 is the button
Seat 4: ehrmstyle ($31.31 in chips) 
Seat 6: Kalaboush ($14.03 in chips) 
ehrmstyle: posts small blind $0.05
Kalaboush: posts big blind $0.10
ehrmstyle: posts the ante $0.02
Kalaboush: posts the ante $0.02
*** HOLE CARDS ***
ehrmstyle: raises $0.20 to $0.30
Kalaboush: folds 
Uncalled bet ($0.20) returned to ehrmstyle
ehrmstyle collected $0.24 from pot
ehrmstyle: doesn't show hand 
*** SUMMARY ***
Total pot $0.24 | Rake $0 
Seat 4: ehrmstyle (button) (small blind) collected ($0.24)
Seat 6: Kalaboush (big blind) folded before Flop



PokerStars Hand #201506356152:  Hold'em No Limit ($0.05/$0.10 USD) - 2019/06/18 9:17:08 ET
Table 'Moreau III' 6-max Seat #6 is the button
Seat 4: ehrmstyle ($31.43 in chips) 
Seat 6: Kalaboush ($13.91 in chips) 
Kalaboush: posts small blind $0.05
ehrmstyle: posts big blind $0.10
ehrmstyle: posts the ante $0.02
Kalaboush: posts the ante $0.02
*** HOLE CARDS ***
Kalaboush: raises $0.20 to $0.30
ehrmstyle: folds 
Uncalled bet ($0.20) returned to Kalaboush
Kalaboush collected $0.24 from pot
Kalaboush: doesn't show hand 
*** SUMMARY ***
Total pot $0.24 | Rake $0 
Seat 4: ehrmstyle (big blind) folded before Flop
Seat 6: Kalaboush (button) (small blind) collected ($0.24)



PokerStars Hand #201506361366:  Hold'em No Limit ($0.05/$0.10 USD) - 2019/06/18 9:17:23 ET
Table 'Moreau III' 6-max Seat #4 is the button
Seat 4: ehrmstyle ($31.31 in chips) 
Seat 6: Kalaboush ($14.03 in chips) 
ehrmstyle: posts small blind $0.05
Kalaboush: posts big blind $0.10
ehrmstyle: posts the ante $0.02
Kalaboush: posts the ante $0.02
*** HOLE CARDS ***
ehrmstyle: calls $0.05
Kalaboush: checks 
*** FLOP *** [3h 2d Js]
Kalaboush: checks 
ehrmstyle: checks 
*** TURN *** [3h 2d Js] [8c]
Kalaboush: checks 
ehrmstyle: checks 
*** RIVER *** [3h 2d Js 8c] [6h]
Kalaboush: checks 
ehrmstyle: checks 
*** SHOW DOWN ***
Kalaboush: shows [Ks 5d] (high card King)
ehrmstyle: mucks hand 
Kalaboush collected $0.23 from pot
*** SUMMARY ***
Total pot $0.24 | Rake $0.01 
Board [3h 2d Js 8c 6h]
Seat 4: ehrmstyle (button) (small blind) mucked
Seat 6: Kalaboush (big blind) showed [Ks 5d] and won ($0.23) with high card King



PokerStars Hand #201506370487:  Hold'em No Limit ($0.05/$0.10 USD) - 2019/06/18 9:17:49 ET
Table 'Moreau III' 6-max Seat #6 is the button
Seat 4: ehrmstyle ($31.19 in chips) 
Seat 6: Kalaboush ($14.14 in chips) 
Kalaboush: posts small blind $0.05
ehrmstyle: posts big blind $0.10
ehrmstyle: posts the ante $0.02
Kalaboush: posts the ante $0.02
*** HOLE CARDS ***
Kalaboush: folds 
Uncalled bet ($0.05) returned to ehrmstyle
ehrmstyle collected $0.14 from pot
ehrmstyle: doesn't show hand 
*** SUMMARY ***
Total pot $0.14 | Rake $0 
Seat 4: ehrmstyle (big blind) collected ($0.14)
Seat 6: Kalaboush (button) (small blind) folded before Flop



PokerStars Hand #201506372320:  Hold'em No Limit ($0.05/$0.10 USD) - 2019/06/18 9:17:54 ET
Table 'Moreau III' 6-max Seat #4 is the button
Seat 4: ehrmstyle ($31.26 in chips) 
Seat 6: Kalaboush ($14.07 in chips) 
ehrmstyle: posts small blind $0.05
Kalaboush: posts big blind $0.10
ehrmstyle: posts the ante $0.02
Kalaboush: posts the ante $0.02
*** HOLE CARDS ***
ehrmstyle: raises $0.20 to $0.30
Kalaboush: raises $0.64 to $0.94
ehrmstyle: calls $0.64
*** FLOP *** [7h 4s 2h]
Kalaboush: bets $0.30
ehrmstyle: folds 
Uncalled bet ($0.30) returned to Kalaboush
Kalaboush collected $1.83 from pot
Kalaboush: doesn't show hand 
*** SUMMARY ***
Total pot $1.92 | Rake $0.09 
Board [7h 4s 2h]
Seat 4: ehrmstyle (button) (small blind) folded on the Flop
Seat 6: Kalaboush (big blind) collected ($1.83)



PokerStars Hand #201506383860:  Hold'em No Limit ($0.05/$0.10 USD) - 2019/06/18 9:18:27 ET
Table 'Moreau III' 6-max Seat #6 is the button
Seat 4: ehrmstyle ($30.30 in chips) 
Seat 6: Kalaboush ($14.94 in chips) 
Kalaboush: posts small blind $0.05
ehrmstyle: posts big blind $0.10
ehrmstyle: posts the ante $0.02
Kalaboush: posts the ante $0.02
*** HOLE CARDS ***
Kalaboush: raises $0.10 to $0.20
ehrmstyle: calls $0.10
*** FLOP *** [9d 3c 2h]
ehrmstyle: bets $0.21
Kalaboush: folds 
Uncalled bet ($0.21) returned to ehrmstyle
ehrmstyle collected $0.42 from pot
ehrmstyle: doesn't show hand 
*** SUMMARY ***
Total pot $0.44 | Rake $0.02 
Board [9d 3c 2h]
Seat 4: ehrmstyle (big blind) collected ($0.42)
Seat 6: Kalaboush (button) (small blind) folded on the Flop



PokerStars Hand #201506390848:  Hold'em No Limit ($0.05/$0.10 USD) - 2019/06/18 9:18:47 ET
Table 'Moreau III' 6-max Seat #4 is the button
Seat 4: ehrmstyle ($30.50 in chips) 
Seat 6: Kalaboush ($14.72 in chips) 
ehrmstyle: posts small blind $0.05
Kalaboush: posts big blind $0.10
ehrmstyle: posts the ante $0.02
Kalaboush: posts the ante $0.02
*** HOLE CARDS ***
ehrmstyle: raises $0.20 to $0.30
Kalaboush: calls $0.20
*** FLOP *** [8s 6s 5s]
Kalaboush: checks 
ehrmstyle: checks 
*** TURN *** [8s 6s 5s] [Jc]
Kalaboush: checks 
ehrmstyle: checks 
*** RIVER *** [8s 6s 5s Jc] [9d]
Kalaboush: bets $0.10
ehrmstyle: folds 
Uncalled bet ($0.10) returned to Kalaboush
Kalaboush collected $0.61 from pot
Kalaboush: doesn't show hand 
*** SUMMARY ***
Total pot $0.64 | Rake $0.03 
Board [8s 6s 5s Jc 9d]
Seat 4: ehrmstyle (button) (small blind) folded on the River
Seat 6: Kalaboush (big blind) collected ($0.61)



PokerStars Hand #201506398488:  Hold'em No Limit ($0.05/$0.10 USD) - 2019/06/18 9:19:09 ET
Table 'Moreau III' 6-max Seat #6 is the button
Seat 4: ehrmstyle ($30.18 in chips) 
Seat 6: Kalaboush ($15.01 in chips) 
Kalaboush: posts small blind $0.05
ehrmstyle: posts big blind $0.10
ehrmstyle: posts the ante $0.02
Kalaboush: posts the ante $0.02
*** HOLE CARDS ***
Kalaboush: raises $0.10 to $0.20
ehrmstyle: calls $0.10
*** FLOP *** [8d 5s 5h]
ehrmstyle: checks 
Kalaboush: checks 
*** TURN *** [8d 5s 5h] [9s]
ehrmstyle: bets $0.21
Kalaboush: calls $0.21
*** RIVER *** [8d 5s 5h 9s] [8s]
ehrmstyle: bets $0.82
Kalaboush: calls $0.82
*** SHOW DOWN ***
ehrmstyle: shows [5d Ad] (a full house, Fives full of Eights)
Kalaboush: mucks hand 
ehrmstyle collected $2.39 from pot
*** SUMMARY ***
Total pot $2.50 | Rake $0.11 
Board [8d 5s 5h 9s 8s]
Seat 4: ehrmstyle (big blind) showed [5d Ad] and won ($2.39) with a full house, Fives full of Eights
Seat 6: Kalaboush (button) (small blind) mucked



PokerStars Hand #201506409925:  Hold'em No Limit ($0.05/$0.10 USD) - 2019/06/18 9:19:42 ET
Table 'Moreau III' 6-max Seat #4 is the button
Seat 4: ehrmstyle ($31.32 in chips) 
Seat 6: Kalaboush ($13.76 in chips) 
ehrmstyle: posts small blind $0.05
Kalaboush: posts big blind $0.10
ehrmstyle: posts the ante $0.02
Kalaboush: posts the ante $0.02
*** HOLE CARDS ***
ehrmstyle: raises $0.20 to $0.30
Kalaboush: folds 
Uncalled bet ($0.20) returned to ehrmstyle
ehrmstyle collected $0.24 from pot
ehrmstyle: doesn't show hand 
*** SUMMARY ***
Total pot $0.24 | Rake $0 
Seat 4: ehrmstyle (button) (small blind) collected ($0.24)
Seat 6: Kalaboush (big blind) folded before Flop



PokerStars Hand #201506412847:  Hold'em No Limit ($0.05/$0.10 USD) - 2019/06/18 9:19:50 ET
Table 'Moreau III' 6-max Seat #6 is the button
Seat 4: ehrmstyle ($31.44 in chips) 
Seat 6: Kalaboush ($13.64 in chips) 
Kalaboush: posts small blind $0.05
ehrmstyle: posts big blind $0.10
ehrmstyle: posts the ante $0.02
Kalaboush: posts the ante $0.02
*** HOLE CARDS ***
Kalaboush: raises $0.20 to $0.30
ehrmstyle: folds 
Uncalled bet ($0.20) returned to Kalaboush
Kalaboush collected $0.24 from pot
Kalaboush: doesn't show hand 
*** SUMMARY ***
Total pot $0.24 | Rake $0 
Seat 4: ehrmstyle (big blind) folded before Flop
Seat 6: Kalaboush (button) (small blind) collected ($0.24)



PokerStars Hand #201506415515:  Hold'em No Limit ($0.05/$0.10 USD) - 2019/06/18 9:19:58 ET
Table 'Moreau III' 6-max Seat #4 is the button
Seat 4: ehrmstyle ($31.32 in chips) 
Seat 6: Kalaboush ($13.76 in chips) 
ehrmstyle: posts small blind $0.05
Kalaboush: posts big blind $0.10
ehrmstyle: posts the ante $0.02
Kalaboush: posts the ante $0.02
*** HOLE CARDS ***
ehrmstyle: raises $0.20 to $0.30
Kalaboush: calls $0.20
*** FLOP *** [Ts 5s 9d]
Kalaboush: checks 
ehrmstyle: bets $0.31
Kalaboush: calls $0.31
*** TURN *** [Ts 5s 9d] [Ah]
Kalaboush: checks 
ehrmstyle: bets $0.60
Kalaboush: calls $0.60
*** RIVER *** [Ts 5s 9d Ah] [Jc]
Kalaboush: checks 
ehrmstyle: bets $1.18
Kalaboush: calls $1.18
*** SHOW DOWN ***
ehrmstyle: shows [Kc As] (a pair of Aces)
Kalaboush: mucks hand 
ehrmstyle collected $4.60 from pot
*** SUMMARY ***
Total pot $4.82 | Rake $0.22 
Board [Ts 5s 9d Ah Jc]
Seat 4: ehrmstyle (button) (small blind) showed [Kc As] and won ($4.60) with a pair of Aces
Seat 6: Kalaboush (big blind) mucked



PokerStars Hand #201506427217:  Hold'em No Limit ($0.05/$0.10 USD) - 2019/06/18 9:20:31 ET
Table 'Moreau III' 6-max Seat #6 is the button
Seat 4: ehrmstyle ($33.51 in chips) 
Seat 6: Kalaboush ($11.35 in chips) 
Kalaboush: posts small blind $0.05
ehrmstyle: posts big blind $0.10
ehrmstyle: posts the ante $0.02
Kalaboush: posts the ante $0.02
*** HOLE CARDS ***
Kalaboush: raises $0.10 to $0.20
ehrmstyle: raises $0.10 to $0.30
Kalaboush: calls $0.10
*** FLOP *** [8c 4s Td]
ehrmstyle: checks 
Kalaboush: checks 
*** TURN *** [8c 4s Td] [Ac]
ehrmstyle: checks 
Kalaboush: checks 
*** RIVER *** [8c 4s Td Ac] [2d]
ehrmstyle: bets $33.19 and is all-in
Kalaboush: folds 
Uncalled bet ($33.19) returned to ehrmstyle
ehrmstyle collected $0.61 from pot
ehrmstyle: doesn't show hand 
*** SUMMARY ***
Total pot $0.64 | Rake $0.03 
Board [8c 4s Td Ac 2d]
Seat 4: ehrmstyle (big blind) collected ($0.61)
Seat 6: Kalaboush (button) (small blind) folded on the River



PokerStars Hand #201506435966:  Hold'em No Limit ($0.05/$0.10 USD) - 2019/06/18 9:20:56 ET
Table 'Moreau III' 6-max Seat #4 is the button
Seat 4: ehrmstyle ($33.80 in chips) 
Seat 6: Kalaboush ($11.03 in chips) 
ehrmstyle: posts small blind $0.05
Kalaboush: posts big blind $0.10
ehrmstyle: posts the ante $0.02
Kalaboush: posts the ante $0.02
*** HOLE CARDS ***
ehrmstyle: raises $0.20 to $0.30
Kalaboush: calls $0.20
*** FLOP *** [3d 3c 4c]
Kalaboush: checks 
ehrmstyle: bets $0.31
Kalaboush: calls $0.31
*** TURN *** [3d 3c 4c] [As]
Kalaboush: checks 
ehrmstyle: bets $0.60
Kalaboush: raises $1.20 to $1.80
ehrmstyle: calls $1.20
*** RIVER *** [3d 3c 4c As] [5c]
Kalaboush: bets $2.30
ehrmstyle: folds 
Uncalled bet ($2.30) returned to Kalaboush
Kalaboush collected $4.64 from pot
Kalaboush: doesn't show hand 
*** SUMMARY ***
Total pot $4.86 | Rake $0.22 
Board [3d 3c 4c As 5c]
Seat 4: ehrmstyle (button) (small blind) folded on the River
Seat 6: Kalaboush (big blind) collected ($4.64)



PokerStars Hand #201506448777:  Hold'em No Limit ($0.05/$0.10 USD) - 2019/06/18 9:21:32 ET
Table 'Moreau III' 6-max Seat #6 is the button
Seat 4: ehrmstyle ($31.37 in chips) 
Seat 6: Kalaboush ($13.24 in chips) 
Kalaboush: posts small blind $0.05
ehrmstyle: posts big blind $0.10
ehrmstyle: posts the ante $0.02
Kalaboush: posts the ante $0.02
*** HOLE CARDS ***
Kalaboush: raises $0.24 to $0.34
ehrmstyle: calls $0.24
*** FLOP *** [4d Js 5c]
ehrmstyle: checks 
Kalaboush: bets $0.10
ehrmstyle: calls $0.10
*** TURN *** [4d Js 5c] [8s]
ehrmstyle: checks 
Kalaboush: checks 
*** RIVER *** [4d Js 5c 8s] [Ac]
ehrmstyle: bets $0.44
Kalaboush: calls $0.44
*** SHOW DOWN ***
ehrmstyle: shows [Tc Qs] (high card Ace)
Kalaboush: shows [Th Ah] (a pair of Aces)
Kalaboush collected $1.72 from pot
*** SUMMARY ***
Total pot $1.80 | Rake $0.08 
Board [4d Js 5c 8s Ac]
Seat 4: ehrmstyle (big blind) showed [Tc Qs] and lost with high card Ace
Seat 6: Kalaboush (button) (small blind) showed [Th Ah] and won ($1.72) with a pair of Aces



PokerStars Hand #201506459137:  Hold'em No Limit ($0.05/$0.10 USD) - 2019/06/18 9:22:02 ET
Table 'Moreau III' 6-max Seat #4 is the button
Seat 4: ehrmstyle ($30.47 in chips) 
Seat 6: Kalaboush ($14.06 in chips) 
ehrmstyle: posts small blind $0.05
Kalaboush: posts big blind $0.10
ehrmstyle: posts the ante $0.02
Kalaboush: posts the ante $0.02
*** HOLE CARDS ***
ehrmstyle: raises $0.20 to $0.30
Kalaboush: calls $0.20
*** FLOP *** [7c 3h Kh]
Kalaboush: checks 
ehrmstyle: checks 
*** TURN *** [7c 3h Kh] [2c]
Kalaboush: checks 
ehrmstyle: checks 
*** RIVER *** [7c 3h Kh 2c] [6d]
Kalaboush: checks 
ehrmstyle: checks 
*** SHOW DOWN ***
Kalaboush: shows [8c 4c] (high card King)
ehrmstyle: shows [Jh 9s] (high card King - Jack kicker)
ehrmstyle collected $0.61 from pot
*** SUMMARY ***
Total pot $0.64 | Rake $0.03 
Board [7c 3h Kh 2c 6d]
Seat 4: ehrmstyle (button) (small blind) showed [Jh 9s] and won ($0.61) with high card King
Seat 6: Kalaboush (big blind) showed [8c 4c] and lost with high card King



PokerStars Hand #201506477270:  Hold'em No Limit ($0.05/$0.10 USD) - 2019/06/18 9:22:54 ET
Table 'Moreau III' 6-max Seat #6 is the button
Seat 4: ehrmstyle ($30.76 in chips) 
Seat 6: Kalaboush ($13.74 in chips) 
Kalaboush: posts small blind $0.05
ehrmstyle: posts big blind $0.10
ehrmstyle: posts the ante $0.02
Kalaboush: posts the ante $0.02
*** HOLE CARDS ***
Kalaboush: calls $0.05
klugkk joins the table at seat #1 
ehrmstyle: raises $0.20 to $0.30
Kalaboush: calls $0.20
*** FLOP *** [5c Kh 6c]
ehrmstyle: bets $0.61
Kalaboush: folds 
Uncalled bet ($0.61) returned to ehrmstyle
ehrmstyle collected $0.61 from pot
ehrmstyle: doesn't show hand 
*** SUMMARY ***
Total pot $0.64 | Rake $0.03 
Board [5c Kh 6c]
Seat 4: ehrmstyle (big blind) collected ($0.61)
Seat 6: Kalaboush (button) (small blind) folded on the Flop



PokerStars Hand #201506482470:  Hold'em No Limit ($0.05/$0.10 USD) - 2019/06/18 9:23:09 ET
Table 'Moreau III' 6-max Seat #4 is the button
Seat 1: klugkk ($10 in chips) 
Seat 4: ehrmstyle ($31.05 in chips) 
Seat 6: Kalaboush ($13.42 in chips) 
Kalaboush: posts small blind $0.05
klugkk: posts big blind $0.10
klugkk: posts the ante $0.02
ehrmstyle: posts the ante $0.02
Kalaboush: posts the ante $0.02
*** HOLE CARDS ***
ehrmstyle: raises $0.20 to $0.30
Kalaboush: folds 
klugkk: folds 
Uncalled bet ($0.20) returned to ehrmstyle
ehrmstyle collected $0.31 from pot
ehrmstyle: doesn't show hand 
*** SUMMARY ***
Total pot $0.31 | Rake $0 
Seat 1: klugkk (big blind) folded before Flop
Seat 4: ehrmstyle (button) collected ($0.31)
Seat 6: Kalaboush (small blind) folded before Flop



PokerStars Hand #201506485448:  Hold'em No Limit ($0.05/$0.10 USD) - 2019/06/18 9:23:17 ET
Table 'Moreau III' 6-max Seat #6 is the button
Seat 1: klugkk ($10 in chips) 
Seat 4: ehrmstyle ($31.24 in chips) 
Seat 6: Kalaboush ($13.35 in chips) 
klugkk: posts small blind $0.05
ehrmstyle: posts big blind $0.10
klugkk: posts the ante $0.02
ehrmstyle: posts the ante $0.02
Kalaboush: posts the ante $0.02
*** HOLE CARDS ***
Kalaboush: raises $0.31 to $0.41
klugkk: calls $0.36
ehrmstyle: calls $0.31
*** FLOP *** [Tc Ah Ac]
klugkk: checks 
ehrmstyle: checks 
Kalaboush: bets $0.60
klugkk: folds 
ehrmstyle: folds 
Uncalled bet ($0.60) returned to Kalaboush
Kalaboush collected $1.23 from pot
Kalaboush: doesn't show hand 
*** SUMMARY ***
Total pot $1.29 | Rake $0.06 
Board [Tc Ah Ac]
Seat 1: klugkk (small blind) folded on the Flop
Seat 4: ehrmstyle (big blind) folded on the Flop
Seat 6: Kalaboush (button) collected ($1.23)



PokerStars Hand #201506493293:  Hold'em No Limit ($0.05/$0.10 USD) - 2019/06/18 9:23:40 ET
Table 'Moreau III' 6-max Seat #1 is the button
Seat 1: klugkk ($10 in chips) 
Seat 4: ehrmstyle ($30.81 in chips) 
Seat 6: Kalaboush ($14.15 in chips) 
ehrmstyle: posts small blind $0.05
Kalaboush: posts big blind $0.10
klugkk: posts the ante $0.02
ehrmstyle: posts the ante $0.02
Kalaboush: posts the ante $0.02
*** HOLE CARDS ***
klugkk: raises $0.10 to $0.20
ehrmstyle: folds 
Kalaboush: folds 
Uncalled bet ($0.10) returned to klugkk
klugkk collected $0.31 from pot
klugkk: doesn't show hand 
*** SUMMARY ***
Total pot $0.31 | Rake $0 
Seat 1: klugkk (button) collected ($0.31)
Seat 4: ehrmstyle (small blind) folded before Flop
Seat 6: Kalaboush (big blind) folded before Flop



PokerStars Hand #201506497831:  Hold'em No Limit ($0.05/$0.10 USD) - 2019/06/18 9:23:52 ET
Table 'Moreau III' 6-max Seat #4 is the button
Seat 1: klugkk ($10.19 in chips) 
Seat 4: ehrmstyle ($30.74 in chips) 
Seat 6: Kalaboush ($14.03 in chips) 
Kalaboush: posts small blind $0.05
klugkk: posts big blind $0.10
klugkk: posts the ante $0.02
ehrmstyle: posts the ante $0.02
Kalaboush: posts the ante $0.02
*** HOLE CARDS ***
ehrmstyle: folds 
Kalaboush: calls $0.05
klugkk: checks 
*** FLOP *** [7h 6h 2d]
Kalaboush: checks 
klugkk: checks 
*** TURN *** [7h 6h 2d] [8c]
Kalaboush: checks 
klugkk: checks 
*** RIVER *** [7h 6h 2d 8c] [3s]
Kalaboush: checks 
klugkk: bets $0.13
Kalaboush: folds 
Uncalled bet ($0.13) returned to klugkk
klugkk collected $0.25 from pot
klugkk: doesn't show hand 
*** SUMMARY ***
Total pot $0.26 | Rake $0.01 
Board [7h 6h 2d 8c 3s]
Seat 1: klugkk (big blind) collected ($0.25)
Seat 4: ehrmstyle (button) folded before Flop (didn't bet)
Seat 6: Kalaboush (small blind) folded on the River



PokerStars Hand #201506506255:  Hold'em No Limit ($0.05/$0.10 USD) - 2019/06/18 9:24:16 ET
Table 'Moreau III' 6-max Seat #6 is the button
Seat 1: klugkk ($10.32 in chips) 
Seat 4: ehrmstyle ($30.72 in chips) 
Seat 6: Kalaboush ($13.91 in chips) 
klugkk: posts small blind $0.05
ehrmstyle: posts big blind $0.10
klugkk: posts the ante $0.02
ehrmstyle: posts the ante $0.02
Kalaboush: posts the ante $0.02
*** HOLE CARDS ***
Kalaboush: calls $0.10
klugkk: raises $0.50 to $0.60
ehrmstyle: folds 
Kalaboush: folds 
Uncalled bet ($0.50) returned to klugkk
klugkk collected $0.36 from pot
klugkk: doesn't show hand 
*** SUMMARY ***
Total pot $0.36 | Rake $0 
Seat 1: klugkk (small blind) collected ($0.36)
Seat 4: ehrmstyle (big blind) folded before Flop
Seat 6: Kalaboush (button) folded before Flop



PokerStars Hand #201506512348:  Hold'em No Limit ($0.05/$0.10 USD) - 2019/06/18 9:24:33 ET
Table 'Moreau III' 6-max Seat #1 is the button
Seat 1: klugkk ($10.56 in chips) 
Seat 4: ehrmstyle ($30.60 in chips) 
Seat 6: Kalaboush ($13.79 in chips) 
ehrmstyle: posts small blind $0.05
Kalaboush: posts big blind $0.10
klugkk: posts the ante $0.02
ehrmstyle: posts the ante $0.02
Kalaboush: posts the ante $0.02
*** HOLE CARDS ***
klugkk: raises $0.20 to $0.30
ehrmstyle: raises $0.76 to $1.06
Kalaboush: folds 
klugkk: calls $0.76
*** FLOP *** [5d Jh Ac]
ehrmstyle: bets $1.09
klugkk: calls $1.09
*** TURN *** [5d Jh Ac] [Js]
ehrmstyle: bets $2.13
klugkk: raises $6.26 to $8.39 and is all-in
ehrmstyle: folds 
Uncalled bet ($6.26) returned to klugkk
klugkk collected $8.33 from pot
klugkk: doesn't show hand 
*** SUMMARY ***
Total pot $8.72 | Rake $0.39 
Board [5d Jh Ac Js]
Seat 1: klugkk (button) collected ($8.33)
Seat 4: ehrmstyle (small blind) folded on the Turn
Seat 6: Kalaboush (big blind) folded before Flop



PokerStars Hand #201506525768:  Hold'em No Limit ($0.05/$0.10 USD) - 2019/06/18 9:25:12 ET
Table 'Moreau III' 6-max Seat #4 is the button
Seat 1: klugkk ($14.59 in chips) 
Seat 4: ehrmstyle ($26.30 in chips) 
Seat 6: Kalaboush ($13.67 in chips) 
Kalaboush: posts small blind $0.05
klugkk: posts big blind $0.10
klugkk: posts the ante $0.02
ehrmstyle: posts the ante $0.02
Kalaboush: posts the ante $0.02
*** HOLE CARDS ***
ehrmstyle: raises $0.20 to $0.30
Kalaboush: calls $0.25
klugkk: folds 
*** FLOP *** [Qc 8c Jh]
Kalaboush: checks 
ehrmstyle: bets $0.37
Kalaboush: calls $0.37
*** TURN *** [Qc 8c Jh] [Js]
Kalaboush: checks 
ehrmstyle: bets $0.72
Kalaboush: folds 
Uncalled bet ($0.72) returned to ehrmstyle
ehrmstyle collected $1.43 from pot
ehrmstyle: doesn't show hand 
*** SUMMARY ***
Total pot $1.50 | Rake $0.07 
Board [Qc 8c Jh Js]
Seat 1: klugkk (big blind) folded before Flop
Seat 4: ehrmstyle (button) collected ($1.43)
Seat 6: Kalaboush (small blind) folded on the Turn



PokerStars Hand #201506534531:  Hold'em No Limit ($0.05/$0.10 USD) - 2019/06/18 9:25:36 ET
Table 'Moreau III' 6-max Seat #6 is the button
Seat 1: klugkk ($14.47 in chips) 
Seat 4: ehrmstyle ($27.04 in chips) 
Seat 6: Kalaboush ($12.98 in chips) 
klugkk: posts small blind $0.05
ehrmstyle: posts big blind $0.10
klugkk: posts the ante $0.02
ehrmstyle: posts the ante $0.02
Kalaboush: posts the ante $0.02
*** HOLE CARDS ***
Kalaboush: raises $0.20 to $0.30
klugkk: folds 
ehrmstyle: calls $0.20
*** FLOP *** [6d 5h 9h]
ehrmstyle: checks 
Kalaboush: checks 
*** TURN *** [6d 5h 9h] [Th]
ehrmstyle: checks 
Kalaboush: checks 
*** RIVER *** [6d 5h 9h Th] [Ks]
ehrmstyle: checks 
Kalaboush: checks 
*** SHOW DOWN ***
ehrmstyle: shows [3s 3h] (a pair of Threes)
Kalaboush: mucks hand 
ehrmstyle collected $0.68 from pot
*** SUMMARY ***
Total pot $0.71 | Rake $0.03 
Board [6d 5h 9h Th Ks]
Seat 1: klugkk (small blind) folded before Flop
Seat 4: ehrmstyle (big blind) showed [3s 3h] and won ($0.68) with a pair of Threes
Seat 6: Kalaboush (button) mucked



PokerStars Hand #201506543086:  Hold'em No Limit ($0.05/$0.10 USD) - 2019/06/18 9:26:01 ET
Table 'Moreau III' 6-max Seat #1 is the button
Seat 1: klugkk ($14.40 in chips) 
Seat 4: ehrmstyle ($27.40 in chips) 
Seat 6: Kalaboush ($12.66 in chips) 
ehrmstyle: posts small blind $0.05
Kalaboush: posts big blind $0.10
klugkk: posts the ante $0.02
ehrmstyle: posts the ante $0.02
Kalaboush: posts the ante $0.02
*** HOLE CARDS ***
klugkk: raises $0.10 to $0.20
ehrmstyle: raises $0.10 to $0.30
Kalaboush: calls $0.20
klugkk: calls $0.10
*** FLOP *** [9d 5c Qc]
ehrmstyle: bets $0.50
Kalaboush: folds 
klugkk: folds 
Uncalled bet ($0.50) returned to ehrmstyle
ehrmstyle collected $0.92 from pot
ehrmstyle: doesn't show hand 
*** SUMMARY ***
Total pot $0.96 | Rake $0.04 
Board [9d 5c Qc]
Seat 1: klugkk (button) folded on the Flop
Seat 4: ehrmstyle (small blind) collected ($0.92)
Seat 6: Kalaboush (big blind) folded on the Flop



PokerStars Hand #201506551479:  Hold'em No Limit ($0.05/$0.10 USD) - 2019/06/18 9:26:25 ET
Table 'Moreau III' 6-max Seat #4 is the button
Seat 1: klugkk ($14.08 in chips) 
Seat 4: ehrmstyle ($28 in chips) 
Seat 6: Kalaboush ($12.34 in chips) 
Kalaboush: posts small blind $0.05
klugkk: posts big blind $0.10
klugkk: posts the ante $0.02
ehrmstyle: posts the ante $0.02
Kalaboush: posts the ante $0.02
*** HOLE CARDS ***
ehrmstyle: raises $0.31 to $0.41
Kalaboush: calls $0.36
klugkk: calls $0.31
*** FLOP *** [5h Kh Qs]
Kalaboush: checks 
klugkk: checks 
ehrmstyle: checks 
*** TURN *** [5h Kh Qs] [6s]
Kalaboush: checks 
klugkk: bets $0.62
ehrmstyle: calls $0.62
Kalaboush: folds 
*** RIVER *** [5h Kh Qs 6s] [Ks]
klugkk: bets $1.21
ehrmstyle: calls $1.21
*** SHOW DOWN ***
klugkk: shows [Th Ad] (a pair of Kings)
ehrmstyle: shows [9s 9d] (two pair, Kings and Nines)
ehrmstyle collected $4.73 from pot
*** SUMMARY ***
Total pot $4.95 | Rake $0.22 
Board [5h Kh Qs 6s Ks]
Seat 1: klugkk (big blind) showed [Th Ad] and lost with a pair of Kings
Seat 4: ehrmstyle (button) showed [9s 9d] and won ($4.73) with two pair, Kings and Nines
Seat 6: Kalaboush (small blind) folded on the Turn



PokerStars Hand #201506564215:  Hold'em No Limit ($0.05/$0.10 USD) - 2019/06/18 9:27:02 ET
Table 'Moreau III' 6-max Seat #6 is the button
Seat 1: klugkk ($11.82 in chips) 
Seat 4: ehrmstyle ($30.47 in chips) 
Seat 6: Kalaboush ($11.91 in chips) 
klugkk: posts small blind $0.05
ehrmstyle: posts big blind $0.10
klugkk: posts the ante $0.02
ehrmstyle: posts the ante $0.02
Kalaboush: posts the ante $0.02
*** HOLE CARDS ***
Kalaboush: raises $0.31 to $0.41
klugkk: folds 
ehrmstyle: folds 
Uncalled bet ($0.31) returned to Kalaboush
Kalaboush collected $0.31 from pot
Kalaboush: doesn't show hand 
*** SUMMARY ***
Total pot $0.31 | Rake $0 
Seat 1: klugkk (small blind) folded before Flop
Seat 4: ehrmstyle (big blind) folded before Flop
Seat 6: Kalaboush (button) collected ($0.31)



PokerStars Hand #201506569792:  Hold'em No Limit ($0.05/$0.10 USD) - 2019/06/18 9:27:18 ET
Table 'Moreau III' 6-max Seat #1 is the button
Seat 1: klugkk ($11.75 in chips) 
Seat 4: ehrmstyle ($30.35 in chips) 
Seat 6: Kalaboush ($12.10 in chips) 
ehrmstyle: posts small blind $0.05
Kalaboush: posts big blind $0.10
klugkk: posts the ante $0.02
ehrmstyle: posts the ante $0.02
Kalaboush: posts the ante $0.02
*** HOLE CARDS ***
klugkk: raises $0.20 to $0.30
ehrmstyle: folds 
Kalaboush: calls $0.20
*** FLOP *** [2d 5d 9s]
Kalaboush: checks 
klugkk: bets $0.34
Kalaboush: calls $0.34
*** TURN *** [2d 5d 9s] [4d]
Kalaboush: checks 
klugkk: checks 
*** RIVER *** [2d 5d 9s 4d] [8s]
Kalaboush: bets $0.10
klugkk: folds 
Uncalled bet ($0.10) returned to Kalaboush
Kalaboush collected $1.33 from pot
Kalaboush: doesn't show hand 
*** SUMMARY ***
Total pot $1.39 | Rake $0.06 
Board [2d 5d 9s 4d 8s]
Seat 1: klugkk (button) folded on the River
Seat 4: ehrmstyle (small blind) folded before Flop
Seat 6: Kalaboush (big blind) collected ($1.33)



PokerStars Hand #201506576311:  Hold'em No Limit ($0.05/$0.10 USD) - 2019/06/18 9:27:36 ET
Table 'Moreau III' 6-max Seat #4 is the button
Seat 1: klugkk ($11.09 in chips) 
Seat 4: ehrmstyle ($30.28 in chips) 
Seat 6: Kalaboush ($12.77 in chips) 
Kalaboush: posts small blind $0.05
klugkk: posts big blind $0.10
klugkk: posts the ante $0.02
ehrmstyle: posts the ante $0.02
Kalaboush: posts the ante $0.02
*** HOLE CARDS ***
ehrmstyle: folds 
Kalaboush: folds 
Uncalled bet ($0.05) returned to klugkk
klugkk collected $0.16 from pot
*** SUMMARY ***
Total pot $0.16 | Rake $0 
Seat 1: klugkk (big blind) collected ($0.16)
Seat 4: ehrmstyle (button) folded before Flop (didn't bet)
Seat 6: Kalaboush (small blind) folded before Flop



PokerStars Hand #201506579787:  Hold'em No Limit ($0.05/$0.10 USD) - 2019/06/18 9:27:46 ET
Table 'Moreau III' 6-max Seat #6 is the button
Seat 1: klugkk ($11.18 in chips) 
Seat 4: ehrmstyle ($30.26 in chips) 
Seat 6: Kalaboush ($12.70 in chips) 
klugkk: posts small blind $0.05
ehrmstyle: posts big blind $0.10
klugkk: posts the ante $0.02
ehrmstyle: posts the ante $0.02
Kalaboush: posts the ante $0.02
*** HOLE CARDS ***
Kalaboush: folds 
klugkk: raises $0.20 to $0.30
ehrmstyle: folds 
Uncalled bet ($0.20) returned to klugkk
klugkk collected $0.26 from pot
klugkk: doesn't show hand 
*** SUMMARY ***
Total pot $0.26 | Rake $0 
Seat 1: klugkk (small blind) collected ($0.26)
Seat 4: ehrmstyle (big blind) folded before Flop
Seat 6: Kalaboush (button) folded before Flop (didn't bet)



PokerStars Hand #201506585971:  Hold'em No Limit ($0.05/$0.10 USD) - 2019/06/18 9:28:03 ET
Table 'Moreau III' 6-max Seat #1 is the button
Seat 1: klugkk ($11.32 in chips) 
Seat 4: ehrmstyle ($30.14 in chips) 
Seat 6: Kalaboush ($12.68 in chips) 
ehrmstyle: posts small blind $0.05
Kalaboush: posts big blind $0.10
klugkk: posts the ante $0.02
ehrmstyle: posts the ante $0.02
Kalaboush: posts the ante $0.02
*** HOLE CARDS ***
klugkk: raises $0.20 to $0.30
ehrmstyle: calls $0.25
Kalaboush: calls $0.20
*** FLOP *** [7s Kh Ad]
ehrmstyle: checks 
Kalaboush: checks 
klugkk: checks 
*** TURN *** [7s Kh Ad] [6s]
ehrmstyle: checks 
Kalaboush: checks 
klugkk: checks 
*** RIVER *** [7s Kh Ad 6s] [Kc]
ehrmstyle: checks 
Kalaboush: bets $0.50
klugkk: folds 
ehrmstyle: folds 
Uncalled bet ($0.50) returned to Kalaboush
Kalaboush collected $0.92 from pot
Kalaboush: doesn't show hand 
*** SUMMARY ***
Total pot $0.96 | Rake $0.04 
Board [7s Kh Ad 6s Kc]
Seat 1: klugkk (button) folded on the River
Seat 4: ehrmstyle (small blind) folded on the River
Seat 6: Kalaboush (big blind) collected ($0.92)



PokerStars Hand #201506600612:  Hold'em No Limit ($0.05/$0.10 USD) - 2019/06/18 9:28:45 ET
Table 'Moreau III' 6-max Seat #4 is the button
Seat 1: klugkk ($11 in chips) 
Seat 4: ehrmstyle ($29.82 in chips) 
Seat 6: Kalaboush ($13.28 in chips) 
Kalaboush: posts small blind $0.05
klugkk: posts big blind $0.10
klugkk: posts the ante $0.02
ehrmstyle: posts the ante $0.02
Kalaboush: posts the ante $0.02
*** HOLE CARDS ***
ehrmstyle: raises $0.20 to $0.30
Kalaboush: folds 
klugkk: raises $0.90 to $1.20
ehrmstyle: calls $0.90
*** FLOP *** [Kh 4s 4d]
klugkk: bets $1.20
ehrmstyle: folds 
Uncalled bet ($1.20) returned to klugkk
klugkk collected $2.40 from pot
klugkk: doesn't show hand 
*** SUMMARY ***
Total pot $2.51 | Rake $0.11 
Board [Kh 4s 4d]
Seat 1: klugkk (big blind) collected ($2.40)
Seat 4: ehrmstyle (button) folded on the Flop
Seat 6: Kalaboush (small blind) folded before Flop



PokerStars Hand #201506612841:  Hold'em No Limit ($0.05/$0.10 USD) - 2019/06/18 9:29:20 ET
Table 'Moreau III' 6-max Seat #6 is the button
Seat 1: klugkk ($12.18 in chips) 
Seat 4: ehrmstyle ($28.60 in chips) 
Seat 6: Kalaboush ($13.21 in chips) 
klugkk: posts small blind $0.05
ehrmstyle: posts big blind $0.10
klugkk: posts the ante $0.02
ehrmstyle: posts the ante $0.02
Kalaboush: posts the ante $0.02
*** HOLE CARDS ***
Kalaboush: folds 
klugkk: raises $0.20 to $0.30
ehrmstyle: folds 
Uncalled bet ($0.20) returned to klugkk
klugkk collected $0.26 from pot
klugkk: doesn't show hand 
*** SUMMARY ***
Total pot $0.26 | Rake $0 
Seat 1: klugkk (small blind) collected ($0.26)
Seat 4: ehrmstyle (big blind) folded before Flop
Seat 6: Kalaboush (button) folded before Flop (didn't bet)



PokerStars Hand #201506616790:  Hold'em No Limit ($0.05/$0.10 USD) - 2019/06/18 9:29:31 ET
Table 'Moreau III' 6-max Seat #1 is the button
Seat 1: klugkk ($12.32 in chips) 
Seat 4: ehrmstyle ($28.48 in chips) 
Seat 6: Kalaboush ($13.19 in chips) 
ehrmstyle: posts small blind $0.05
Kalaboush: posts big blind $0.10
klugkk: posts the ante $0.02
ehrmstyle: posts the ante $0.02
Kalaboush: posts the ante $0.02
*** HOLE CARDS ***
klugkk: raises $0.20 to $0.30
ehrmstyle: folds 
Kalaboush: folds 
Uncalled bet ($0.20) returned to klugkk
klugkk collected $0.31 from pot
klugkk: doesn't show hand 
*** SUMMARY ***
Total pot $0.31 | Rake $0 
Seat 1: klugkk (button) collected ($0.31)
Seat 4: ehrmstyle (small blind) folded before Flop
Seat 6: Kalaboush (big blind) folded before Flop



PokerStars Hand #201506620965:  Hold'em No Limit ($0.05/$0.10 USD) - 2019/06/18 9:29:43 ET
Table 'Moreau III' 6-max Seat #4 is the button
Seat 1: klugkk ($12.51 in chips) 
Seat 4: ehrmstyle ($28.41 in chips) 
Seat 6: Kalaboush ($13.07 in chips) 
Kalaboush: posts small blind $0.05
klugkk: posts big blind $0.10
klugkk: posts the ante $0.02
ehrmstyle: posts the ante $0.02
Kalaboush: posts the ante $0.02
*** HOLE CARDS ***
ehrmstyle: raises $0.20 to $0.30
Kalaboush: folds 
klugkk: folds 
Uncalled bet ($0.20) returned to ehrmstyle
ehrmstyle collected $0.31 from pot
ehrmstyle: doesn't show hand 
*** SUMMARY ***
Total pot $0.31 | Rake $0 
Seat 1: klugkk (big blind) folded before Flop
Seat 4: ehrmstyle (button) collected ($0.31)
Seat 6: Kalaboush (small blind) folded before Flop



PokerStars Hand #201506624871:  Hold'em No Limit ($0.05/$0.10 USD) - 2019/06/18 9:29:54 ET
Table 'Moreau III' 6-max Seat #6 is the button
Seat 1: klugkk ($12.39 in chips) 
Seat 4: ehrmstyle ($28.60 in chips) 
Seat 6: Kalaboush ($13 in chips) 
klugkk: posts small blind $0.05
ehrmstyle: posts big blind $0.10
klugkk: posts the ante $0.02
ehrmstyle: posts the ante $0.02
Kalaboush: posts the ante $0.02
*** HOLE CARDS ***
Kalaboush: raises $0.31 to $0.41
klugkk: raises $0.98 to $1.39
ehrmstyle: folds 
Kalaboush: raises $1.08 to $2.47
klugkk: calls $1.08
*** FLOP *** [4d 7d 7s]
klugkk: checks 
Kalaboush: bets $4.90
klugkk: folds 
Uncalled bet ($4.90) returned to Kalaboush
Kalaboush collected $4.87 from pot
Kalaboush: doesn't show hand 
*** SUMMARY ***
Total pot $5.10 | Rake $0.23 
Board [4d 7d 7s]
Seat 1: klugkk (small blind) folded on the Flop
Seat 4: ehrmstyle (big blind) folded before Flop
Seat 6: Kalaboush (button) collected ($4.87)



PokerStars Hand #201506633770:  Hold'em No Limit ($0.05/$0.10 USD) - 2019/06/18 9:30:19 ET
Table 'Moreau III' 6-max Seat #1 is the button
Seat 1: klugkk ($10 in chips) 
Seat 4: ehrmstyle ($28.48 in chips) 
Seat 6: Kalaboush ($15.38 in chips) 
ehrmstyle: posts small blind $0.05
Kalaboush: posts big blind $0.10
klugkk: posts the ante $0.02
ehrmstyle: posts the ante $0.02
Kalaboush: posts the ante $0.02
*** HOLE CARDS ***
klugkk: folds 
ehrmstyle: folds 
Uncalled bet ($0.05) returned to Kalaboush
Kalaboush collected $0.16 from pot
Kalaboush: doesn't show hand 
*** SUMMARY ***
Total pot $0.16 | Rake $0 
Seat 1: klugkk (button) folded before Flop (didn't bet)
Seat 4: ehrmstyle (small blind) folded before Flop
Seat 6: Kalaboush (big blind) collected ($0.16)



PokerStars Hand #201506636106:  Hold'em No Limit ($0.05/$0.10 USD) - 2019/06/18 9:30:26 ET
Table 'Moreau III' 6-max Seat #4 is the button
Seat 1: klugkk ($10 in chips) 
Seat 4: ehrmstyle ($28.41 in chips) 
Seat 6: Kalaboush ($15.47 in chips) 
Kalaboush: posts small blind $0.05
klugkk: posts big blind $0.10
klugkk: posts the ante $0.02
ehrmstyle: posts the ante $0.02
Kalaboush: posts the ante $0.02
*** HOLE CARDS ***
ehrmstyle: raises $0.20 to $0.30
Kalaboush: folds 
klugkk: calls $0.20
*** FLOP *** [7h Tc 5s]
klugkk: checks 
ehrmstyle: checks 
*** TURN *** [7h Tc 5s] [4c]
klugkk: bets $0.40
ehrmstyle: folds 
Uncalled bet ($0.40) returned to klugkk
klugkk collected $0.68 from pot
klugkk: doesn't show hand 
umz102 joins the table at seat #3 
*** SUMMARY ***
Total pot $0.71 | Rake $0.03 
Board [7h Tc 5s 4c]
Seat 1: klugkk (big blind) collected ($0.68)
Seat 4: ehrmstyle (button) folded on the Turn
Seat 6: Kalaboush (small blind) folded before Flop



PokerStars Hand #201506645960:  Hold'em No Limit ($0.05/$0.10 USD) - 2019/06/18 9:30:54 ET
Table 'Moreau III' 6-max Seat #6 is the button
Seat 1: klugkk ($10.36 in chips) 
Seat 3: umz102 ($8 in chips) 
Seat 4: ehrmstyle ($28.09 in chips) 
Seat 6: Kalaboush ($15.40 in chips) 
klugkk: posts small blind $0.05
umz102: posts big blind $0.10
klugkk: posts the ante $0.02
umz102: posts the ante $0.02
ehrmstyle: posts the ante $0.02
Kalaboush: posts the ante $0.02
*** HOLE CARDS ***
ehrmstyle: folds 
Kalaboush: raises $0.33 to $0.43
klugkk: folds 
umz102: folds 
Uncalled bet ($0.33) returned to Kalaboush
Kalaboush collected $0.33 from pot
Kalaboush: doesn't show hand 
*** SUMMARY ***
Total pot $0.33 | Rake $0 
Seat 1: klugkk (small blind) folded before Flop
Seat 3: umz102 (big blind) folded before Flop
Seat 4: ehrmstyle folded before Flop (didn't bet)
Seat 6: Kalaboush (button) collected ($0.33)



PokerStars Hand #201506654249:  Hold'em No Limit ($0.05/$0.10 USD) - 2019/06/18 9:31:17 ET
Table 'Moreau III' 6-max Seat #1 is the button
Seat 1: klugkk ($10.29 in chips) 
Seat 3: umz102 ($7.88 in chips) 
Seat 4: ehrmstyle ($28.07 in chips) 
Seat 6: Kalaboush ($15.61 in chips) 
umz102: posts small blind $0.05
ehrmstyle: posts big blind $0.10
klugkk: posts the ante $0.02
umz102: posts the ante $0.02
ehrmstyle: posts the ante $0.02
Kalaboush: posts the ante $0.02
*** HOLE CARDS ***
Kalaboush: raises $0.20 to $0.30
klugkk: folds 
umz102: folds 
ehrmstyle: calls $0.20
*** FLOP *** [7d 3h 8h]
ehrmstyle: checks 
Kalaboush: bets $0.30
ehrmstyle: calls $0.30
*** TURN *** [7d 3h 8h] [8c]
ehrmstyle: checks 
Kalaboush: checks 
*** RIVER *** [7d 3h 8h 8c] [Tc]
ehrmstyle: bets $0.64
Kalaboush: folds 
Uncalled bet ($0.64) returned to ehrmstyle
ehrmstyle collected $1.27 from pot
ehrmstyle: doesn't show hand 
*** SUMMARY ***
Total pot $1.33 | Rake $0.06 
Board [7d 3h 8h 8c Tc]
Seat 1: klugkk (button) folded before Flop (didn't bet)
Seat 3: umz102 (small blind) folded before Flop
Seat 4: ehrmstyle (big blind) collected ($1.27)
Seat 6: Kalaboush folded on the River



PokerStars Hand #201506667705:  Hold'em No Limit ($0.05/$0.10 USD) - 2019/06/18 9:31:54 ET
Table 'Moreau III' 6-max Seat #3 is the button
Seat 1: klugkk ($10.27 in chips) 
Seat 3: umz102 ($7.81 in chips) 
Seat 4: ehrmstyle ($28.72 in chips) 
Seat 6: Kalaboush ($14.99 in chips) 
ehrmstyle: posts small blind $0.05
Kalaboush: posts big blind $0.10
klugkk: posts the ante $0.02
umz102: posts the ante $0.02
ehrmstyle: posts the ante $0.02
Kalaboush: posts the ante $0.02
*** HOLE CARDS ***
klugkk: folds 
umz102: folds 
ehrmstyle: folds 
Uncalled bet ($0.05) returned to Kalaboush
Kalaboush collected $0.18 from pot
Kalaboush: doesn't show hand 
*** SUMMARY ***
Total pot $0.18 | Rake $0 
Seat 1: klugkk folded before Flop (didn't bet)
Seat 3: umz102 (button) folded before Flop (didn't bet)
Seat 4: ehrmstyle (small blind) folded before Flop
Seat 6: Kalaboush (big blind) collected ($0.18)



PokerStars Hand #201506671638:  Hold'em No Limit ($0.05/$0.10 USD) - 2019/06/18 9:32:05 ET
Table 'Moreau III' 6-max Seat #4 is the button
Seat 1: klugkk ($10.25 in chips) 
Seat 3: umz102 ($7.79 in chips) 
Seat 4: ehrmstyle ($28.65 in chips) 
Seat 6: Kalaboush ($15.10 in chips) 
Kalaboush: posts small blind $0.05
klugkk: posts big blind $0.10
klugkk: posts the ante $0.02
umz102: posts the ante $0.02
ehrmstyle: posts the ante $0.02
Kalaboush: posts the ante $0.02
*** HOLE CARDS ***
umz102: folds 
ehrmstyle: raises $0.20 to $0.30
Kalaboush: calls $0.25
klugkk: folds 
*** FLOP *** [4h Td 8h]
Kalaboush: checks 
ehrmstyle: bets $0.37
Kalaboush: calls $0.37
*** TURN *** [4h Td 8h] [4d]
Kalaboush: checks 
ehrmstyle: checks 
*** RIVER *** [4h Td 8h 4d] [Qc]
Kalaboush: bets $0.70
ehrmstyle: folds 
Uncalled bet ($0.70) returned to Kalaboush
Kalaboush collected $1.45 from pot
Kalaboush: doesn't show hand 
*** SUMMARY ***
Total pot $1.52 | Rake $0.07 
Board [4h Td 8h 4d Qc]
Seat 1: klugkk (big blind) folded before Flop
Seat 3: umz102 folded before Flop (didn't bet)
Seat 4: ehrmstyle (button) folded on the River
Seat 6: Kalaboush (small blind) collected ($1.45)



PokerStars Hand #201506685301:  Hold'em No Limit ($0.05/$0.10 USD) - 2019/06/18 9:32:43 ET
Table 'Moreau III' 6-max Seat #6 is the button
Seat 1: klugkk ($10.13 in chips) 
Seat 3: umz102 ($7.77 in chips) 
Seat 4: ehrmstyle ($27.96 in chips) 
Seat 6: Kalaboush ($15.86 in chips) 
klugkk: posts small blind $0.05
umz102: posts big blind $0.10
klugkk: posts the ante $0.02
umz102: posts the ante $0.02
ehrmstyle: posts the ante $0.02
Kalaboush: posts the ante $0.02
*** HOLE CARDS ***
ehrmstyle: folds 
Kalaboush: folds 
klugkk: raises $0.20 to $0.30
umz102: calls $0.20
*** FLOP *** [Qs Qc 5s]
klugkk: bets $0.33
umz102: raises $0.33 to $0.66
klugkk: folds 
Uncalled bet ($0.33) returned to umz102
umz102 collected $1.28 from pot
*** SUMMARY ***
Total pot $1.34 | Rake $0.06 
Board [Qs Qc 5s]
Seat 1: klugkk (small blind) folded on the Flop
Seat 3: umz102 (big blind) collected ($1.28)
Seat 4: ehrmstyle folded before Flop (didn't bet)
Seat 6: Kalaboush (button) folded before Flop (didn't bet)



PokerStars Hand #201506692070:  Hold'em No Limit ($0.05/$0.10 USD) - 2019/06/18 9:33:02 ET
Table 'Moreau III' 6-max Seat #1 is the button
Seat 1: klugkk ($10 in chips) 
Seat 3: umz102 ($8.40 in chips) 
Seat 4: ehrmstyle ($27.94 in chips) 
Seat 6: Kalaboush ($15.84 in chips) 
umz102: posts small blind $0.05
ehrmstyle: posts big blind $0.10
klugkk: posts the ante $0.02
umz102: posts the ante $0.02
ehrmstyle: posts the ante $0.02
Kalaboush: posts the ante $0.02
*** HOLE CARDS ***
vsv100 joins the table at seat #5 
Kalaboush: raises $0.33 to $0.43
klugkk: folds 
umz102: folds 
ehrmstyle: folds 
Uncalled bet ($0.33) returned to Kalaboush
Kalaboush collected $0.33 from pot
Kalaboush: doesn't show hand 
*** SUMMARY ***
Total pot $0.33 | Rake $0 
Seat 1: klugkk (button) folded before Flop (didn't bet)
Seat 3: umz102 (small blind) folded before Flop
Seat 4: ehrmstyle (big blind) folded before Flop
Seat 6: Kalaboush collected ($0.33)



PokerStars Hand #201506695751:  Hold'em No Limit ($0.05/$0.10 USD) - 2019/06/18 9:33:12 ET
Table 'Moreau III' 6-max Seat #3 is the button
Seat 1: klugkk ($10 in chips) 
Seat 3: umz102 ($8.33 in chips) 
Seat 4: ehrmstyle ($27.82 in chips) 
Seat 5: vsv100 ($10.51 in chips) 
Seat 6: Kalaboush ($16.05 in chips) 
ehrmstyle: posts small blind $0.05
vsv100: posts big blind $0.10
klugkk: posts the ante $0.02
umz102: posts the ante $0.02
ehrmstyle: posts the ante $0.02
vsv100: posts the ante $0.02
Kalaboush: posts the ante $0.02
*** HOLE CARDS ***
Kalaboush: raises $0.20 to $0.30
klugkk: calls $0.30
umz102: folds 
ehrmstyle: folds 
vsv100: calls $0.20
*** FLOP *** [Kc 8s Kd]
vsv100: checks 
Kalaboush: bets $1
klugkk: folds 
vsv100: folds 
Uncalled bet ($1) returned to Kalaboush
Kalaboush collected $1 from pot
Kalaboush: doesn't show hand 
*** SUMMARY ***
Total pot $1.05 | Rake $0.05 
Board [Kc 8s Kd]
Seat 1: klugkk folded on the Flop
Seat 3: umz102 (button) folded before Flop (didn't bet)
Seat 4: ehrmstyle (small blind) folded before Flop
Seat 5: vsv100 (big blind) folded on the Flop
Seat 6: Kalaboush collected ($1)



PokerStars Hand #201506703920:  Hold'em No Limit ($0.05/$0.10 USD) - 2019/06/18 9:33:35 ET
Table 'Moreau III' 6-max Seat #4 is the button
Seat 1: klugkk ($10 in chips) 
Seat 3: umz102 ($8.31 in chips) 
Seat 4: ehrmstyle ($27.75 in chips) 
Seat 5: vsv100 ($10.19 in chips) 
Seat 6: Kalaboush ($16.73 in chips) 
vsv100: posts small blind $0.05
Kalaboush: posts big blind $0.10
klugkk: posts the ante $0.02
umz102: posts the ante $0.02
ehrmstyle: posts the ante $0.02
vsv100: posts the ante $0.02
Kalaboush: posts the ante $0.02
*** HOLE CARDS ***
klugkk: folds 
umz102: calls $0.10
ehrmstyle: raises $0.45 to $0.55
vsv100: folds 
Kalaboush: folds 
umz102: calls $0.45
*** FLOP *** [2d 2s 3s]
umz102: checks 
ehrmstyle: bets $0.65
umz102: folds 
Uncalled bet ($0.65) returned to ehrmstyle
ehrmstyle collected $1.29 from pot
ehrmstyle: doesn't show hand 
*** SUMMARY ***
Total pot $1.35 | Rake $0.06 
Board [2d 2s 3s]
Seat 1: klugkk folded before Flop (didn't bet)
Seat 3: umz102 folded on the Flop
Seat 4: ehrmstyle (button) collected ($1.29)
Seat 5: vsv100 (small blind) folded before Flop
Seat 6: Kalaboush (big blind) folded before Flop



PokerStars Hand #201506716859:  Hold'em No Limit ($0.05/$0.10 USD) - 2019/06/18 9:34:11 ET
Table 'Moreau III' 6-max Seat #5 is the button
Seat 1: klugkk ($10 in chips) 
Seat 3: umz102 ($7.74 in chips) 
Seat 4: ehrmstyle ($28.47 in chips) 
Seat 5: vsv100 ($10.12 in chips) 
Seat 6: Kalaboush ($16.61 in chips) 
Kalaboush: posts small blind $0.05
klugkk: posts big blind $0.10
klugkk: posts the ante $0.02
umz102: posts the ante $0.02
ehrmstyle: posts the ante $0.02
vsv100: posts the ante $0.02
Kalaboush: posts the ante $0.02
*** HOLE CARDS ***
umz102: folds 
ehrmstyle: raises $0.35 to $0.45
vsv100: folds 
Kalaboush: folds 
klugkk: folds 
Uncalled bet ($0.35) returned to ehrmstyle
ehrmstyle collected $0.35 from pot
ehrmstyle: doesn't show hand 
*** SUMMARY ***
Total pot $0.35 | Rake $0 
Seat 1: klugkk (big blind) folded before Flop
Seat 3: umz102 folded before Flop (didn't bet)
Seat 4: ehrmstyle collected ($0.35)
Seat 5: vsv100 (button) folded before Flop (didn't bet)
Seat 6: Kalaboush (small blind) folded before Flop



PokerStars Hand #201506721539:  Hold'em No Limit ($0.05/$0.10 USD) - 2019/06/18 9:34:24 ET
Table 'Moreau III' 6-max Seat #6 is the button
Seat 1: klugkk ($10 in chips) 
Seat 3: umz102 ($7.72 in chips) 
Seat 4: ehrmstyle ($28.70 in chips) 
Seat 5: vsv100 ($10.10 in chips) 
Seat 6: Kalaboush ($16.54 in chips) 
klugkk: posts small blind $0.05
umz102: posts big blind $0.10
klugkk: posts the ante $0.02
umz102: posts the ante $0.02
ehrmstyle: posts the ante $0.02
vsv100: posts the ante $0.02
Kalaboush: posts the ante $0.02
*** HOLE CARDS ***
ehrmstyle: folds 
vsv100: calls $0.10
Kalaboush: folds 
klugkk: calls $0.05
umz102: checks 
*** FLOP *** [8h Tc Td]
klugkk: bets $0.19
umz102: folds 
vsv100: folds 
Uncalled bet ($0.19) returned to klugkk
klugkk collected $0.38 from pot
klugkk: doesn't show hand 
*** SUMMARY ***
Total pot $0.40 | Rake $0.02 
Board [8h Tc Td]
Seat 1: klugkk (small blind) collected ($0.38)
Seat 3: umz102 (big blind) folded on the Flop
Seat 4: ehrmstyle folded before Flop (didn't bet)
Seat 5: vsv100 folded on the Flop
Seat 6: Kalaboush (button) folded before Flop (didn't bet)



PokerStars Hand #201506732412:  Hold'em No Limit ($0.05/$0.10 USD) - 2019/06/18 9:34:54 ET
Table 'Moreau III' 6-max Seat #1 is the button
Seat 1: klugkk ($10.26 in chips) 
Seat 3: umz102 ($7.60 in chips) 
Seat 4: ehrmstyle ($28.68 in chips) 
Seat 5: vsv100 ($9.98 in chips) 
Seat 6: Kalaboush ($16.52 in chips) 
umz102: posts small blind $0.05
ehrmstyle: posts big blind $0.10
klugkk: posts the ante $0.02
umz102: posts the ante $0.02
ehrmstyle: posts the ante $0.02
vsv100: posts the ante $0.02
Kalaboush: posts the ante $0.02
*** HOLE CARDS ***
vsv100: calls $0.10
Kalaboush: folds 
klugkk: raises $0.20 to $0.30
umz102: folds 
ehrmstyle: folds 
vsv100: raises $0.60 to $0.90
klugkk: calls $0.60
*** FLOP *** [3s 5s Js]
vsv100: bets $1
klugkk: folds 
Uncalled bet ($1) returned to vsv100
vsv100 collected $1.96 from pot
vsv100: doesn't show hand 
*** SUMMARY ***
Total pot $2.05 | Rake $0.09 
Board [3s 5s Js]
Seat 1: klugkk (button) folded on the Flop
Seat 3: umz102 (small blind) folded before Flop
Seat 4: ehrmstyle (big blind) folded before Flop
Seat 5: vsv100 collected ($1.96)
Seat 6: Kalaboush folded before Flop (didn't bet)



PokerStars Hand #201506744558:  Hold'em No Limit ($0.05/$0.10 USD) - 2019/06/18 9:35:28 ET
Table 'Moreau III' 6-max Seat #3 is the button
Seat 1: klugkk ($10 in chips) 
Seat 3: umz102 ($7.53 in chips) 
Seat 4: ehrmstyle ($28.56 in chips) 
Seat 5: vsv100 ($11.02 in chips) 
Seat 6: Kalaboush ($16.50 in chips) 
ehrmstyle: posts small blind $0.05
vsv100: posts big blind $0.10
klugkk: posts the ante $0.02
umz102: posts the ante $0.02
ehrmstyle: posts the ante $0.02
vsv100: posts the ante $0.02
Kalaboush: posts the ante $0.02
*** HOLE CARDS ***
Kalaboush: folds 
klugkk: folds 
umz102: folds 
ehrmstyle: folds 
Uncalled bet ($0.05) returned to vsv100
vsv100 collected $0.20 from pot
vsv100: doesn't show hand 
*** SUMMARY ***
Total pot $0.20 | Rake $0 
Seat 1: klugkk folded before Flop (didn't bet)
Seat 3: umz102 (button) folded before Flop (didn't bet)
Seat 4: ehrmstyle (small blind) folded before Flop
Seat 5: vsv100 (big blind) collected ($0.20)
Seat 6: Kalaboush folded before Flop (didn't bet)



PokerStars Hand #201506753191:  Hold'em No Limit ($0.05/$0.10 USD) - 2019/06/18 9:35:52 ET
Table 'Moreau III' 6-max Seat #4 is the button
Seat 1: klugkk ($10 in chips) 
Seat 3: umz102 ($7.51 in chips) 
Seat 4: ehrmstyle ($28.49 in chips) 
Seat 5: vsv100 ($11.15 in chips) 
Seat 6: Kalaboush ($16.48 in chips) 
vsv100: posts small blind $0.05
Kalaboush: posts big blind $0.10
klugkk: posts the ante $0.02
umz102: posts the ante $0.02
ehrmstyle: posts the ante $0.02
vsv100: posts the ante $0.02
Kalaboush: posts the ante $0.02
*** HOLE CARDS ***
klugkk: folds 
umz102 has timed out
umz102: folds 
ehrmstyle: raises $0.20 to $0.30
vsv100: folds 
Kalaboush: calls $0.20
*** FLOP *** [7h 9h 8c]
Kalaboush: checks 
ehrmstyle: bets $0.36
Kalaboush: calls $0.36
*** TURN *** [7h 9h 8c] [Th]
Kalaboush: checks 
ehrmstyle: checks 
*** RIVER *** [7h 9h 8c Th] [3h]
Kalaboush: bets $0.90
ehrmstyle: folds 
Uncalled bet ($0.90) returned to Kalaboush
Kalaboush collected $1.40 from pot
Kalaboush: doesn't show hand 
*** SUMMARY ***
Total pot $1.47 | Rake $0.07 
Board [7h 9h 8c Th 3h]
Seat 1: klugkk folded before Flop (didn't bet)
Seat 3: umz102 folded before Flop (didn't bet)
Seat 4: ehrmstyle (button) folded on the River
Seat 5: vsv100 (small blind) folded before Flop
Seat 6: Kalaboush (big blind) collected ($1.40)



PokerStars Hand #201506777323:  Hold'em No Limit ($0.05/$0.10 USD) - 2019/06/18 9:36:59 ET
Table 'Moreau III' 6-max Seat #5 is the button
Seat 1: klugkk ($10 in chips) 
Seat 4: ehrmstyle ($27.81 in chips) 
Seat 5: vsv100 ($11.08 in chips) 
Seat 6: Kalaboush ($17.20 in chips) 
Kalaboush: posts small blind $0.05
klugkk: posts big blind $0.10
klugkk: posts the ante $0.02
ehrmstyle: posts the ante $0.02
vsv100: posts the ante $0.02
Kalaboush: posts the ante $0.02
*** HOLE CARDS ***
ehrmstyle: raises $0.20 to $0.30
vsv100: folds 
Kalaboush: raises $0.78 to $1.08
klugkk: folds 
ehrmstyle: folds 
Uncalled bet ($0.78) returned to Kalaboush
Kalaboush collected $0.78 from pot
Kalaboush: doesn't show hand 
*** SUMMARY ***
Total pot $0.78 | Rake $0 
Seat 1: klugkk (big blind) folded before Flop
Seat 4: ehrmstyle folded before Flop
Seat 5: vsv100 (button) folded before Flop (didn't bet)
Seat 6: Kalaboush (small blind) collected ($0.78)



PokerStars Hand #201506785200:  Hold'em No Limit ($0.05/$0.10 USD) - 2019/06/18 9:37:21 ET
Table 'Moreau III' 6-max Seat #6 is the button
Seat 1: klugkk ($10 in chips) 
Seat 4: ehrmstyle ($27.49 in chips) 
Seat 5: vsv100 ($11.06 in chips) 
Seat 6: Kalaboush ($17.66 in chips) 
klugkk: posts small blind $0.05
ehrmstyle: posts big blind $0.10
klugkk: posts the ante $0.02
ehrmstyle: posts the ante $0.02
vsv100: posts the ante $0.02
Kalaboush: posts the ante $0.02
*** HOLE CARDS ***
vsv100: folds 
Kalaboush: raises $0.33 to $0.43
klugkk: folds 
ehrmstyle: folds 
Uncalled bet ($0.33) returned to Kalaboush
Kalaboush collected $0.33 from pot
Kalaboush: doesn't show hand 
*** SUMMARY ***
Total pot $0.33 | Rake $0 
Seat 1: klugkk (small blind) folded before Flop
Seat 4: ehrmstyle (big blind) folded before Flop
Seat 5: vsv100 folded before Flop (didn't bet)
Seat 6: Kalaboush (button) collected ($0.33)



PokerStars Hand #201506789715:  Hold'em No Limit ($0.05/$0.10 USD) - 2019/06/18 9:37:34 ET
Table 'Moreau III' 6-max Seat #1 is the button
Seat 1: klugkk ($10 in chips) 
Seat 4: ehrmstyle ($27.37 in chips) 
Seat 5: vsv100 ($11.04 in chips) 
Seat 6: Kalaboush ($17.87 in chips) 
ehrmstyle: posts small blind $0.05
vsv100: posts big blind $0.10
klugkk: posts the ante $0.02
ehrmstyle: posts the ante $0.02
vsv100: posts the ante $0.02
Kalaboush: posts the ante $0.02
*** HOLE CARDS ***
Kalaboush: folds 
klugkk: folds 
ehrmstyle: raises $0.20 to $0.30
vsv100: folds 
Uncalled bet ($0.20) returned to ehrmstyle
ehrmstyle collected $0.28 from pot
ehrmstyle: doesn't show hand 
*** SUMMARY ***
Total pot $0.28 | Rake $0 
Seat 1: klugkk (button) folded before Flop (didn't bet)
Seat 4: ehrmstyle (small blind) collected ($0.28)
Seat 5: vsv100 (big blind) folded before Flop
Seat 6: Kalaboush folded before Flop (didn't bet)



PokerStars Hand #201506795174:  Hold'em No Limit ($0.05/$0.10 USD) - 2019/06/18 9:37:49 ET
Table 'Moreau III' 6-max Seat #4 is the button
Seat 1: klugkk ($10 in chips) 
Seat 4: ehrmstyle ($27.53 in chips) 
Seat 5: vsv100 ($10.92 in chips) 
Seat 6: Kalaboush ($17.85 in chips) 
vsv100: posts small blind $0.05
Kalaboush: posts big blind $0.10
klugkk: posts the ante $0.02
ehrmstyle: posts the ante $0.02
vsv100: posts the ante $0.02
Kalaboush: posts the ante $0.02
*** HOLE CARDS ***
klugkk: raises $0.20 to $0.30
ehrmstyle: folds 
vsv100: folds 
Kalaboush: calls $0.20
*** FLOP *** [7c 8d Jh]
Kalaboush: checks 
klugkk: bets $0.50
Kalaboush: calls $0.50
*** TURN *** [7c 8d Jh] [Kd]
Kalaboush: checks 
klugkk: bets $1.20
Kalaboush: folds 
Uncalled bet ($1.20) returned to klugkk
klugkk collected $1.65 from pot
klugkk: doesn't show hand 
*** SUMMARY ***
Total pot $1.73 | Rake $0.08 
Board [7c 8d Jh Kd]
Seat 1: klugkk collected ($1.65)
Seat 4: ehrmstyle (button) folded before Flop (didn't bet)
Seat 5: vsv100 (small blind) folded before Flop
Seat 6: Kalaboush (big blind) folded on the Turn



PokerStars Hand #201506805871:  Hold'em No Limit ($0.05/$0.10 USD) - 2019/06/18 9:38:19 ET
Table 'Moreau III' 6-max Seat #5 is the button
Seat 1: klugkk ($10.83 in chips) 
Seat 4: ehrmstyle ($27.51 in chips) 
Seat 5: vsv100 ($10.85 in chips) 
Seat 6: Kalaboush ($17.03 in chips) 
Kalaboush: posts small blind $0.05
klugkk: posts big blind $0.10
klugkk: posts the ante $0.02
ehrmstyle: posts the ante $0.02
vsv100: posts the ante $0.02
Kalaboush: posts the ante $0.02
*** HOLE CARDS ***
ehrmstyle: folds 
vsv100: calls $0.10
Kalaboush: folds 
klugkk: checks 
*** FLOP *** [Kd 2c Ad]
klugkk: checks 
vsv100: bets $0.10
klugkk: folds 
Uncalled bet ($0.10) returned to vsv100
vsv100 collected $0.32 from pot
vsv100: doesn't show hand 
*** SUMMARY ***
Total pot $0.33 | Rake $0.01 
Board [Kd 2c Ad]
Seat 1: klugkk (big blind) folded on the Flop
Seat 4: ehrmstyle folded before Flop (didn't bet)
Seat 5: vsv100 (button) collected ($0.32)
Seat 6: Kalaboush (small blind) folded before Flop



PokerStars Hand #201506811466:  Hold'em No Limit ($0.05/$0.10 USD) - 2019/06/18 9:38:35 ET
Table 'Moreau III' 6-max Seat #6 is the button
Seat 1: klugkk ($10.71 in chips) 
Seat 4: ehrmstyle ($27.49 in chips) 
Seat 5: vsv100 ($11.05 in chips) 
Seat 6: Kalaboush ($16.96 in chips) 
klugkk: posts small blind $0.05
ehrmstyle: posts big blind $0.10
klugkk: posts the ante $0.02
ehrmstyle: posts the ante $0.02
vsv100: posts the ante $0.02
Kalaboush: posts the ante $0.02
*** HOLE CARDS ***
vsv100: raises $0.10 to $0.20
Kalaboush: folds 
klugkk: calls $0.15
ehrmstyle: folds 
*** FLOP *** [8h 6d 4s]
klugkk: checks 
vsv100: checks 
*** TURN *** [8h 6d 4s] [5h]
klugkk: checks 
vsv100: bets $0.10
klugkk: calls $0.10
*** RIVER *** [8h 6d 4s 5h] [4h]
klugkk: checks 
vsv100: bets $0.10
klugkk: calls $0.10
*** SHOW DOWN ***
vsv100: shows [7s As] (a straight, Four to Eight)
klugkk: mucks hand 
vsv100 collected $0.94 from pot
*** SUMMARY ***
Total pot $0.98 | Rake $0.04 
Board [8h 6d 4s 5h 4h]
Seat 1: klugkk (small blind) mucked
Seat 4: ehrmstyle (big blind) folded before Flop
Seat 5: vsv100 showed [7s As] and won ($0.94) with a straight, Four to Eight
Seat 6: Kalaboush (button) folded before Flop (didn't bet)



PokerStars Hand #201506821901:  Hold'em No Limit ($0.05/$0.10 USD) - 2019/06/18 9:39:04 ET
Table 'Moreau III' 6-max Seat #1 is the button
Seat 1: klugkk ($10.29 in chips) 
Seat 4: ehrmstyle ($27.37 in chips) 
Seat 5: vsv100 ($11.57 in chips) 
Seat 6: Kalaboush ($16.94 in chips) 
ehrmstyle: posts small blind $0.05
vsv100: posts big blind $0.10
klugkk: posts the ante $0.02
ehrmstyle: posts the ante $0.02
vsv100: posts the ante $0.02
Kalaboush: posts the ante $0.02
*** HOLE CARDS ***
Kalaboush: folds 
klugkk: raises $0.30 to $0.40
ehrmstyle: folds 
vsv100: folds 
Uncalled bet ($0.30) returned to klugkk
klugkk collected $0.33 from pot
klugkk: doesn't show hand 
*** SUMMARY ***
Total pot $0.33 | Rake $0 
Seat 1: klugkk (button) collected ($0.33)
Seat 4: ehrmstyle (small blind) folded before Flop
Seat 5: vsv100 (big blind) folded before Flop
Seat 6: Kalaboush folded before Flop (didn't bet)



PokerStars Hand #201506828617:  Hold'em No Limit ($0.05/$0.10 USD) - 2019/06/18 9:39:23 ET
Table 'Moreau III' 6-max Seat #4 is the button
Seat 1: klugkk ($10.50 in chips) 
Seat 3: umz102 ($7.49 in chips) 
Seat 4: ehrmstyle ($27.30 in chips) 
Seat 5: vsv100 ($11.45 in chips) 
Seat 6: Kalaboush ($16.92 in chips) 
vsv100: posts small blind $0.05
Kalaboush: posts big blind $0.10
umz102: posts small & big blinds $0.15
klugkk: posts the ante $0.02
umz102: posts the ante $0.02
ehrmstyle: posts the ante $0.02
vsv100: posts the ante $0.02
Kalaboush: posts the ante $0.02
*** HOLE CARDS ***
klugkk: raises $0.50 to $0.60
umz102: folds 
ehrmstyle: folds 
vsv100: folds 
Kalaboush: folds 
Uncalled bet ($0.50) returned to klugkk
klugkk collected $0.50 from pot
klugkk: doesn't show hand 
*** SUMMARY ***
Total pot $0.50 | Rake $0 
Seat 1: klugkk collected ($0.50)
Seat 3: umz102 folded before Flop (didn't bet)
Seat 4: ehrmstyle (button) folded before Flop (didn't bet)
Seat 5: vsv100 (small blind) folded before Flop
Seat 6: Kalaboush (big blind) folded before Flop



PokerStars Hand #201506839345:  Hold'em No Limit ($0.05/$0.10 USD) - 2019/06/18 9:39:53 ET
Table 'Moreau III' 6-max Seat #5 is the button
Seat 1: klugkk ($10.88 in chips) 
Seat 3: umz102 ($7.32 in chips) 
Seat 4: ehrmstyle ($27.28 in chips) 
Seat 5: vsv100 ($11.38 in chips) 
Seat 6: Kalaboush ($16.80 in chips) 
Kalaboush: posts small blind $0.05
klugkk: posts big blind $0.10
klugkk: posts the ante $0.02
umz102: posts the ante $0.02
ehrmstyle: posts the ante $0.02
vsv100: posts the ante $0.02
Kalaboush: posts the ante $0.02
*** HOLE CARDS ***
umz102: folds 
ehrmstyle: raises $0.20 to $0.30
vsv100: folds 
Kalaboush: folds 
klugkk: folds 
Uncalled bet ($0.20) returned to ehrmstyle
ehrmstyle collected $0.35 from pot
ehrmstyle: doesn't show hand 
*** SUMMARY ***
Total pot $0.35 | Rake $0 
Seat 1: klugkk (big blind) folded before Flop
Seat 3: umz102 folded before Flop (didn't bet)
Seat 4: ehrmstyle collected ($0.35)
Seat 5: vsv100 (button) folded before Flop (didn't bet)
Seat 6: Kalaboush (small blind) folded before Flop



PokerStars Hand #201506845331:  Hold'em No Limit ($0.05/$0.10 USD) - 2019/06/18 9:40:10 ET
Table 'Moreau III' 6-max Seat #6 is the button
Seat 1: klugkk ($10.76 in chips) 
Seat 3: umz102 ($7.30 in chips) 
Seat 4: ehrmstyle ($27.51 in chips) 
Seat 5: vsv100 ($11.36 in chips) 
Seat 6: Kalaboush ($16.73 in chips) 
klugkk: posts small blind $0.05
umz102: posts big blind $0.10
klugkk: posts the ante $0.02
umz102: posts the ante $0.02
ehrmstyle: posts the ante $0.02
vsv100: posts the ante $0.02
Kalaboush: posts the ante $0.02
*** HOLE CARDS ***
ehrmstyle: folds 
vsv100: folds 
Kalaboush: folds 
klugkk: folds 
Uncalled bet ($0.05) returned to umz102
umz102 collected $0.20 from pot
*** SUMMARY ***
Total pot $0.20 | Rake $0 
Seat 1: klugkk (small blind) folded before Flop
Seat 3: umz102 (big blind) collected ($0.20)
Seat 4: ehrmstyle folded before Flop (didn't bet)
Seat 5: vsv100 folded before Flop (didn't bet)
Seat 6: Kalaboush (button) folded before Flop (didn't bet)



PokerStars Hand #201506849183:  Hold'em No Limit ($0.05/$0.10 USD) - 2019/06/18 9:40:21 ET
Table 'Moreau III' 6-max Seat #1 is the button
Seat 1: klugkk ($10.69 in chips) 
Seat 3: umz102 ($7.43 in chips) 
Seat 4: ehrmstyle ($27.49 in chips) 
Seat 5: vsv100 ($11.34 in chips) 
Seat 6: Kalaboush ($16.71 in chips) 
umz102: posts small blind $0.05
ehrmstyle: posts big blind $0.10
klugkk: posts the ante $0.02
umz102: posts the ante $0.02
ehrmstyle: posts the ante $0.02
vsv100: posts the ante $0.02
Kalaboush: posts the ante $0.02
*** HOLE CARDS ***
vsv100: folds 
Kalaboush: folds 
klugkk: raises $0.30 to $0.40
umz102: folds 
ehrmstyle: folds 
Uncalled bet ($0.30) returned to klugkk
klugkk collected $0.35 from pot
klugkk: doesn't show hand 
*** SUMMARY ***
Total pot $0.35 | Rake $0 
Seat 1: klugkk (button) collected ($0.35)
Seat 3: umz102 (small blind) folded before Flop
Seat 4: ehrmstyle (big blind) folded before Flop
Seat 5: vsv100 folded before Flop (didn't bet)
Seat 6: Kalaboush folded before Flop (didn't bet)



PokerStars Hand #201506855164:  Hold'em No Limit ($0.05/$0.10 USD) - 2019/06/18 9:40:37 ET
Table 'Moreau III' 6-max Seat #3 is the button
Seat 1: klugkk ($10.92 in chips) 
Seat 3: umz102 ($7.36 in chips) 
Seat 4: ehrmstyle ($27.37 in chips) 
Seat 5: vsv100 ($11.32 in chips) 
Seat 6: Kalaboush ($16.69 in chips) 
ehrmstyle: posts small blind $0.05
vsv100: posts big blind $0.10
klugkk: posts the ante $0.02
umz102: posts the ante $0.02
ehrmstyle: posts the ante $0.02
vsv100: posts the ante $0.02
Kalaboush: posts the ante $0.02
*** HOLE CARDS ***
Kalaboush: raises $0.20 to $0.30
klugkk: folds 
umz102 has timed out
umz102: folds 
ehrmstyle: folds 
vsv100: folds 
Uncalled bet ($0.20) returned to Kalaboush
Kalaboush collected $0.35 from pot
Kalaboush: doesn't show hand 
*** SUMMARY ***
Total pot $0.35 | Rake $0 
Seat 1: klugkk folded before Flop (didn't bet)
Seat 3: umz102 (button) folded before Flop (didn't bet)
Seat 4: ehrmstyle (small blind) folded before Flop
Seat 5: vsv100 (big blind) folded before Flop
Seat 6: Kalaboush collected ($0.35)



PokerStars Hand #201506865260:  Hold'em No Limit ($0.05/$0.10 USD) - 2019/06/18 9:41:05 ET
Table 'Moreau III' 6-max Seat #4 is the button
Seat 1: klugkk ($10.90 in chips) 
Seat 4: ehrmstyle ($27.30 in chips) 
Seat 5: vsv100 ($11.20 in chips) 
Seat 6: Kalaboush ($16.92 in chips) 
vsv100: posts small blind $0.05
Kalaboush: posts big blind $0.10
klugkk: posts the ante $0.02
ehrmstyle: posts the ante $0.02
vsv100: posts the ante $0.02
Kalaboush: posts the ante $0.02
*** HOLE CARDS ***
klugkk: folds 
ehrmstyle: calls $0.10
vsv100: folds 
Kalaboush: checks 
*** FLOP *** [2d 3s 5h]
Kalaboush: checks 
ehrmstyle: bets $0.16
Kalaboush: folds 
Uncalled bet ($0.16) returned to ehrmstyle
ehrmstyle collected $0.32 from pot
ehrmstyle: doesn't show hand 
*** SUMMARY ***
Total pot $0.33 | Rake $0.01 
Board [2d 3s 5h]
Seat 1: klugkk folded before Flop (didn't bet)
Seat 4: ehrmstyle (button) collected ($0.32)
Seat 5: vsv100 (small blind) folded before Flop
Seat 6: Kalaboush (big blind) folded on the Flop



PokerStars Hand #201506872342:  Hold'em No Limit ($0.05/$0.10 USD) - 2019/06/18 9:41:25 ET
Table 'Moreau III' 6-max Seat #5 is the button
Seat 1: klugkk ($10.88 in chips) 
Seat 4: ehrmstyle ($27.50 in chips) 
Seat 5: vsv100 ($11.13 in chips) 
Seat 6: Kalaboush ($16.80 in chips) 
Kalaboush: posts small blind $0.05
klugkk: posts big blind $0.10
klugkk: posts the ante $0.02
ehrmstyle: posts the ante $0.02
vsv100: posts the ante $0.02
Kalaboush: posts the ante $0.02
*** HOLE CARDS ***
ehrmstyle: folds 
vsv100: raises $0.10 to $0.20
Kalaboush: folds 
klugkk: folds 
Uncalled bet ($0.10) returned to vsv100
vsv100 collected $0.33 from pot
vsv100: doesn't show hand 
*** SUMMARY ***
Total pot $0.33 | Rake $0 
Seat 1: klugkk (big blind) folded before Flop
Seat 4: ehrmstyle folded before Flop (didn't bet)
Seat 5: vsv100 (button) collected ($0.33)
Seat 6: Kalaboush (small blind) folded before Flop



PokerStars Hand #201506875701:  Hold'em No Limit ($0.05/$0.10 USD) - 2019/06/18 9:41:34 ET
Table 'Moreau III' 6-max Seat #6 is the button
Seat 1: klugkk ($10.76 in chips) 
Seat 4: ehrmstyle ($27.48 in chips) 
Seat 5: vsv100 ($11.34 in chips) 
Seat 6: Kalaboush ($16.73 in chips) 
klugkk: posts small blind $0.05
ehrmstyle: posts big blind $0.10
klugkk: posts the ante $0.02
ehrmstyle: posts the ante $0.02
vsv100: posts the ante $0.02
Kalaboush: posts the ante $0.02
*** HOLE CARDS ***
vsv100: calls $0.10
Kalaboush: raises $0.43 to $0.53
klugkk: folds 
ehrmstyle: raises $1.29 to $1.82
Briise joins the table at seat #2 
vsv100: folds 
Kalaboush: raises $1.29 to $3.11
ehrmstyle: raises $6.45 to $9.56
Kalaboush: raises $7.15 to $16.71 and is all-in
ehrmstyle: calls $7.15
*** FLOP *** [5h Td 3h]
*** TURN *** [5h Td 3h] [3s]
*** RIVER *** [5h Td 3h 3s] [Qs]
*** SHOW DOWN ***
ehrmstyle: shows [Kd Ks] (two pair, Kings and Threes)
Kalaboush: shows [Ad Ah] (two pair, Aces and Threes)
Kalaboush collected $32.65 from pot
*** SUMMARY ***
Total pot $33.65 | Rake $1 
Board [5h Td 3h 3s Qs]
Seat 1: klugkk (small blind) folded before Flop
Seat 4: ehrmstyle (big blind) showed [Kd Ks] and lost with two pair, Kings and Threes
Seat 5: vsv100 folded before Flop
Seat 6: Kalaboush (button) showed [Ad Ah] and won ($32.65) with two pair, Aces and Threes



PokerStars Hand #201506892552:  Hold'em No Limit ($0.05/$0.10 USD) - 2019/06/18 9:42:22 ET
Table 'Moreau III' 6-max Seat #1 is the button
Seat 1: klugkk ($10.69 in chips) 
Seat 4: ehrmstyle ($10.75 in chips) 
Seat 5: vsv100 ($11.22 in chips) 
Seat 6: Kalaboush ($32.65 in chips) 
ehrmstyle: posts small blind $0.05
vsv100: posts big blind $0.10
klugkk: posts the ante $0.02
ehrmstyle: posts the ante $0.02
vsv100: posts the ante $0.02
Kalaboush: posts the ante $0.02
*** HOLE CARDS ***
Kalaboush: raises $0.20 to $0.30
klugkk: folds 
ehrmstyle: folds 
vsv100: folds 
Uncalled bet ($0.20) returned to Kalaboush
Kalaboush collected $0.33 from pot
Kalaboush: doesn't show hand 
umz102 leaves the table
*** SUMMARY ***
Total pot $0.33 | Rake $0 
Seat 1: klugkk (button) folded before Flop (didn't bet)
Seat 4: ehrmstyle (small blind) folded before Flop
Seat 5: vsv100 (big blind) folded before Flop
Seat 6: Kalaboush collected ($0.33)



PokerStars Hand #201506896281:  Hold'em No Limit ($0.05/$0.10 USD) - 2019/06/18 9:42:32 ET
Table 'Moreau III' 6-max Seat #4 is the button
Seat 1: klugkk ($10.67 in chips) 
Seat 2: Briise ($10 in chips) 
Seat 4: ehrmstyle ($10.68 in chips) 
Seat 5: vsv100 ($11.10 in chips) 
Seat 6: Kalaboush ($32.86 in chips) 
vsv100: posts small blind $0.05
Kalaboush: posts big blind $0.10
Briise: posts big blind $0.10
klugkk: posts the ante $0.02
Briise: posts the ante $0.02
ehrmstyle: posts the ante $0.02
vsv100: posts the ante $0.02
Kalaboush: posts the ante $0.02
*** HOLE CARDS ***
klugkk: folds 
Briise: checks 
ehrmstyle: folds 
vsv100: folds 
Kalaboush: checks 
*** FLOP *** [5s 3s Jh]
Kalaboush: checks 
Briise: checks 
*** TURN *** [5s 3s Jh] [2h]
Kalaboush: checks 
Briise: bets $0.10
Kalaboush: calls $0.10
*** RIVER *** [5s 3s Jh 2h] [7c]
Kalaboush: checks 
Briise: checks 
*** SHOW DOWN ***
Kalaboush: shows [Ad 5h] (a pair of Fives)
Briise: mucks hand 
Kalaboush collected $0.53 from pot
*** SUMMARY ***
Total pot $0.55 | Rake $0.02 
Board [5s 3s Jh 2h 7c]
Seat 1: klugkk folded before Flop (didn't bet)
Seat 2: Briise mucked
Seat 4: ehrmstyle (button) folded before Flop (didn't bet)
Seat 5: vsv100 (small blind) folded before Flop
Seat 6: Kalaboush (big blind) showed [Ad 5h] and won ($0.53) with a pair of Fives



PokerStars Hand #201506909130:  Hold'em No Limit ($0.05/$0.10 USD) - 2019/06/18 9:43:08 ET
Table 'Moreau III' 6-max Seat #5 is the button
Seat 1: klugkk ($10.65 in chips) 
Seat 2: Briise ($9.78 in chips) 
Seat 4: ehrmstyle ($10.66 in chips) 
Seat 5: vsv100 ($11.03 in chips) 
Seat 6: Kalaboush ($33.17 in chips) 
Kalaboush: posts small blind $0.05
klugkk: posts big blind $0.10
klugkk: posts the ante $0.02
Briise: posts the ante $0.02
ehrmstyle: posts the ante $0.02
vsv100: posts the ante $0.02
Kalaboush: posts the ante $0.02
*** HOLE CARDS ***
Briise: folds 
ehrmstyle: raises $0.35 to $0.45
vsv100: folds 
Kalaboush: folds 
klugkk: folds 
Uncalled bet ($0.35) returned to ehrmstyle
ehrmstyle collected $0.35 from pot
ehrmstyle: doesn't show hand 
*** SUMMARY ***
Total pot $0.35 | Rake $0 
Seat 1: klugkk (big blind) folded before Flop
Seat 2: Briise folded before Flop (didn't bet)
Seat 4: ehrmstyle collected ($0.35)
Seat 5: vsv100 (button) folded before Flop (didn't bet)
Seat 6: Kalaboush (small blind) folded before Flop



PokerStars Hand #201506913719:  Hold'em No Limit ($0.05/$0.10 USD) - 2019/06/18 9:43:20 ET
Table 'Moreau III' 6-max Seat #6 is the button
Seat 1: klugkk ($10.53 in chips) 
Seat 2: Briise ($9.76 in chips) 
Seat 4: ehrmstyle ($10.89 in chips) 
Seat 5: vsv100 ($11.01 in chips) 
Seat 6: Kalaboush ($33.10 in chips) 
klugkk: posts small blind $0.05
Briise: posts big blind $0.10
klugkk: posts the ante $0.02
Briise: posts the ante $0.02
ehrmstyle: posts the ante $0.02
vsv100: posts the ante $0.02
Kalaboush: posts the ante $0.02
*** HOLE CARDS ***
ehrmstyle: raises $0.20 to $0.30
vsv100: calls $0.30
Kalaboush: folds 
klugkk: folds 
Briise: folds 
*** FLOP *** [9d Ts As]
ehrmstyle: bets $0.41
vsv100: calls $0.41
*** TURN *** [9d Ts As] [2h]
ehrmstyle: bets $0.80
vsv100: folds 
Uncalled bet ($0.80) returned to ehrmstyle
ReKych joins the table at seat #3 
ehrmstyle collected $1.59 from pot
ehrmstyle: doesn't show hand 
*** SUMMARY ***
Total pot $1.67 | Rake $0.08 
Board [9d Ts As 2h]
Seat 1: klugkk (small blind) folded before Flop
Seat 2: Briise (big blind) folded before Flop
Seat 4: ehrmstyle collected ($1.59)
Seat 5: vsv100 folded on the Turn
Seat 6: Kalaboush (button) folded before Flop (didn't bet)



PokerStars Hand #201506922570:  Hold'em No Limit ($0.05/$0.10 USD) - 2019/06/18 9:43:45 ET
Table 'Moreau III' 6-max Seat #1 is the button
Seat 1: klugkk ($10.46 in chips) 
Seat 2: Briise ($9.64 in chips) 
Seat 3: ReKych ($10 in chips) 
Seat 4: ehrmstyle ($11.75 in chips) 
Seat 5: vsv100 ($10.28 in chips) 
Seat 6: Kalaboush ($33.08 in chips) 
Briise: posts small blind $0.05
ReKych: posts big blind $0.10
klugkk: posts the ante $0.02
Briise: posts the ante $0.02
ReKych: posts the ante $0.02
ehrmstyle: posts the ante $0.02
vsv100: posts the ante $0.02
Kalaboush: posts the ante $0.02
*** HOLE CARDS ***
ehrmstyle: raises $0.20 to $0.30
vsv100: folds 
Kalaboush: raises $0.87 to $1.17
klugkk: folds 
Briise: folds 
ReKych: folds 
ehrmstyle: raises $2.61 to $3.78
Kalaboush: folds 
Uncalled bet ($2.61) returned to ehrmstyle
ehrmstyle collected $2.61 from pot
ehrmstyle: doesn't show hand 
*** SUMMARY ***
Total pot $2.61 | Rake $0 
Seat 1: klugkk (button) folded before Flop (didn't bet)
Seat 2: Briise (small blind) folded before Flop
Seat 3: ReKych (big blind) folded before Flop
Seat 4: ehrmstyle collected ($2.61)
Seat 5: vsv100 folded before Flop (didn't bet)
Seat 6: Kalaboush folded before Flop



PokerStars Hand #201506933177:  Hold'em No Limit ($0.05/$0.10 USD) - 2019/06/18 9:44:15 ET
Table 'Moreau III' 6-max Seat #2 is the button
Seat 1: klugkk ($10.44 in chips) 
Seat 2: Briise ($9.57 in chips) 
Seat 3: ReKych ($10 in chips) 
Seat 4: ehrmstyle ($13.17 in chips) 
Seat 5: vsv100 ($10.26 in chips) 
Seat 6: Kalaboush ($31.89 in chips) 
ReKych: posts small blind $0.05
ehrmstyle: posts big blind $0.10
klugkk: posts the ante $0.02
Briise: posts the ante $0.02
ReKych: posts the ante $0.02
ehrmstyle: posts the ante $0.02
vsv100: posts the ante $0.02
Kalaboush: posts the ante $0.02
*** HOLE CARDS ***
vsv100: calls $0.10
Kalaboush: raises $0.47 to $0.57
klugkk: folds 
Briise: folds 
ReKych: folds 
ehrmstyle: folds 
vsv100: folds 
Uncalled bet ($0.47) returned to Kalaboush
Kalaboush collected $0.47 from pot
Kalaboush: doesn't show hand 
*** SUMMARY ***
Total pot $0.47 | Rake $0 
Seat 1: klugkk folded before Flop (didn't bet)
Seat 2: Briise (button) folded before Flop (didn't bet)
Seat 3: ReKych (small blind) folded before Flop
Seat 4: ehrmstyle (big blind) folded before Flop
Seat 5: vsv100 folded before Flop
Seat 6: Kalaboush collected ($0.47)



PokerStars Hand #201506940197:  Hold'em No Limit ($0.05/$0.10 USD) - 2019/06/18 9:44:34 ET
Table 'Moreau III' 6-max Seat #3 is the button
Seat 1: klugkk ($10.42 in chips) 
Seat 2: Briise ($9.55 in chips) 
Seat 3: ReKych ($10 in chips) 
Seat 4: ehrmstyle ($13.05 in chips) 
Seat 5: vsv100 ($10.14 in chips) 
Seat 6: Kalaboush ($32.24 in chips) 
ehrmstyle: posts small blind $0.05
vsv100: posts big blind $0.10
klugkk: posts the ante $0.02
Briise: posts the ante $0.02
ReKych: posts the ante $0.02
ehrmstyle: posts the ante $0.02
vsv100: posts the ante $0.02
Kalaboush: posts the ante $0.02
*** HOLE CARDS ***
Kalaboush: calls $0.10
klugkk: folds 
Briise: calls $0.10
ReKych: folds 
ehrmstyle: raises $0.20 to $0.30
vsv100: folds 
Kalaboush: calls $0.20
Briise: calls $0.20
*** FLOP *** [9s 4c Jd]
ehrmstyle: checks 
Kalaboush: bets $0.50
Briise: calls $0.50
ehrmstyle: folds 
*** TURN *** [9s 4c Jd] [Ks]
Kalaboush: checks 
Briise: bets $0.80
Kalaboush: folds 
Uncalled bet ($0.80) returned to Briise
Briise collected $2.02 from pot
Briise: doesn't show hand 
*** SUMMARY ***
Total pot $2.12 | Rake $0.10 
Board [9s 4c Jd Ks]
Seat 1: klugkk folded before Flop (didn't bet)
Seat 2: Briise collected ($2.02)
Seat 3: ReKych (button) folded before Flop (didn't bet)
Seat 4: ehrmstyle (small blind) folded on the Flop
Seat 5: vsv100 (big blind) folded before Flop
Seat 6: Kalaboush folded on the Turn



PokerStars Hand #201506961291:  Hold'em No Limit ($0.05/$0.10 USD) - 2019/06/18 9:45:33 ET
Table 'Moreau III' 6-max Seat #4 is the button
Seat 1: klugkk ($10.40 in chips) 
Seat 2: Briise ($10.75 in chips) 
Seat 3: ReKych ($10 in chips) 
Seat 4: ehrmstyle ($12.73 in chips) 
Seat 5: vsv100 ($10.02 in chips) 
Seat 6: Kalaboush ($31.42 in chips) 
vsv100: posts small blind $0.05
Kalaboush: posts big blind $0.10
klugkk: posts the ante $0.02
Briise: posts the ante $0.02
ReKych: posts the ante $0.02
ehrmstyle: posts the ante $0.02
vsv100: posts the ante $0.02
Kalaboush: posts the ante $0.02
*** HOLE CARDS ***
klugkk: raises $0.30 to $0.40
Briise: folds 
ReKych: calls $0.40
ehrmstyle: folds 
vsv100: folds 
Kalaboush: folds 
*** FLOP *** [2s 5c 5d]
klugkk: bets $0.80
ReKych: calls $0.80
*** TURN *** [2s 5c 5d] [2h]
klugkk: bets $1.50
ReKych: folds 
Uncalled bet ($1.50) returned to klugkk
klugkk collected $2.55 from pot
klugkk: doesn't show hand 
*** SUMMARY ***
Total pot $2.67 | Rake $0.12 
Board [2s 5c 5d 2h]
Seat 1: klugkk collected ($2.55)
Seat 2: Briise folded before Flop (didn't bet)
Seat 3: ReKych folded on the Turn
Seat 4: ehrmstyle (button) folded before Flop (didn't bet)
Seat 5: vsv100 (small blind) folded before Flop
Seat 6: Kalaboush (big blind) folded before Flop



PokerStars Hand #201506973768:  Hold'em No Limit ($0.05/$0.10 USD) - 2019/06/18 9:46:07 ET
Table 'Moreau III' 6-max Seat #5 is the button
Seat 1: klugkk ($11.73 in chips) 
Seat 2: Briise ($10.73 in chips) 
Seat 3: ReKych ($10 in chips) 
Seat 4: ehrmstyle ($12.71 in chips) 
Seat 5: vsv100 ($9.95 in chips) 
Seat 6: Kalaboush ($31.30 in chips) 
Kalaboush: posts small blind $0.05
klugkk: posts big blind $0.10
klugkk: posts the ante $0.02
Briise: posts the ante $0.02
ReKych: posts the ante $0.02
ehrmstyle: posts the ante $0.02
vsv100: posts the ante $0.02
Kalaboush: posts the ante $0.02
*** HOLE CARDS ***
Briise: folds 
ReKych: folds 
ehrmstyle: folds 
vsv100: folds 
Kalaboush: calls $0.05
klugkk: checks 
*** FLOP *** [4h 9s 7s]
Kalaboush: checks 
klugkk: bets $0.16
Kalaboush: folds 
Uncalled bet ($0.16) returned to klugkk
klugkk collected $0.31 from pot
klugkk: doesn't show hand 
*** SUMMARY ***
Total pot $0.32 | Rake $0.01 
Board [4h 9s 7s]
Seat 1: klugkk (big blind) collected ($0.31)
Seat 2: Briise folded before Flop (didn't bet)
Seat 3: ReKych folded before Flop (didn't bet)
Seat 4: ehrmstyle folded before Flop (didn't bet)
Seat 5: vsv100 (button) folded before Flop (didn't bet)
Seat 6: Kalaboush (small blind) folded on the Flop



PokerStars Hand #201506984938:  Hold'em No Limit ($0.05/$0.10 USD) - 2019/06/18 9:46:38 ET
Table 'Moreau III' 6-max Seat #6 is the button
Seat 1: klugkk ($11.92 in chips) 
Seat 2: Briise ($10.71 in chips) 
Seat 3: ReKych ($10 in chips) 
Seat 4: ehrmstyle ($12.69 in chips) 
Seat 5: vsv100 ($9.93 in chips) 
Seat 6: Kalaboush ($31.18 in chips) 
klugkk: posts small blind $0.05
Briise: posts big blind $0.10
klugkk: posts the ante $0.02
Briise: posts the ante $0.02
ReKych: posts the ante $0.02
ehrmstyle: posts the ante $0.02
vsv100: posts the ante $0.02
Kalaboush: posts the ante $0.02
*** HOLE CARDS ***
ReKych: folds 
ehrmstyle: folds 
vsv100: folds 
Kalaboush: folds 
klugkk: raises $0.30 to $0.40
Briise: folds 
Uncalled bet ($0.30) returned to klugkk
klugkk collected $0.32 from pot
klugkk: doesn't show hand 
*** SUMMARY ***
Total pot $0.32 | Rake $0 
Seat 1: klugkk (small blind) collected ($0.32)
Seat 2: Briise (big blind) folded before Flop
Seat 3: ReKych folded before Flop (didn't bet)
Seat 4: ehrmstyle folded before Flop (didn't bet)
Seat 5: vsv100 folded before Flop (didn't bet)
Seat 6: Kalaboush (button) folded before Flop (didn't bet)



PokerStars Hand #201506990512:  Hold'em No Limit ($0.05/$0.10 USD) - 2019/06/18 9:46:54 ET
Table 'Moreau III' 6-max Seat #1 is the button
Seat 1: klugkk ($12.12 in chips) 
Seat 2: Briise ($10.59 in chips) 
Seat 3: ReKych ($10 in chips) 
Seat 4: ehrmstyle ($12.67 in chips) 
Seat 5: vsv100 ($9.91 in chips) 
Seat 6: Kalaboush ($31.16 in chips) 
Briise: posts small blind $0.05
ReKych: posts big blind $0.10
klugkk: posts the ante $0.02
Briise: posts the ante $0.02
ReKych: posts the ante $0.02
ehrmstyle: posts the ante $0.02
vsv100: posts the ante $0.02
Kalaboush: posts the ante $0.02
*** HOLE CARDS ***
ehrmstyle: folds 
vsv100: folds 
Kalaboush: raises $0.20 to $0.30
klugkk: folds 
Briise: folds 
ReKych: calls $0.20
*** FLOP *** [3s Th 4s]
ReKych: checks 
Kalaboush: checks 
*** TURN *** [3s Th 4s] [6d]
ReKych: bets $0.45
Kalaboush: calls $0.45
*** RIVER *** [3s Th 4s 6d] [2c]
ReKych: bets $1
Kalaboush: calls $1
*** SHOW DOWN ***
ReKych: shows [Qc Ts] (a pair of Tens)
Kalaboush: mucks hand 
ReKych collected $3.50 from pot
*** SUMMARY ***
Total pot $3.67 | Rake $0.17 
Board [3s Th 4s 6d 2c]
Seat 1: klugkk (button) folded before Flop (didn't bet)
Seat 2: Briise (small blind) folded before Flop
Seat 3: ReKych (big blind) showed [Qc Ts] and won ($3.50) with a pair of Tens
Seat 4: ehrmstyle folded before Flop (didn't bet)
Seat 5: vsv100 folded before Flop (didn't bet)
Seat 6: Kalaboush mucked



PokerStars Hand #201507002311:  Hold'em No Limit ($0.05/$0.10 USD) - 2019/06/18 9:47:26 ET
Table 'Moreau III' 6-max Seat #2 is the button
Seat 1: klugkk ($12.10 in chips) 
Seat 2: Briise ($10.52 in chips) 
Seat 3: ReKych ($11.73 in chips) 
Seat 4: ehrmstyle ($12.65 in chips) 
Seat 5: vsv100 ($9.89 in chips) 
Seat 6: Kalaboush ($29.39 in chips) 
ReKych: posts small blind $0.05
ehrmstyle: posts big blind $0.10
klugkk: posts the ante $0.02
Briise: posts the ante $0.02
ReKych: posts the ante $0.02
ehrmstyle: posts the ante $0.02
vsv100: posts the ante $0.02
Kalaboush: posts the ante $0.02
*** HOLE CARDS ***
vsv100: folds 
Kalaboush: raises $0.20 to $0.30
klugkk: folds 
Briise: folds 
ReKych: folds 
ehrmstyle: folds 
Uncalled bet ($0.20) returned to Kalaboush
Kalaboush collected $0.37 from pot
Kalaboush: doesn't show hand 
*** SUMMARY ***
Total pot $0.37 | Rake $0 
Seat 1: klugkk folded before Flop (didn't bet)
Seat 2: Briise (button) folded before Flop (didn't bet)
Seat 3: ReKych (small blind) folded before Flop
Seat 4: ehrmstyle (big blind) folded before Flop
Seat 5: vsv100 folded before Flop (didn't bet)
Seat 6: Kalaboush collected ($0.37)



PokerStars Hand #201507007595:  Hold'em No Limit ($0.05/$0.10 USD) - 2019/06/18 9:47:41 ET
Table 'Moreau III' 6-max Seat #3 is the button
Seat 1: klugkk ($12.08 in chips) 
Seat 2: Briise ($10.50 in chips) 
Seat 3: ReKych ($11.66 in chips) 
Seat 4: ehrmstyle ($12.53 in chips) 
Seat 5: vsv100 ($9.87 in chips) 
Seat 6: Kalaboush ($29.64 in chips) 
ehrmstyle: posts small blind $0.05
vsv100: posts big blind $0.10
klugkk: posts the ante $0.02
Briise: posts the ante $0.02
ReKych: posts the ante $0.02
ehrmstyle: posts the ante $0.02
vsv100: posts the ante $0.02
Kalaboush: posts the ante $0.02
*** HOLE CARDS ***
Kalaboush: raises $0.20 to $0.30
klugkk: folds 
Briise: folds 
ReKych: folds 
ehrmstyle: folds 
vsv100: folds 
Uncalled bet ($0.20) returned to Kalaboush
Kalaboush collected $0.37 from pot
Kalaboush: doesn't show hand 
*** SUMMARY ***
Total pot $0.37 | Rake $0 
Seat 1: klugkk folded before Flop (didn't bet)
Seat 2: Briise folded before Flop (didn't bet)
Seat 3: ReKych (button) folded before Flop (didn't bet)
Seat 4: ehrmstyle (small blind) folded before Flop
Seat 5: vsv100 (big blind) folded before Flop
Seat 6: Kalaboush collected ($0.37)



PokerStars Hand #201507023624:  Hold'em No Limit ($0.05/$0.10 USD) - 2019/06/18 9:48:24 ET
Table 'Moreau III' 6-max Seat #4 is the button
Seat 1: klugkk ($12.06 in chips) 
Seat 2: Briise ($10.48 in chips) 
Seat 3: ReKych ($11.64 in chips) 
Seat 4: ehrmstyle ($12.46 in chips) 
Seat 5: vsv100 ($9.75 in chips) 
Seat 6: Kalaboush ($29.89 in chips) 
vsv100: posts small blind $0.05
Kalaboush: posts big blind $0.10
klugkk: posts the ante $0.02
Briise: posts the ante $0.02
ReKych: posts the ante $0.02
ehrmstyle: posts the ante $0.02
vsv100: posts the ante $0.02
Kalaboush: posts the ante $0.02
*** HOLE CARDS ***
klugkk: folds 
Briise: calls $0.10
ReKych: raises $0.40 to $0.50
ehrmstyle: folds 
vsv100: folds 
Kalaboush: folds 
Briise: calls $0.40
*** FLOP *** [Qd 5c 4h]
Briise: checks 
ReKych: bets $0.40
Briise: folds 
Uncalled bet ($0.40) returned to ReKych
ReKych collected $1.21 from pot
ReKych: doesn't show hand 
*** SUMMARY ***
Total pot $1.27 | Rake $0.06 
Board [Qd 5c 4h]
Seat 1: klugkk folded before Flop (didn't bet)
Seat 2: Briise folded on the Flop
Seat 3: ReKych collected ($1.21)
Seat 4: ehrmstyle (button) folded before Flop (didn't bet)
Seat 5: vsv100 (small blind) folded before Flop
Seat 6: Kalaboush (big blind) folded before Flop



PokerStars Hand #201507039972:  Hold'em No Limit ($0.05/$0.10 USD) - 2019/06/18 9:49:09 ET
Table 'Moreau III' 6-max Seat #5 is the button
Seat 1: klugkk ($12.04 in chips) 
Seat 2: Briise ($9.96 in chips) 
Seat 3: ReKych ($12.33 in chips) 
Seat 4: ehrmstyle ($12.44 in chips) 
Seat 5: vsv100 ($9.68 in chips) 
Seat 6: Kalaboush ($29.77 in chips) 
Kalaboush: posts small blind $0.05
klugkk: posts big blind $0.10
klugkk: posts the ante $0.02
Briise: posts the ante $0.02
ReKych: posts the ante $0.02
ehrmstyle: posts the ante $0.02
vsv100: posts the ante $0.02
Kalaboush: posts the ante $0.02
*** HOLE CARDS ***
Briise: folds 
ReKych: folds 
ehrmstyle: folds 
vsv100: folds 
Kalaboush: folds 
Uncalled bet ($0.05) returned to klugkk
klugkk collected $0.22 from pot
klugkk: doesn't show hand 
*** SUMMARY ***
Total pot $0.22 | Rake $0 
Seat 1: klugkk (big blind) collected ($0.22)
Seat 2: Briise folded before Flop (didn't bet)
Seat 3: ReKych folded before Flop (didn't bet)
Seat 4: ehrmstyle folded before Flop (didn't bet)
Seat 5: vsv100 (button) folded before Flop (didn't bet)
Seat 6: Kalaboush (small blind) folded before Flop



PokerStars Hand #201507043811:  Hold'em No Limit ($0.05/$0.10 USD) - 2019/06/18 9:49:19 ET
Table 'Moreau III' 6-max Seat #6 is the button
Seat 1: klugkk ($12.19 in chips) 
Seat 2: Briise ($9.94 in chips) 
Seat 3: ReKych ($12.31 in chips) 
Seat 4: ehrmstyle ($12.42 in chips) 
Seat 5: vsv100 ($9.66 in chips) 
Seat 6: Kalaboush ($29.70 in chips) 
klugkk: posts small blind $0.05
Briise: posts big blind $0.10
klugkk: posts the ante $0.02
Briise: posts the ante $0.02
ReKych: posts the ante $0.02
ehrmstyle: posts the ante $0.02
vsv100: posts the ante $0.02
Kalaboush: posts the ante $0.02
*** HOLE CARDS ***
ReKych: raises $0.30 to $0.40
ehrmstyle: folds 
vsv100: calls $0.40
Kalaboush: folds 
klugkk: folds 
Briise: calls $0.30
*** FLOP *** [6h 4c 2d]
Briise: checks 
ReKych: bets $0.70
vsv100: folds 
Briise: folds 
Uncalled bet ($0.70) returned to ReKych
ReKych collected $1.31 from pot
ReKych: doesn't show hand 
*** SUMMARY ***
Total pot $1.37 | Rake $0.06 
Board [6h 4c 2d]
Seat 1: klugkk (small blind) folded before Flop
Seat 2: Briise (big blind) folded on the Flop
Seat 3: ReKych collected ($1.31)
Seat 4: ehrmstyle folded before Flop (didn't bet)
Seat 5: vsv100 folded on the Flop
Seat 6: Kalaboush (button) folded before Flop (didn't bet)



PokerStars Hand #201507053338:  Hold'em No Limit ($0.05/$0.10 USD) - 2019/06/18 9:49:46 ET
Table 'Moreau III' 6-max Seat #1 is the button
Seat 1: klugkk ($12.12 in chips) 
Seat 2: Briise ($9.52 in chips) 
Seat 3: ReKych ($13.20 in chips) 
Seat 4: ehrmstyle ($12.40 in chips) 
Seat 5: vsv100 ($9.24 in chips) 
Seat 6: Kalaboush ($29.68 in chips) 
Briise: posts small blind $0.05
ReKych: posts big blind $0.10
klugkk: posts the ante $0.02
Briise: posts the ante $0.02
ReKych: posts the ante $0.02
ehrmstyle: posts the ante $0.02
vsv100: posts the ante $0.02
Kalaboush: posts the ante $0.02
*** HOLE CARDS ***
ehrmstyle: folds 
vsv100: calls $0.10
Kalaboush: raises $0.47 to $0.57
klugkk: folds 
Briise: folds 
ReKych: folds 
vsv100: calls $0.47
*** FLOP *** [Ts Td 9d]
vsv100: checks 
Kalaboush: bets $1
vsv100: folds 
Uncalled bet ($1) returned to Kalaboush
Kalaboush collected $1.35 from pot
Kalaboush: doesn't show hand 
*** SUMMARY ***
Total pot $1.41 | Rake $0.06 
Board [Ts Td 9d]
Seat 1: klugkk (button) folded before Flop (didn't bet)
Seat 2: Briise (small blind) folded before Flop
Seat 3: ReKych (big blind) folded before Flop
Seat 4: ehrmstyle folded before Flop (didn't bet)
Seat 5: vsv100 folded on the Flop
Seat 6: Kalaboush collected ($1.35)



PokerStars Hand #201507067540:  Hold'em No Limit ($0.05/$0.10 USD) - 2019/06/18 9:50:24 ET
Table 'Moreau III' 6-max Seat #2 is the button
Seat 1: klugkk ($12.10 in chips) 
Seat 2: Briise ($9.45 in chips) 
Seat 3: ReKych ($13.08 in chips) 
Seat 4: ehrmstyle ($12.38 in chips) 
Seat 5: vsv100 ($8.65 in chips) 
Seat 6: Kalaboush ($30.44 in chips) 
ReKych: posts small blind $0.05
ehrmstyle: posts big blind $0.10
klugkk: posts the ante $0.02
Briise: posts the ante $0.02
ReKych: posts the ante $0.02
ehrmstyle: posts the ante $0.02
vsv100: posts the ante $0.02
Kalaboush: posts the ante $0.02
*** HOLE CARDS ***
vsv100: calls $0.10
Kalaboush: folds 
klugkk: raises $0.30 to $0.40
Briise: folds 
ReKych: folds 
ehrmstyle: folds 
vsv100: calls $0.30
*** FLOP *** [Tc Ah Qd]
vsv100: checks 
klugkk: bets $1.02
vsv100: folds 
Uncalled bet ($1.02) returned to klugkk
klugkk collected $1.02 from pot
klugkk: doesn't show hand 
*** SUMMARY ***
Total pot $1.07 | Rake $0.05 
Board [Tc Ah Qd]
Seat 1: klugkk collected ($1.02)
Seat 2: Briise (button) folded before Flop (didn't bet)
Seat 3: ReKych (small blind) folded before Flop
Seat 4: ehrmstyle (big blind) folded before Flop
Seat 5: vsv100 folded on the Flop
Seat 6: Kalaboush folded before Flop (didn't bet)



PokerStars Hand #201507077004:  Hold'em No Limit ($0.05/$0.10 USD) - 2019/06/18 9:50:50 ET
Table 'Moreau III' 6-max Seat #3 is the button
Seat 1: klugkk ($12.70 in chips) 
Seat 2: Briise ($9.43 in chips) 
Seat 3: ReKych ($13.01 in chips) 
Seat 4: ehrmstyle ($12.26 in chips) 
Seat 5: vsv100 ($8.23 in chips) 
Seat 6: Kalaboush ($30.42 in chips) 
ehrmstyle: posts small blind $0.05
vsv100: posts big blind $0.10
klugkk: posts the ante $0.02
Briise: posts the ante $0.02
ReKych: posts the ante $0.02
ehrmstyle: posts the ante $0.02
vsv100: posts the ante $0.02
Kalaboush: posts the ante $0.02
*** HOLE CARDS ***
Kalaboush: raises $0.20 to $0.30
klugkk: raises $0.87 to $1.17
Briise: folds 
ReKych: folds 
ehrmstyle: folds 
vsv100: folds 
Kalaboush: folds 
Uncalled bet ($0.87) returned to klugkk
klugkk collected $0.87 from pot
klugkk: doesn't show hand 
*** SUMMARY ***
Total pot $0.87 | Rake $0 
Seat 1: klugkk collected ($0.87)
Seat 2: Briise folded before Flop (didn't bet)
Seat 3: ReKych (button) folded before Flop (didn't bet)
Seat 4: ehrmstyle (small blind) folded before Flop
Seat 5: vsv100 (big blind) folded before Flop
Seat 6: Kalaboush folded before Flop



PokerStars Hand #201507086796:  Hold'em No Limit ($0.05/$0.10 USD) - 2019/06/18 9:51:17 ET
Table 'Moreau III' 6-max Seat #4 is the button
Seat 1: klugkk ($13.25 in chips) 
Seat 2: Briise ($9.41 in chips) 
Seat 3: ReKych ($12.99 in chips) 
Seat 4: ehrmstyle ($12.19 in chips) 
Seat 5: vsv100 ($8.11 in chips) 
Seat 6: Kalaboush ($30.10 in chips) 
vsv100: posts small blind $0.05
Kalaboush: posts big blind $0.10
klugkk: posts the ante $0.02
Briise: posts the ante $0.02
ReKych: posts the ante $0.02
ehrmstyle: posts the ante $0.02
vsv100: posts the ante $0.02
Kalaboush: posts the ante $0.02
*** HOLE CARDS ***
klugkk: folds 
Briise: folds 
ReKych: raises $0.20 to $0.30
ehrmstyle: folds 
klugkk leaves the table
togl63amg joins the table at seat #1 
vsv100: calls $0.25
Kalaboush: calls $0.20
*** FLOP *** [3s 7d 6c]
vsv100: bets $0.49
Kalaboush: calls $0.49
ReKych: calls $0.49
*** TURN *** [3s 7d 6c] [8s]
vsv100: bets $0.40
Kalaboush: calls $0.40
ReKych: folds 
*** RIVER *** [3s 7d 6c 8s] [3c]
vsv100: checks 
Kalaboush: bets $1.60
vsv100: folds 
Uncalled bet ($1.60) returned to Kalaboush
Kalaboush collected $3.14 from pot
Kalaboush: doesn't show hand 
*** SUMMARY ***
Total pot $3.29 | Rake $0.15 
Board [3s 7d 6c 8s 3c]
Seat 1: klugkk folded before Flop (didn't bet)
Seat 2: Briise folded before Flop (didn't bet)
Seat 3: ReKych folded on the Turn
Seat 4: ehrmstyle (button) folded before Flop (didn't bet)
Seat 5: vsv100 (small blind) folded on the River
Seat 6: Kalaboush (big blind) collected ($3.14)



PokerStars Hand #201507106796:  Hold'em No Limit ($0.05/$0.10 USD) - 2019/06/18 9:52:13 ET
Table 'Moreau III' 6-max Seat #5 is the button
Seat 1: togl63amg ($10 in chips) 
Seat 2: Briise ($9.39 in chips) 
Seat 3: ReKych ($12.18 in chips) 
Seat 4: ehrmstyle ($12.17 in chips) 
Seat 5: vsv100 ($6.90 in chips) 
Seat 6: Kalaboush ($32.03 in chips) 
Kalaboush: posts small blind $0.05
togl63amg: posts big blind $0.10
togl63amg: posts the ante $0.02
Briise: posts the ante $0.02
ReKych: posts the ante $0.02
ehrmstyle: posts the ante $0.02
vsv100: posts the ante $0.02
Kalaboush: posts the ante $0.02
*** HOLE CARDS ***
Briise: raises $0.20 to $0.30
ReKych: folds 
ehrmstyle: folds 
vsv100: calls $0.30
Kalaboush: calls $0.25
togl63amg: calls $0.20
*** FLOP *** [4d Js 5s]
Kalaboush: checks 
togl63amg: checks 
Briise: bets $0.50
vsv100: calls $0.50
Kalaboush: calls $0.50
togl63amg: folds 
*** TURN *** [4d Js 5s] [Th]
Kalaboush: checks 
Briise: checks 
vsv100: checks 
*** RIVER *** [4d Js 5s Th] [8s]
Kalaboush: checks 
Briise: checks 
vsv100: checks 
*** SHOW DOWN ***
Kalaboush: shows [Jd Tc] (two pair, Jacks and Tens)
Briise: mucks hand 
vsv100: mucks hand 
Kalaboush collected $2.69 from pot
*** SUMMARY ***
Total pot $2.82 | Rake $0.13 
Board [4d Js 5s Th 8s]
Seat 1: togl63amg (big blind) folded on the Flop
Seat 2: Briise mucked
Seat 3: ReKych folded before Flop (didn't bet)
Seat 4: ehrmstyle folded before Flop (didn't bet)
Seat 5: vsv100 (button) mucked
Seat 6: Kalaboush (small blind) showed [Jd Tc] and won ($2.69) with two pair, Jacks and Tens



PokerStars Hand #201507131487:  Hold'em No Limit ($0.05/$0.10 USD) - 2019/06/18 9:53:21 ET
Table 'Moreau III' 6-max Seat #6 is the button
Seat 1: togl63amg ($10 in chips) 
Seat 2: Briise ($8.57 in chips) 
Seat 3: ReKych ($12.16 in chips) 
Seat 4: ehrmstyle ($12.15 in chips) 
Seat 5: vsv100 ($6.08 in chips) 
Seat 6: Kalaboush ($33.90 in chips) 
togl63amg: posts small blind $0.05
Briise: posts big blind $0.10
togl63amg: posts the ante $0.02
Briise: posts the ante $0.02
ReKych: posts the ante $0.02
ehrmstyle: posts the ante $0.02
vsv100: posts the ante $0.02
Kalaboush: posts the ante $0.02
*** HOLE CARDS ***
ReKych: folds 
ehrmstyle: raises $0.20 to $0.30
vsv100: folds 
Kalaboush: calls $0.30
togl63amg: folds 
Briise: folds 
*** FLOP *** [9h Jh 2c]
ehrmstyle: bets $0.42
Kalaboush: raises $0.42 to $0.84
ehrmstyle: calls $0.42
*** TURN *** [9h Jh 2c] [6h]
ehrmstyle: bets $1.22
Kalaboush: folds 
Uncalled bet ($1.22) returned to ehrmstyle
ehrmstyle collected $2.44 from pot
ehrmstyle: doesn't show hand 
*** SUMMARY ***
Total pot $2.55 | Rake $0.11 
Board [9h Jh 2c 6h]
Seat 1: togl63amg (small blind) folded before Flop
Seat 2: Briise (big blind) folded before Flop
Seat 3: ReKych folded before Flop (didn't bet)
Seat 4: ehrmstyle collected ($2.44)
Seat 5: vsv100 folded before Flop (didn't bet)
Seat 6: Kalaboush (button) folded on the Turn



PokerStars Hand #201507145466:  Hold'em No Limit ($0.05/$0.10 USD) - 2019/06/18 9:53:59 ET
Table 'Moreau III' 6-max Seat #1 is the button
Seat 1: togl63amg ($10 in chips) 
Seat 2: Briise ($8.45 in chips) 
Seat 3: ReKych ($12.14 in chips) 
Seat 4: ehrmstyle ($13.43 in chips) 
Seat 5: vsv100 ($6.06 in chips) 
Seat 6: Kalaboush ($32.74 in chips) 
Briise: posts small blind $0.05
ReKych: posts big blind $0.10
togl63amg: posts the ante $0.02
Briise: posts the ante $0.02
ReKych: posts the ante $0.02
ehrmstyle: posts the ante $0.02
vsv100: posts the ante $0.02
Kalaboush: posts the ante $0.02
*** HOLE CARDS ***
ehrmstyle: raises $0.20 to $0.30
vsv100: folds 
Kalaboush: folds 
togl63amg: folds 
Briise: folds 
ReKych: folds 
Uncalled bet ($0.20) returned to ehrmstyle
ehrmstyle collected $0.37 from pot
ehrmstyle: doesn't show hand 
*** SUMMARY ***
Total pot $0.37 | Rake $0 
Seat 1: togl63amg (button) folded before Flop (didn't bet)
Seat 2: Briise (small blind) folded before Flop
Seat 3: ReKych (big blind) folded before Flop
Seat 4: ehrmstyle collected ($0.37)
Seat 5: vsv100 folded before Flop (didn't bet)
Seat 6: Kalaboush folded before Flop (didn't bet)



PokerStars Hand #201507154098:  Hold'em No Limit ($0.05/$0.10 USD) - 2019/06/18 9:54:23 ET
Table 'Moreau III' 6-max Seat #2 is the button
Seat 1: togl63amg ($10 in chips) 
Seat 2: Briise ($8.38 in chips) 
Seat 3: ReKych ($12.02 in chips) 
Seat 5: vsv100 ($6.04 in chips) 
Seat 6: Kalaboush ($32.72 in chips) 
ReKych: posts small blind $0.05
ehrmstyle: is sitting out 
vsv100: posts big blind $0.10
togl63amg: posts the ante $0.02
Briise: posts the ante $0.02
ReKych: posts the ante $0.02
vsv100: posts the ante $0.02
Kalaboush: posts the ante $0.02
*** HOLE CARDS ***
Kalaboush: folds 
togl63amg: folds 
ehrmstyle leaves the table
Briise: folds 
ReKych: raises $0.20 to $0.30
vsv100: folds 
Uncalled bet ($0.20) returned to ReKych
ReKych collected $0.30 from pot
ReKych: doesn't show hand 
vsv100 leaves the table
*** SUMMARY ***
Total pot $0.30 | Rake $0 
Seat 1: togl63amg folded before Flop (didn't bet)
Seat 2: Briise (button) folded before Flop (didn't bet)
Seat 3: ReKych (small blind) collected ($0.30)
Seat 5: vsv100 (big blind) folded before Flop
Seat 6: Kalaboush folded before Flop (didn't bet)



PokerStars Hand #201507162571:  Hold'em No Limit ($0.05/$0.10 USD) - 2019/06/18 9:54:46 ET
Table 'Moreau III' 6-max Seat #3 is the button
Seat 1: togl63amg ($10 in chips) 
Seat 2: Briise ($8.36 in chips) 
Seat 3: ReKych ($12.20 in chips) 
Seat 6: Kalaboush ($32.70 in chips) 
Kalaboush: posts small blind $0.05
togl63amg: posts big blind $0.10
togl63amg: posts the ante $0.02
Briise: posts the ante $0.02
ReKych: posts the ante $0.02
Kalaboush: posts the ante $0.02
*** HOLE CARDS ***
Briise: raises $0.20 to $0.30
ReKych: folds 
Kalaboush: raises $0.78 to $1.08
togl63amg: folds 
Briise: calls $0.78
*** FLOP *** [Qc Th Qh]
Kalaboush: bets $1.10
Briise: folds 
Uncalled bet ($1.10) returned to Kalaboush
Kalaboush collected $2.23 from pot
Kalaboush: doesn't show hand 
*** SUMMARY ***
Total pot $2.34 | Rake $0.11 
Board [Qc Th Qh]
Seat 1: togl63amg (big blind) folded before Flop
Seat 2: Briise folded on the Flop
Seat 3: ReKych (button) folded before Flop (didn't bet)
Seat 6: Kalaboush (small blind) collected ($2.23)



PokerStars Hand #201507183356:  Hold'em No Limit ($0.05/$0.10 USD) - 2019/06/18 9:55:48 ET
Table 'Moreau III' 6-max Seat #6 is the button
Seat 1: togl63amg ($10 in chips) 
Seat 2: Briise ($7.26 in chips) 
Seat 3: ReKych ($12.18 in chips) 
Seat 6: Kalaboush ($33.83 in chips) 
togl63amg: posts small blind $0.05
Briise: posts big blind $0.10
togl63amg: posts the ante $0.02
Briise: posts the ante $0.02
ReKych: posts the ante $0.02
Kalaboush: posts the ante $0.02
*** HOLE CARDS ***
ReKych: folds 
Kalaboush: folds 
togl63amg: raises $0.20 to $0.30
Briise: folds 
Uncalled bet ($0.20) returned to togl63amg
togl63amg collected $0.28 from pot
*** SUMMARY ***
Total pot $0.28 | Rake $0 
Seat 1: togl63amg (small blind) collected ($0.28)
Seat 2: Briise (big blind) folded before Flop
Seat 3: ReKych folded before Flop (didn't bet)
Seat 6: Kalaboush (button) folded before Flop (didn't bet)



PokerStars Hand #201507187701:  Hold'em No Limit ($0.05/$0.10 USD) - 2019/06/18 9:56:02 ET
Table 'Moreau III' 6-max Seat #1 is the button
Seat 1: togl63amg ($10.16 in chips) 
Seat 2: Briise ($7.14 in chips) 
Seat 3: ReKych ($12.16 in chips) 
Seat 6: Kalaboush ($33.81 in chips) 
Briise: posts small blind $0.05
ReKych: posts big blind $0.10
togl63amg: posts the ante $0.02
Briise: posts the ante $0.02
ReKych: posts the ante $0.02
Kalaboush: posts the ante $0.02
*** HOLE CARDS ***
eeeLOVEnkov joins the table at seat #5 
Kalaboush: raises $0.20 to $0.30
togl63amg: folds 
Briise: calls $0.25
razukhin joins the table at seat #4 
ReKych: folds 
*** FLOP *** [Tc 6d 8h]
Briise: checks 
razukhin leaves the table
Kalaboush: bets $0.40
Briise: folds 
Uncalled bet ($0.40) returned to Kalaboush
Kalaboush collected $0.74 from pot
Kalaboush: doesn't show hand 
*** SUMMARY ***
Total pot $0.78 | Rake $0.04 
Board [Tc 6d 8h]
Seat 1: togl63amg (button) folded before Flop (didn't bet)
Seat 2: Briise (small blind) folded on the Flop
Seat 3: ReKych (big blind) folded before Flop
Seat 6: Kalaboush collected ($0.74)



PokerStars Hand #201507197854:  Hold'em No Limit ($0.05/$0.10 USD) - 2019/06/18 9:56:34 ET
Table 'Moreau III' 6-max Seat #2 is the button
Seat 1: togl63amg ($10.14 in chips) 
Seat 2: Briise ($6.82 in chips) 
Seat 3: ReKych ($12.04 in chips) 
Seat 5: eeeLOVEnkov ($10 in chips) 
Seat 6: Kalaboush ($34.23 in chips) 
ReKych: posts small blind $0.05
eeeLOVEnkov: posts big blind $0.10
togl63amg: posts the ante $0.02
Briise: posts the ante $0.02
ReKych: posts the ante $0.02
eeeLOVEnkov: posts the ante $0.02
Kalaboush: posts the ante $0.02
*** HOLE CARDS ***
Kalaboush: calls $0.10
togl63amg: folds 
Briise: folds 
Briise leaves the table
ReKych: calls $0.05
eeeLOVEnkov: raises $0.40 to $0.50
Kalaboush: calls $0.40
ReKych: folds 
*** FLOP *** [2c 3d 5d]
eeeLOVEnkov: checks 
Kalaboush: checks 
*** TURN *** [2c 3d 5d] [Js]
eeeLOVEnkov: checks 
Kalaboush: bets $0.60
eeeLOVEnkov: folds 
Uncalled bet ($0.60) returned to Kalaboush
Kalaboush collected $1.15 from pot
Kalaboush: doesn't show hand 
*** SUMMARY ***
Total pot $1.20 | Rake $0.05 
Board [2c 3d 5d Js]
Seat 1: togl63amg folded before Flop (didn't bet)
Seat 2: Briise (button) folded before Flop (didn't bet)
Seat 3: ReKych (small blind) folded before Flop
Seat 5: eeeLOVEnkov (big blind) folded on the Turn
Seat 6: Kalaboush collected ($1.15)



PokerStars Hand #201507212145:  Hold'em No Limit ($0.05/$0.10 USD) - 2019/06/18 9:57:20 ET
Table 'Moreau III' 6-max Seat #3 is the button
Seat 1: togl63amg ($10.12 in chips) 
Seat 3: ReKych ($11.92 in chips) 
Seat 5: eeeLOVEnkov ($10 in chips) 
Seat 6: Kalaboush ($34.86 in chips) 
eeeLOVEnkov: posts small blind $0.05
Kalaboush: posts big blind $0.10
togl63amg: posts the ante $0.02
ReKych: posts the ante $0.02
eeeLOVEnkov: posts the ante $0.02
Kalaboush: posts the ante $0.02
*** HOLE CARDS ***
togl63amg: raises $0.20 to $0.30
nemomen1 joins the table at seat #2 
ReKych: folds 
eeeLOVEnkov: folds 
Kalaboush: calls $0.20
*** FLOP *** [6c 3h 7c]
Kalaboush: checks 
togl63amg: bets $0.39
Kalaboush: calls $0.39
*** TURN *** [6c 3h 7c] [2d]
Kalaboush: checks 
togl63amg: bets $1.01
Kalaboush: calls $1.01
*** RIVER *** [6c 3h 7c 2d] [Jh]
Kalaboush: checks 
togl63amg: bets $1.35
Kalaboush: calls $1.35
Klim_89 joins the table at seat #4 
*** SHOW DOWN ***
togl63amg: shows [8c 9c] (high card Jack)
Kalaboush: shows [6d 4c] (a pair of Sixes)
Kalaboush collected $5.95 from pot
*** SUMMARY ***
Total pot $6.23 | Rake $0.28 
Board [6c 3h 7c 2d Jh]
Seat 1: togl63amg showed [8c 9c] and lost with high card Jack
Seat 3: ReKych (button) folded before Flop (didn't bet)
Seat 5: eeeLOVEnkov (small blind) folded before Flop
Seat 6: Kalaboush (big blind) showed [6d 4c] and won ($5.95) with a pair of Sixes



PokerStars Hand #201507227030:  Hold'em No Limit ($0.05/$0.10 USD) - 2019/06/18 9:58:07 ET
Table 'Moreau III' 6-max Seat #5 is the button
Seat 1: togl63amg ($10 in chips) 
Seat 2: nemomen1 ($8 in chips) 
Seat 3: ReKych ($11.90 in chips) 
Seat 5: eeeLOVEnkov ($10 in chips) 
Seat 6: Kalaboush ($37.74 in chips) 
Kalaboush: posts small blind $0.05
togl63amg: posts big blind $0.10
nemomen1: posts big blind $0.10
Klim_89: sits out 
togl63amg: posts the ante $0.02
nemomen1: posts the ante $0.02
ReKych: posts the ante $0.02
eeeLOVEnkov: posts the ante $0.02
Kalaboush: posts the ante $0.02
*** HOLE CARDS ***
nemomen1: checks 
ReKych: folds 
eeeLOVEnkov: folds 
Kalaboush: folds 
togl63amg: checks 
*** FLOP *** [9d Qc 2d]
togl63amg: bets $0.18
nemomen1: folds 
Uncalled bet ($0.18) returned to togl63amg
togl63amg collected $0.33 from pot
*** SUMMARY ***
Total pot $0.35 | Rake $0.02 
Board [9d Qc 2d]
Seat 1: togl63amg (big blind) collected ($0.33)
Seat 2: nemomen1 folded on the Flop (didn't bet)
Seat 3: ReKych folded before Flop (didn't bet)
Seat 5: eeeLOVEnkov (button) folded before Flop (didn't bet)
Seat 6: Kalaboush (small blind) folded before Flop



PokerStars Hand #201507236684:  Hold'em No Limit ($0.05/$0.10 USD) - 2019/06/18 9:58:37 ET
Table 'Moreau III' 6-max Seat #6 is the button
Seat 1: togl63amg ($10.21 in chips) 
Seat 2: nemomen1 ($7.88 in chips) 
Seat 3: ReKych ($11.88 in chips) 
Seat 5: eeeLOVEnkov ($10 in chips) 
Seat 6: Kalaboush ($37.67 in chips) 
togl63amg: posts small blind $0.05
nemomen1: posts big blind $0.10
Klim_89: sits out 
togl63amg: posts the ante $0.02
nemomen1: posts the ante $0.02
ReKych: posts the ante $0.02
eeeLOVEnkov: posts the ante $0.02
Kalaboush: posts the ante $0.02
*** HOLE CARDS ***
ReKych: raises $0.40 to $0.50
eeeLOVEnkov: folds 
Kalaboush: folds 
togl63amg: folds 
nemomen1: calls $0.40
*** FLOP *** [Td 6c Ks]
nemomen1: checks 
ReKych: checks 
*** TURN *** [Td 6c Ks] [Th]
nemomen1: checks 
ReKych: checks 
*** RIVER *** [Td 6c Ks Th] [Ts]
nemomen1: bets $1.10
ReKych: folds 
Uncalled bet ($1.10) returned to nemomen1
nemomen1 collected $1.10 from pot
*** SUMMARY ***
Total pot $1.15 | Rake $0.05 
Board [Td 6c Ks Th Ts]
Seat 1: togl63amg (small blind) folded before Flop
Seat 2: nemomen1 (big blind) collected ($1.10)
Seat 3: ReKych folded on the River
Seat 5: eeeLOVEnkov folded before Flop (didn't bet)
Seat 6: Kalaboush (button) folded before Flop (didn't bet)



PokerStars Hand #201507249827:  Hold'em No Limit ($0.05/$0.10 USD) - 2019/06/18 9:59:19 ET
Table 'Moreau III' 6-max Seat #1 is the button
Seat 1: togl63amg ($10.14 in chips) 
Seat 2: nemomen1 ($8.46 in chips) 
Seat 3: ReKych ($11.36 in chips) 
Seat 5: eeeLOVEnkov ($10 in chips) 
Seat 6: Kalaboush ($37.65 in chips) 
nemomen1: posts small blind $0.05
ReKych: posts big blind $0.10
Klim_89: sits out 
togl63amg: posts the ante $0.02
nemomen1: posts the ante $0.02
ReKych: posts the ante $0.02
eeeLOVEnkov: posts the ante $0.02
Kalaboush: posts the ante $0.02
*** HOLE CARDS ***
eeeLOVEnkov: folds 
Kalaboush: folds 
togl63amg: raises $0.20 to $0.30
nemomen1: calls $0.25
ReKych: folds 
*** FLOP *** [5c 5s Jc]
nemomen1: bets $0.38
togl63amg: folds 
Uncalled bet ($0.38) returned to nemomen1
nemomen1 collected $0.76 from pot
*** SUMMARY ***
Total pot $0.80 | Rake $0.04 
Board [5c 5s Jc]
Seat 1: togl63amg (button) folded on the Flop
Seat 2: nemomen1 (small blind) collected ($0.76)
Seat 3: ReKych (big blind) folded before Flop
Seat 5: eeeLOVEnkov folded before Flop (didn't bet)
Seat 6: Kalaboush folded before Flop (didn't bet)



PokerStars Hand #201507260439:  Hold'em No Limit ($0.05/$0.10 USD) - 2019/06/18 9:59:52 ET
Table 'Moreau III' 6-max Seat #2 is the button
Seat 1: togl63amg ($10 in chips) 
Seat 2: nemomen1 ($8.90 in chips) 
Seat 3: ReKych ($11.24 in chips) 
Seat 4: Klim_89 ($10 in chips) 
Seat 5: eeeLOVEnkov ($10 in chips) 
Seat 6: Kalaboush ($37.63 in chips) 
ReKych: posts small blind $0.05
Klim_89: posts big blind $0.10
togl63amg: posts the ante $0.02
nemomen1: posts the ante $0.02
ReKych: posts the ante $0.02
Klim_89: posts the ante $0.02
eeeLOVEnkov: posts the ante $0.02
Kalaboush: posts the ante $0.02
*** HOLE CARDS ***
eeeLOVEnkov: raises $0.20 to $0.30
Kalaboush: folds 
togl63amg: folds 
nemomen1: folds 
ReKych: folds 
Klim_89: folds 
Uncalled bet ($0.20) returned to eeeLOVEnkov
eeeLOVEnkov collected $0.37 from pot
eeeLOVEnkov: doesn't show hand 
*** SUMMARY ***
Total pot $0.37 | Rake $0 
Seat 1: togl63amg folded before Flop (didn't bet)
Seat 2: nemomen1 (button) folded before Flop (didn't bet)
Seat 3: ReKych (small blind) folded before Flop
Seat 4: Klim_89 (big blind) folded before Flop
Seat 5: eeeLOVEnkov collected ($0.37)
Seat 6: Kalaboush folded before Flop (didn't bet)



PokerStars Hand #201507266271:  Hold'em No Limit ($0.05/$0.10 USD) - 2019/06/18 10:00:10 ET
Table 'Moreau III' 6-max Seat #3 is the button
Seat 1: togl63amg ($10 in chips) 
Seat 2: nemomen1 ($8.88 in chips) 
Seat 3: ReKych ($11.17 in chips) 
Seat 4: Klim_89 ($10 in chips) 
Seat 5: eeeLOVEnkov ($10.25 in chips) 
Seat 6: Kalaboush ($37.61 in chips) 
Klim_89: posts small blind $0.05
eeeLOVEnkov: posts big blind $0.10
togl63amg: posts the ante $0.02
nemomen1: posts the ante $0.02
ReKych: posts the ante $0.02
Klim_89: posts the ante $0.02
eeeLOVEnkov: posts the ante $0.02
Kalaboush: posts the ante $0.02
*** HOLE CARDS ***
Kalaboush: raises $0.10 to $0.20
togl63amg: folds 
nemomen1: folds 
ReKych: folds 
Klim_89: folds 
eeeLOVEnkov: folds 
Uncalled bet ($0.10) returned to Kalaboush
Kalaboush collected $0.37 from pot
Kalaboush: doesn't show hand 
*** SUMMARY ***
Total pot $0.37 | Rake $0 
Seat 1: togl63amg folded before Flop (didn't bet)
Seat 2: nemomen1 folded before Flop (didn't bet)
Seat 3: ReKych (button) folded before Flop (didn't bet)
Seat 4: Klim_89 (small blind) folded before Flop
Seat 5: eeeLOVEnkov (big blind) folded before Flop
Seat 6: Kalaboush collected ($0.37)



PokerStars Hand #201507269626:  Hold'em No Limit ($0.05/$0.10 USD) - 2019/06/18 10:00:20 ET
Table 'Moreau III' 6-max Seat #4 is the button
Seat 1: togl63amg ($10 in chips) 
Seat 2: nemomen1 ($8.86 in chips) 
Seat 3: ReKych ($11.15 in chips) 
Seat 4: Klim_89 ($10 in chips) 
Seat 5: eeeLOVEnkov ($10.13 in chips) 
Seat 6: Kalaboush ($37.86 in chips) 
eeeLOVEnkov: posts small blind $0.05
Kalaboush: posts big blind $0.10
togl63amg: posts the ante $0.02
nemomen1: posts the ante $0.02
ReKych: posts the ante $0.02
Klim_89: posts the ante $0.02
eeeLOVEnkov: posts the ante $0.02
Kalaboush: posts the ante $0.02
*** HOLE CARDS ***
togl63amg: folds 
nemomen1: folds 
ReKych: raises $0.30 to $0.40
Klim_89: folds 
eeeLOVEnkov: folds 
Kalaboush: calls $0.30
*** FLOP *** [8h 3s Ah]
Kalaboush: checks 
ReKych: bets $0.55
Kalaboush: folds 
Uncalled bet ($0.55) returned to ReKych
ReKych collected $0.93 from pot
ReKych: doesn't show hand 
*** SUMMARY ***
Total pot $0.97 | Rake $0.04 
Board [8h 3s Ah]
Seat 1: togl63amg folded before Flop (didn't bet)
Seat 2: nemomen1 folded before Flop (didn't bet)
Seat 3: ReKych collected ($0.93)
Seat 4: Klim_89 (button) folded before Flop (didn't bet)
Seat 5: eeeLOVEnkov (small blind) folded before Flop
Seat 6: Kalaboush (big blind) folded on the Flop



PokerStars Hand #201507278316:  Hold'em No Limit ($0.05/$0.10 USD) - 2019/06/18 10:00:46 ET
Table 'Moreau III' 6-max Seat #5 is the button
Seat 1: togl63amg ($10 in chips) 
Seat 2: nemomen1 ($8.84 in chips) 
Seat 3: ReKych ($11.66 in chips) 
Seat 4: Klim_89 ($10 in chips) 
Seat 5: eeeLOVEnkov ($10.06 in chips) 
Seat 6: Kalaboush ($37.44 in chips) 
Kalaboush: posts small blind $0.05
togl63amg: posts big blind $0.10
togl63amg: posts the ante $0.02
nemomen1: posts the ante $0.02
ReKych: posts the ante $0.02
Klim_89: posts the ante $0.02
eeeLOVEnkov: posts the ante $0.02
Kalaboush: posts the ante $0.02
*** HOLE CARDS ***
nemomen1: calls $0.10
ReKych: folds 
Klim_89: folds 
eeeLOVEnkov: folds 
Kalaboush: calls $0.05
togl63amg: checks 
*** FLOP *** [Qc 8c Kh]
Kalaboush: checks 
togl63amg: checks 
nemomen1: bets $0.10
Kalaboush: folds 
togl63amg: folds 
Uncalled bet ($0.10) returned to nemomen1
nemomen1 collected $0.40 from pot
*** SUMMARY ***
Total pot $0.42 | Rake $0.02 
Board [Qc 8c Kh]
Seat 1: togl63amg (big blind) folded on the Flop
Seat 2: nemomen1 collected ($0.40)
Seat 3: ReKych folded before Flop (didn't bet)
Seat 4: Klim_89 folded before Flop (didn't bet)
Seat 5: eeeLOVEnkov (button) folded before Flop (didn't bet)
Seat 6: Kalaboush (small blind) folded on the Flop



PokerStars Hand #201507287162:  Hold'em No Limit ($0.05/$0.10 USD) - 2019/06/18 10:01:12 ET
Table 'Moreau III' 6-max Seat #6 is the button
Seat 1: togl63amg ($10 in chips) 
Seat 2: nemomen1 ($9.12 in chips) 
Seat 3: ReKych ($11.64 in chips) 
Seat 4: Klim_89 ($10 in chips) 
Seat 5: eeeLOVEnkov ($10.04 in chips) 
Seat 6: Kalaboush ($37.32 in chips) 
togl63amg: posts small blind $0.05
nemomen1: posts big blind $0.10
togl63amg: posts the ante $0.02
nemomen1: posts the ante $0.02
ReKych: posts the ante $0.02
Klim_89: posts the ante $0.02
eeeLOVEnkov: posts the ante $0.02
Kalaboush: posts the ante $0.02
*** HOLE CARDS ***
ReKych: folds 
Klim_89: folds 
eeeLOVEnkov: folds 
Kalaboush: folds 
togl63amg: raises $0.20 to $0.30
nemomen1: folds 
Uncalled bet ($0.20) returned to togl63amg
togl63amg collected $0.32 from pot
*** SUMMARY ***
Total pot $0.32 | Rake $0 
Seat 1: togl63amg (small blind) collected ($0.32)
Seat 2: nemomen1 (big blind) folded before Flop
Seat 3: ReKych folded before Flop (didn't bet)
Seat 4: Klim_89 folded before Flop (didn't bet)
Seat 5: eeeLOVEnkov folded before Flop (didn't bet)
Seat 6: Kalaboush (button) folded before Flop (didn't bet)



PokerStars Hand #201507294297:  Hold'em No Limit ($0.05/$0.10 USD) - 2019/06/18 10:01:32 ET
Table 'Moreau III' 6-max Seat #1 is the button
Seat 1: togl63amg ($10.20 in chips) 
Seat 2: nemomen1 ($9 in chips) 
Seat 3: ReKych ($11.62 in chips) 
Seat 4: Klim_89 ($10 in chips) 
Seat 5: eeeLOVEnkov ($10.02 in chips) 
Seat 6: Kalaboush ($37.30 in chips) 
nemomen1: posts small blind $0.05
ReKych: posts big blind $0.10
togl63amg: posts the ante $0.02
nemomen1: posts the ante $0.02
ReKych: posts the ante $0.02
Klim_89: posts the ante $0.02
eeeLOVEnkov: posts the ante $0.02
Kalaboush: posts the ante $0.02
*** HOLE CARDS ***
Klim_89: folds 
eeeLOVEnkov: folds 
Kalaboush: raises $0.10 to $0.20
togl63amg: folds 
nemomen1: calls $0.15
ReKych: calls $0.10
*** FLOP *** [2s Ah 6d]
nemomen1: bets $0.35
ReKych: folds 
Kalaboush: folds 
Uncalled bet ($0.35) returned to nemomen1
nemomen1 collected $0.69 from pot
*** SUMMARY ***
Total pot $0.72 | Rake $0.03 
Board [2s Ah 6d]
Seat 1: togl63amg (button) folded before Flop (didn't bet)
Seat 2: nemomen1 (small blind) collected ($0.69)
Seat 3: ReKych (big blind) folded on the Flop
Seat 4: Klim_89 folded before Flop (didn't bet)
Seat 5: eeeLOVEnkov folded before Flop (didn't bet)
Seat 6: Kalaboush folded on the Flop



PokerStars Hand #201507304103:  Hold'em No Limit ($0.05/$0.10 USD) - 2019/06/18 10:01:59 ET
Table 'Moreau III' 6-max Seat #2 is the button
Seat 1: togl63amg ($10.18 in chips) 
Seat 2: nemomen1 ($9.47 in chips) 
Seat 3: ReKych ($11.40 in chips) 
Seat 4: Klim_89 ($10 in chips) 
Seat 5: eeeLOVEnkov ($10 in chips) 
Seat 6: Kalaboush ($37.08 in chips) 
ReKych: posts small blind $0.05
Klim_89: posts big blind $0.10
togl63amg: posts the ante $0.02
nemomen1: posts the ante $0.02
ReKych: posts the ante $0.02
Klim_89: posts the ante $0.02
eeeLOVEnkov: posts the ante $0.02
Kalaboush: posts the ante $0.02
*** HOLE CARDS ***
eeeLOVEnkov: folds 
Kalaboush: calls $0.10
togl63amg: folds 
nemomen1: calls $0.10
ReKych: calls $0.05
Klim_89: checks 
*** FLOP *** [Js Kh 4h]
ReKych: bets $0.30
Klim_89: calls $0.30
Kalaboush: folds 
nemomen1: folds 
*** TURN *** [Js Kh 4h] [9h]
ReKych: checks 
Klim_89: checks 
*** RIVER *** [Js Kh 4h 9h] [8c]
ReKych: checks 
Klim_89: checks 
*** SHOW DOWN ***
ReKych: shows [5c Kc] (a pair of Kings)
Klim_89: shows [8s Ks] (two pair, Kings and Eights)
Klim_89 collected $1.07 from pot
*** SUMMARY ***
Total pot $1.12 | Rake $0.05 
Board [Js Kh 4h 9h 8c]
Seat 1: togl63amg folded before Flop (didn't bet)
Seat 2: nemomen1 (button) folded on the Flop
Seat 3: ReKych (small blind) showed [5c Kc] and lost with a pair of Kings
Seat 4: Klim_89 (big blind) showed [8s Ks] and won ($1.07) with two pair, Kings and Eights
Seat 5: eeeLOVEnkov folded before Flop (didn't bet)
Seat 6: Kalaboush folded on the Flop



PokerStars Hand #201507325580:  Hold'em No Limit ($0.05/$0.10 USD) - 2019/06/18 10:02:58 ET
Table 'Moreau III' 6-max Seat #3 is the button
Seat 1: togl63amg ($10.16 in chips) 
Seat 2: nemomen1 ($9.35 in chips) 
Seat 3: ReKych ($10.98 in chips) 
Seat 4: Klim_89 ($10.65 in chips) 
Seat 5: eeeLOVEnkov ($10 in chips) 
Seat 6: Kalaboush ($36.96 in chips) 
Klim_89: posts small blind $0.05
eeeLOVEnkov: posts big blind $0.10
togl63amg: posts the ante $0.02
nemomen1: posts the ante $0.02
ReKych: posts the ante $0.02
Klim_89: posts the ante $0.02
eeeLOVEnkov: posts the ante $0.02
Kalaboush: posts the ante $0.02
*** HOLE CARDS ***
Kalaboush: raises $0.10 to $0.20
togl63amg: raises $0.70 to $0.90
nemomen1: folds 
ReKych: folds 
Klim_89: folds 
eeeLOVEnkov: folds 
Kalaboush: calls $0.70
*** FLOP *** [7c 5h Ac]
Kalaboush: checks 
togl63amg: bets $0.50
Kalaboush: folds 
Uncalled bet ($0.50) returned to togl63amg
togl63amg collected $1.98 from pot
*** SUMMARY ***
Total pot $2.07 | Rake $0.09 
Board [7c 5h Ac]
Seat 1: togl63amg collected ($1.98)
Seat 2: nemomen1 folded before Flop (didn't bet)
Seat 3: ReKych (button) folded before Flop (didn't bet)
Seat 4: Klim_89 (small blind) folded before Flop
Seat 5: eeeLOVEnkov (big blind) folded before Flop
Seat 6: Kalaboush folded on the Flop



PokerStars Hand #201507337566:  Hold'em No Limit ($0.05/$0.10 USD) - 2019/06/18 10:03:31 ET
Table 'Moreau III' 6-max Seat #4 is the button
Seat 1: togl63amg ($11.22 in chips) 
Seat 2: nemomen1 ($9.33 in chips) 
Seat 3: ReKych ($10.96 in chips) 
Seat 4: Klim_89 ($10.58 in chips) 
Seat 5: eeeLOVEnkov ($10 in chips) 
Seat 6: Kalaboush ($36.04 in chips) 
eeeLOVEnkov: posts small blind $0.05
Kalaboush: posts big blind $0.10
togl63amg: posts the ante $0.02
nemomen1: posts the ante $0.02
ReKych: posts the ante $0.02
Klim_89: posts the ante $0.02
eeeLOVEnkov: posts the ante $0.02
Kalaboush: posts the ante $0.02
*** HOLE CARDS ***
togl63amg: folds 
nemomen1: raises $0.10 to $0.20
ReKych: folds 
Klim_89: folds 
eeeLOVEnkov: folds 
Kalaboush: raises $0.57 to $0.77
nemomen1: calls $0.57
*** FLOP *** [3s 9c 6h]
Kalaboush: bets $0.30
nemomen1: folds 
Uncalled bet ($0.30) returned to Kalaboush
Kalaboush collected $1.63 from pot
Kalaboush: doesn't show hand 
*** SUMMARY ***
Total pot $1.71 | Rake $0.08 
Board [3s 9c 6h]
Seat 1: togl63amg folded before Flop (didn't bet)
Seat 2: nemomen1 folded on the Flop
Seat 3: ReKych folded before Flop (didn't bet)
Seat 4: Klim_89 (button) folded before Flop (didn't bet)
Seat 5: eeeLOVEnkov (small blind) folded before Flop
Seat 6: Kalaboush (big blind) collected ($1.63)



PokerStars Hand #201507347792:  Hold'em No Limit ($0.05/$0.10 USD) - 2019/06/18 10:03:59 ET
Table 'Moreau III' 6-max Seat #5 is the button
Seat 1: togl63amg ($11.20 in chips) 
Seat 2: nemomen1 ($8.54 in chips) 
Seat 3: ReKych ($10.94 in chips) 
Seat 4: Klim_89 ($10.56 in chips) 
Seat 5: eeeLOVEnkov ($10 in chips) 
Seat 6: Kalaboush ($36.88 in chips) 
Kalaboush: posts small blind $0.05
togl63amg: posts big blind $0.10
togl63amg: posts the ante $0.02
nemomen1: posts the ante $0.02
ReKych: posts the ante $0.02
Klim_89: posts the ante $0.02
eeeLOVEnkov: posts the ante $0.02
Kalaboush: posts the ante $0.02
*** HOLE CARDS ***
nemomen1: calls $0.10
ReKych: raises $0.40 to $0.50
Klim_89: folds 
eeeLOVEnkov: folds 
Kalaboush: folds 
togl63amg: folds 
nemomen1: raises $8.02 to $8.52 and is all-in
ReKych: folds 
Uncalled bet ($8.02) returned to nemomen1
nemomen1 collected $1.27 from pot
*** SUMMARY ***
Total pot $1.27 | Rake $0 
Seat 1: togl63amg (big blind) folded before Flop
Seat 2: nemomen1 collected ($1.27)
Seat 3: ReKych folded before Flop
Seat 4: Klim_89 folded before Flop (didn't bet)
Seat 5: eeeLOVEnkov (button) folded before Flop (didn't bet)
Seat 6: Kalaboush (small blind) folded before Flop



PokerStars Hand #201507359490:  Hold'em No Limit ($0.05/$0.10 USD) - 2019/06/18 10:04:30 ET
Table 'Moreau III' 6-max Seat #6 is the button
Seat 1: togl63amg ($11.08 in chips) 
Seat 2: nemomen1 ($9.29 in chips) 
Seat 3: ReKych ($10.42 in chips) 
Seat 4: Klim_89 ($10.54 in chips) 
Seat 5: eeeLOVEnkov ($10 in chips) 
Seat 6: Kalaboush ($36.81 in chips) 
togl63amg: posts small blind $0.05
nemomen1: posts big blind $0.10
togl63amg: posts the ante $0.02
nemomen1: posts the ante $0.02
ReKych: posts the ante $0.02
Klim_89: posts the ante $0.02
eeeLOVEnkov: posts the ante $0.02
Kalaboush: posts the ante $0.02
*** HOLE CARDS ***
ReKych: folds 
Klim_89: folds 
eeeLOVEnkov: folds 
Kalaboush: folds 
togl63amg: folds 
Uncalled bet ($0.05) returned to nemomen1
nemomen1 collected $0.22 from pot
*** SUMMARY ***
Total pot $0.22 | Rake $0 
Seat 1: togl63amg (small blind) folded before Flop
Seat 2: nemomen1 (big blind) collected ($0.22)
Seat 3: ReKych folded before Flop (didn't bet)
Seat 4: Klim_89 folded before Flop (didn't bet)
Seat 5: eeeLOVEnkov folded before Flop (didn't bet)
Seat 6: Kalaboush (button) folded before Flop (didn't bet)



PokerStars Hand #201507366237:  Hold'em No Limit ($0.05/$0.10 USD) - 2019/06/18 10:04:49 ET
Table 'Moreau III' 6-max Seat #1 is the button
Seat 1: togl63amg ($11.01 in chips) 
Seat 2: nemomen1 ($9.44 in chips) 
Seat 3: ReKych ($10.40 in chips) 
Seat 4: Klim_89 ($10.52 in chips) 
Seat 5: eeeLOVEnkov ($10 in chips) 
Seat 6: Kalaboush ($36.79 in chips) 
nemomen1: posts small blind $0.05
ReKych: posts big blind $0.10
togl63amg: posts the ante $0.02
nemomen1: posts the ante $0.02
ReKych: posts the ante $0.02
Klim_89: posts the ante $0.02
eeeLOVEnkov: posts the ante $0.02
Kalaboush: posts the ante $0.02
*** HOLE CARDS ***
Klim_89: folds 
eeeLOVEnkov: folds 
Kalaboush: folds 
togl63amg: folds 
nemomen1: raises $0.10 to $0.20
ReKych: folds 
Uncalled bet ($0.10) returned to nemomen1
nemomen1 collected $0.32 from pot
*** SUMMARY ***
Total pot $0.32 | Rake $0 
Seat 1: togl63amg (button) folded before Flop (didn't bet)
Seat 2: nemomen1 (small blind) collected ($0.32)
Seat 3: ReKych (big blind) folded before Flop
Seat 4: Klim_89 folded before Flop (didn't bet)
Seat 5: eeeLOVEnkov folded before Flop (didn't bet)
Seat 6: Kalaboush folded before Flop (didn't bet)



PokerStars Hand #201507373935:  Hold'em No Limit ($0.05/$0.10 USD) - 2019/06/18 10:05:09 ET
Table 'Moreau III' 6-max Seat #2 is the button
Seat 1: togl63amg ($10.99 in chips) 
Seat 2: nemomen1 ($9.64 in chips) 
Seat 3: ReKych ($10.28 in chips) 
Seat 4: Klim_89 ($10.50 in chips) 
Seat 5: eeeLOVEnkov ($10 in chips) 
Seat 6: Kalaboush ($36.77 in chips) 
ReKych: posts small blind $0.05
Klim_89: posts big blind $0.10
togl63amg: posts the ante $0.02
nemomen1: posts the ante $0.02
ReKych: posts the ante $0.02
Klim_89: posts the ante $0.02
eeeLOVEnkov: posts the ante $0.02
Kalaboush: posts the ante $0.02
*** HOLE CARDS ***
eeeLOVEnkov: folds 
Kalaboush: raises $0.37 to $0.47
togl63amg: folds 
nemomen1: folds 
ReKych: folds 
Klim_89: calls $0.37
*** FLOP *** [9c 2s Kc]
Klim_89: checks 
Kalaboush: bets $0.50
Klim_89: calls $0.50
*** TURN *** [9c 2s Kc] [Kd]
Klim_89: checks 
Kalaboush: bets $1
Klim_89: folds 
Uncalled bet ($1) returned to Kalaboush
Kalaboush collected $2.02 from pot
Kalaboush: doesn't show hand 
*** SUMMARY ***
Total pot $2.11 | Rake $0.09 
Board [9c 2s Kc Kd]
Seat 1: togl63amg folded before Flop (didn't bet)
Seat 2: nemomen1 (button) folded before Flop (didn't bet)
Seat 3: ReKych (small blind) folded before Flop
Seat 4: Klim_89 (big blind) folded on the Turn
Seat 5: eeeLOVEnkov folded before Flop (didn't bet)
Seat 6: Kalaboush collected ($2.02)



PokerStars Hand #201507392408:  Hold'em No Limit ($0.05/$0.10 USD) - 2019/06/18 10:05:59 ET
Table 'Moreau III' 6-max Seat #3 is the button
Seat 1: togl63amg ($10.97 in chips) 
Seat 2: nemomen1 ($9.62 in chips) 
Seat 3: ReKych ($10.21 in chips) 
Seat 4: Klim_89 ($10 in chips) 
Seat 5: eeeLOVEnkov ($10 in chips) 
Seat 6: Kalaboush ($37.80 in chips) 
Klim_89: posts small blind $0.05
eeeLOVEnkov: posts big blind $0.10
togl63amg: posts the ante $0.02
nemomen1: posts the ante $0.02
ReKych: posts the ante $0.02
Klim_89: posts the ante $0.02
eeeLOVEnkov: posts the ante $0.02
Kalaboush: posts the ante $0.02
*** HOLE CARDS ***
Kalaboush: folds 
togl63amg: folds 
nemomen1: raises $0.10 to $0.20
ReKych: folds 
Klim_89: folds 
eeeLOVEnkov: folds 
Uncalled bet ($0.10) returned to nemomen1
nemomen1 collected $0.37 from pot
*** SUMMARY ***
Total pot $0.37 | Rake $0 
Seat 1: togl63amg folded before Flop (didn't bet)
Seat 2: nemomen1 collected ($0.37)
Seat 3: ReKych (button) folded before Flop (didn't bet)
Seat 4: Klim_89 (small blind) folded before Flop
Seat 5: eeeLOVEnkov (big blind) folded before Flop
Seat 6: Kalaboush folded before Flop (didn't bet)



PokerStars Hand #201507396227:  Hold'em No Limit ($0.05/$0.10 USD) - 2019/06/18 10:06:09 ET
Table 'Moreau III' 6-max Seat #4 is the button
Seat 1: togl63amg ($10.95 in chips) 
Seat 2: nemomen1 ($9.87 in chips) 
Seat 3: ReKych ($10.19 in chips) 
Seat 4: Klim_89 ($10 in chips) 
Seat 5: eeeLOVEnkov ($10 in chips) 
Seat 6: Kalaboush ($37.78 in chips) 
eeeLOVEnkov: posts small blind $0.05
Kalaboush: posts big blind $0.10
togl63amg: posts the ante $0.02
nemomen1: posts the ante $0.02
ReKych: posts the ante $0.02
Klim_89: posts the ante $0.02
eeeLOVEnkov: posts the ante $0.02
Kalaboush: posts the ante $0.02
*** HOLE CARDS ***
togl63amg: folds 
nemomen1: folds 
ReKych: folds 
Klim_89: folds 
eeeLOVEnkov: folds 
Uncalled bet ($0.05) returned to Kalaboush
Kalaboush collected $0.22 from pot
Kalaboush: doesn't show hand 
*** SUMMARY ***
Total pot $0.22 | Rake $0 
Seat 1: togl63amg folded before Flop (didn't bet)
Seat 2: nemomen1 folded before Flop (didn't bet)
Seat 3: ReKych folded before Flop (didn't bet)
Seat 4: Klim_89 (button) folded before Flop (didn't bet)
Seat 5: eeeLOVEnkov (small blind) folded before Flop
Seat 6: Kalaboush (big blind) collected ($0.22)



PokerStars Hand #201507399995:  Hold'em No Limit ($0.05/$0.10 USD) - 2019/06/18 10:06:19 ET
Table 'Moreau III' 6-max Seat #5 is the button
Seat 1: togl63amg ($10.93 in chips) 
Seat 2: nemomen1 ($9.85 in chips) 
Seat 3: ReKych ($10.17 in chips) 
Seat 4: Klim_89 ($10 in chips) 
Seat 5: eeeLOVEnkov ($10 in chips) 
Seat 6: Kalaboush ($37.93 in chips) 
Kalaboush: posts small blind $0.05
togl63amg: posts big blind $0.10
togl63amg: posts the ante $0.02
nemomen1: posts the ante $0.02
ReKych: posts the ante $0.02
Klim_89: posts the ante $0.02
eeeLOVEnkov: posts the ante $0.02
Kalaboush: posts the ante $0.02
*** HOLE CARDS ***
nemomen1: calls $0.10
ReKych: folds 
Klim_89: folds 
eeeLOVEnkov: folds 
Kalaboush: folds 
togl63amg: raises $0.30 to $0.40
nemomen1: calls $0.30
*** FLOP *** [4h 2c Ad]
togl63amg: bets $0.52
nemomen1: folds 
Uncalled bet ($0.52) returned to togl63amg
togl63amg collected $0.93 from pot
*** SUMMARY ***
Total pot $0.97 | Rake $0.04 
Board [4h 2c Ad]
Seat 1: togl63amg (big blind) collected ($0.93)
Seat 2: nemomen1 folded on the Flop
Seat 3: ReKych folded before Flop (didn't bet)
Seat 4: Klim_89 folded before Flop (didn't bet)
Seat 5: eeeLOVEnkov (button) folded before Flop (didn't bet)
Seat 6: Kalaboush (small blind) folded before Flop



PokerStars Hand #201507408916:  Hold'em No Limit ($0.05/$0.10 USD) - 2019/06/18 10:06:43 ET
Table 'Moreau III' 6-max Seat #6 is the button
Seat 1: togl63amg ($11.44 in chips) 
Seat 2: nemomen1 ($9.43 in chips) 
Seat 3: ReKych ($10.15 in chips) 
Seat 4: Klim_89 ($10 in chips) 
Seat 5: eeeLOVEnkov ($10 in chips) 
Seat 6: Kalaboush ($37.86 in chips) 
togl63amg: posts small blind $0.05
nemomen1: posts big blind $0.10
togl63amg: posts the ante $0.02
nemomen1: posts the ante $0.02
ReKych: posts the ante $0.02
Klim_89: posts the ante $0.02
eeeLOVEnkov: posts the ante $0.02
Kalaboush: posts the ante $0.02
*** HOLE CARDS ***
ReKych: folds 
Klim_89: raises $0.12 to $0.22
eeeLOVEnkov: folds 
Kalaboush: raises $0.71 to $0.93
togl63amg: folds 
nemomen1: raises $2.25 to $3.18
Klim_89: folds 
Kalaboush: calls $2.25
*** FLOP *** [5s 2c 4c]
nemomen1: checks 
Kalaboush: bets $6.40
nemomen1: calls $6.23 and is all-in
Uncalled bet ($0.17) returned to Kalaboush
*** TURN *** [5s 2c 4c] [6d]
*** RIVER *** [5s 2c 4c 6d] [3c]
*** SHOW DOWN ***
nemomen1: shows [5c 7c] (a flush, Seven high)
Kalaboush: shows [Qc Qh] (a straight, Deuce to Six)
nemomen1 collected $18.35 from pot
*** SUMMARY ***
Total pot $19.21 | Rake $0.86 
Board [5s 2c 4c 6d 3c]
Seat 1: togl63amg (small blind) folded before Flop
Seat 2: nemomen1 (big blind) showed [5c 7c] and won ($18.35) with a flush, Seven high
Seat 3: ReKych folded before Flop (didn't bet)
Seat 4: Klim_89 folded before Flop
Seat 5: eeeLOVEnkov folded before Flop (didn't bet)
Seat 6: Kalaboush (button) showed [Qc Qh] and lost with a straight, Deuce to Six



PokerStars Hand #201507423070:  Hold'em No Limit ($0.05/$0.10 USD) - 2019/06/18 10:07:21 ET
Table 'Moreau III' 6-max Seat #1 is the button
Seat 1: togl63amg ($11.37 in chips) 
Seat 2: nemomen1 ($18.35 in chips) 
Seat 3: ReKych ($10.13 in chips) 
Seat 4: Klim_89 ($10 in chips) 
Seat 5: eeeLOVEnkov ($10 in chips) 
Seat 6: Kalaboush ($28.43 in chips) 
nemomen1: posts small blind $0.05
ReKych: posts big blind $0.10
togl63amg: posts the ante $0.02
nemomen1: posts the ante $0.02
ReKych: posts the ante $0.02
Klim_89: posts the ante $0.02
eeeLOVEnkov: posts the ante $0.02
Kalaboush: posts the ante $0.02
*** HOLE CARDS ***
Klim_89: folds 
eeeLOVEnkov: folds 
Kalaboush: folds 
togl63amg: raises $0.15 to $0.25
nemomen1: calls $0.20
ReKych: folds 
*** FLOP *** [Ks Js 5s]
nemomen1: bets $0.10
togl63amg: calls $0.10
*** TURN *** [Ks Js 5s] [2d]
nemomen1: checks 
togl63amg: bets $0.49
nemomen1: folds 
Uncalled bet ($0.49) returned to togl63amg
togl63amg collected $0.88 from pot
*** SUMMARY ***
Total pot $0.92 | Rake $0.04 
Board [Ks Js 5s 2d]
Seat 1: togl63amg (button) collected ($0.88)
Seat 2: nemomen1 (small blind) folded on the Turn
Seat 3: ReKych (big blind) folded before Flop
Seat 4: Klim_89 folded before Flop (didn't bet)
Seat 5: eeeLOVEnkov folded before Flop (didn't bet)
Seat 6: Kalaboush folded before Flop (didn't bet)



PokerStars Hand #201507435573:  Hold'em No Limit ($0.05/$0.10 USD) - 2019/06/18 10:07:55 ET
Table 'Moreau III' 6-max Seat #2 is the button
Seat 1: togl63amg ($11.88 in chips) 
Seat 2: nemomen1 ($17.98 in chips) 
Seat 3: ReKych ($10.01 in chips) 
Seat 4: Klim_89 ($10 in chips) 
Seat 5: eeeLOVEnkov ($10 in chips) 
Seat 6: Kalaboush ($28.41 in chips) 
ReKych: posts small blind $0.05
Klim_89: posts big blind $0.10
togl63amg: posts the ante $0.02
nemomen1: posts the ante $0.02
ReKych: posts the ante $0.02
Klim_89: posts the ante $0.02
eeeLOVEnkov: posts the ante $0.02
Kalaboush: posts the ante $0.02
*** HOLE CARDS ***
eeeLOVEnkov: raises $0.20 to $0.30
Kalaboush: calls $0.30
togl63amg: folds 
nemomen1: raises $0.20 to $0.50
ReKych: folds 
Klim_89: folds 
eeeLOVEnkov: calls $0.20
Kalaboush: calls $0.20
*** FLOP *** [9h Kh 7c]
eeeLOVEnkov: checks 
Kalaboush: checks 
nemomen1: bets $0.85
eeeLOVEnkov: folds 
Kalaboush: calls $0.85
*** TURN *** [9h Kh 7c] [As]
Kalaboush: checks 
nemomen1: bets $1.66
Kalaboush: folds 
Uncalled bet ($1.66) returned to nemomen1
nemomen1 collected $3.31 from pot
*** SUMMARY ***
Total pot $3.47 | Rake $0.16 
Board [9h Kh 7c As]
Seat 1: togl63amg folded before Flop (didn't bet)
Seat 2: nemomen1 (button) collected ($3.31)
Seat 3: ReKych (small blind) folded before Flop
Seat 4: Klim_89 (big blind) folded before Flop
Seat 5: eeeLOVEnkov folded on the Flop
Seat 6: Kalaboush folded on the Turn



PokerStars Hand #201507449431:  Hold'em No Limit ($0.05/$0.10 USD) - 2019/06/18 10:08:32 ET
Table 'Moreau III' 6-max Seat #3 is the button
Seat 1: togl63amg ($11.86 in chips) 
Seat 2: nemomen1 ($19.92 in chips) 
Seat 3: ReKych ($10 in chips) 
Seat 4: Klim_89 ($10 in chips) 
Seat 5: eeeLOVEnkov ($10 in chips) 
Seat 6: Kalaboush ($27.04 in chips) 
Klim_89: posts small blind $0.05
eeeLOVEnkov: posts big blind $0.10
togl63amg: posts the ante $0.02
nemomen1: posts the ante $0.02
ReKych: posts the ante $0.02
Klim_89: posts the ante $0.02
eeeLOVEnkov: posts the ante $0.02
Kalaboush: posts the ante $0.02
*** HOLE CARDS ***
Kalaboush: raises $0.20 to $0.30
togl63amg: folds 
nemomen1: folds 
nemomen1 leaves the table
ReKych: folds 
Klim_89: folds 
eeeLOVEnkov: calls $0.20
*** FLOP *** [Qh 6c Qc]
eeeLOVEnkov: checks 
Kalaboush: bets $0.50
eeeLOVEnkov: folds 
Uncalled bet ($0.50) returned to Kalaboush
Kalaboush collected $0.74 from pot
Kalaboush: doesn't show hand 
*** SUMMARY ***
Total pot $0.77 | Rake $0.03 
Board [Qh 6c Qc]
Seat 1: togl63amg folded before Flop (didn't bet)
Seat 2: nemomen1 folded before Flop (didn't bet)
Seat 3: ReKych (button) folded before Flop (didn't bet)
Seat 4: Klim_89 (small blind) folded before Flop
Seat 5: eeeLOVEnkov (big blind) folded on the Flop
Seat 6: Kalaboush collected ($0.74)



PokerStars Hand #201507463176:  Hold'em No Limit ($0.05/$0.10 USD) - 2019/06/18 10:09:08 ET
Table 'Moreau III' 6-max Seat #4 is the button
Seat 1: togl63amg ($11.84 in chips) 
Seat 3: ReKych ($10 in chips) 
Seat 4: Klim_89 ($10 in chips) 
Seat 5: eeeLOVEnkov ($10 in chips) 
eeeLOVEnkov: posts small blind $0.05
Kalaboush: is sitting out 
togl63amg: posts big blind $0.10
togl63amg: posts the ante $0.02
ReKych: posts the ante $0.02
Klim_89: posts the ante $0.02
eeeLOVEnkov: posts the ante $0.02
*** HOLE CARDS ***
ReKych: raises $0.20 to $0.30
Klim_89: folds 
Kalaboush leaves the table
eeeLOVEnkov: folds 
togl63amg: calls $0.20
*** FLOP *** [Th 6h 7h]
togl63amg: checks 
Simanov.A joins the table at seat #2 
ReKych: checks 
*** TURN *** [Th 6h 7h] [7c]
Barneypok83 joins the table at seat #6 
togl63amg: checks 
ReKych: checks 
*** RIVER *** [Th 6h 7h 7c] [8d]
togl63amg: bets $0.30
ReKych: calls $0.30
*** SHOW DOWN ***
togl63amg: shows [Td 9h] (a straight, Six to Ten)
ReKych: shows [Qs 9s] (a straight, Six to Ten)
togl63amg collected $0.64 from pot
ReKych collected $0.63 from pot
*** SUMMARY ***
Total pot $1.33 | Rake $0.06 
Board [Th 6h 7h 7c 8d]
Seat 1: togl63amg (big blind) showed [Td 9h] and won ($0.64) with a straight, Six to Ten
Seat 3: ReKych showed [Qs 9s] and won ($0.63) with a straight, Six to Ten
Seat 4: Klim_89 (button) folded before Flop (didn't bet)
Seat 5: eeeLOVEnkov (small blind) folded before Flop



PokerStars Hand #201507479684:  Hold'em No Limit ($0.05/$0.10 USD) - 2019/06/18 10:09:52 ET
Table 'Moreau III' 6-max Seat #5 is the button
Seat 1: togl63amg ($11.86 in chips) 
Seat 2: Simanov.A ($10 in chips) 
Seat 3: ReKych ($10.01 in chips) 
Seat 4: Klim_89 ($10 in chips) 
Seat 5: eeeLOVEnkov ($10 in chips) 
togl63amg: posts small blind $0.05
Simanov.A: posts big blind $0.10
togl63amg: posts the ante $0.02
Simanov.A: posts the ante $0.02
ReKych: posts the ante $0.02
Klim_89: posts the ante $0.02
eeeLOVEnkov: posts the ante $0.02
*** HOLE CARDS ***
ReKych: folds 
Klim_89: raises $0.12 to $0.22
eeeLOVEnkov: folds 
togl63amg: folds 
Simanov.A: folds 
Uncalled bet ($0.12) returned to Klim_89
Klim_89 collected $0.35 from pot
Klim_89: doesn't show hand 
*** SUMMARY ***
Total pot $0.35 | Rake $0 
Seat 1: togl63amg (small blind) folded before Flop
Seat 2: Simanov.A (big blind) folded before Flop
Seat 3: ReKych folded before Flop (didn't bet)
Seat 4: Klim_89 collected ($0.35)
Seat 5: eeeLOVEnkov (button) folded before Flop (didn't bet)



PokerStars Hand #201507487985:  Hold'em No Limit ($0.05/$0.10 USD) - 2019/06/18 10:10:14 ET
Table 'Moreau III' 6-max Seat #1 is the button
Seat 1: togl63amg ($11.79 in chips) 
Seat 2: Simanov.A ($9.88 in chips) 
Seat 5: eeeLOVEnkov ($10 in chips) 
Simanov.A: posts small blind $0.05
ReKych: is sitting out 
ReKych leaves the table
Klim_89: is sitting out 
Klim_89 leaves the table
eeeLOVEnkov: posts big blind $0.10
Barneypok83: sits out 
togl63amg: posts the ante $0.02
Simanov.A: posts the ante $0.02
eeeLOVEnkov: posts the ante $0.02
*** HOLE CARDS ***
togl63amg: raises $0.15 to $0.25
Simanov.A: raises $0.15 to $0.40
eeeLOVEnkov: folds 
togl63amg: calls $0.15
*** FLOP *** [Jh 5h Ks]
Simanov.A: bets $0.40
togl63amg: folds 
Uncalled bet ($0.40) returned to Simanov.A
Simanov.A collected $0.92 from pot
Simanov.A: doesn't show hand 
*** SUMMARY ***
Total pot $0.96 | Rake $0.04 
Board [Jh 5h Ks]
Seat 1: togl63amg (button) folded on the Flop
Seat 2: Simanov.A (small blind) collected ($0.92)
Seat 5: eeeLOVEnkov (big blind) folded before Flop



PokerStars Hand #201507501823:  Hold'em No Limit ($0.05/$0.10 USD) - 2019/06/18 10:10:51 ET
Table 'Moreau III' 6-max Seat #2 is the button
Seat 1: togl63amg ($11.37 in chips) 
Seat 2: Simanov.A ($10.38 in chips) 
Seat 5: eeeLOVEnkov ($10 in chips) 
Seat 6: Barneypok83 ($8 in chips) 
eeeLOVEnkov: posts small blind $0.05
Barneypok83: posts big blind $0.10
togl63amg: posts the ante $0.02
Simanov.A: posts the ante $0.02
eeeLOVEnkov: posts the ante $0.02
Barneypok83: posts the ante $0.02
*** HOLE CARDS ***
togl63amg: raises $0.20 to $0.30
Simanov.A: folds 
eeeLOVEnkov: folds 
Barneypok83: folds 
Uncalled bet ($0.20) returned to togl63amg
togl63amg collected $0.33 from pot
*** SUMMARY ***
Total pot $0.33 | Rake $0 
Seat 1: togl63amg collected ($0.33)
Seat 2: Simanov.A (button) folded before Flop (didn't bet)
Seat 5: eeeLOVEnkov (small blind) folded before Flop
Seat 6: Barneypok83 (big blind) folded before Flop



PokerStars Hand #201507508716:  Hold'em No Limit ($0.05/$0.10 USD) - 2019/06/18 10:11:09 ET
Table 'Moreau III' 6-max Seat #5 is the button
Seat 1: togl63amg ($11.58 in chips) 
Seat 2: Simanov.A ($10.36 in chips) 
Seat 5: eeeLOVEnkov ($10 in chips) 
Seat 6: Barneypok83 ($7.88 in chips) 
Barneypok83: posts small blind $0.05
togl63amg: posts big blind $0.10
togl63amg: posts the ante $0.02
Simanov.A: posts the ante $0.02
eeeLOVEnkov: posts the ante $0.02
Barneypok83: posts the ante $0.02
*** HOLE CARDS ***
razukhin joins the table at seat #3 
pichcora 811 joins the table at seat #4 
Simanov.A: folds 
eeeLOVEnkov: raises $0.15 to $0.25
razukhin leaves the table
Barneypok83: calls $0.20
togl63amg: folds 
*** FLOP *** [4d As 2s]
Barneypok83: bets $0.20
eeeLOVEnkov: calls $0.20
*** TURN *** [4d As 2s] [Qd]
Barneypok83: bets $0.30
Igasha1 joins the table at seat #3 
eeeLOVEnkov: calls $0.30
*** RIVER *** [4d As 2s Qd] [2d]
Barneypok83: bets $7.11 and is all-in
eeeLOVEnkov: folds 
Uncalled bet ($7.11) returned to Barneypok83
Barneypok83 collected $1.60 from pot
Barneypok83: doesn't show hand 
*** SUMMARY ***
Total pot $1.68 | Rake $0.08 
Board [4d As 2s Qd 2d]
Seat 1: togl63amg (big blind) folded before Flop
Seat 2: Simanov.A folded before Flop (didn't bet)
Seat 5: eeeLOVEnkov (button) folded on the River
Seat 6: Barneypok83 (small blind) collected ($1.60)



PokerStars Hand #201507532931:  Hold'em No Limit ($0.05/$0.10 USD) - 2019/06/18 10:12:14 ET
Table 'Moreau III' 6-max Seat #6 is the button
Seat 1: togl63amg ($11.46 in chips) 
Seat 2: Simanov.A ($10.34 in chips) 
Seat 5: eeeLOVEnkov ($10 in chips) 
Seat 6: Barneypok83 ($8.71 in chips) 
togl63amg: posts small blind $0.05
Simanov.A: posts big blind $0.10
Igasha1: sits out 
pichcora 811: sits out 
togl63amg: posts the ante $0.02
Simanov.A: posts the ante $0.02
eeeLOVEnkov: posts the ante $0.02
Barneypok83: posts the ante $0.02
*** HOLE CARDS ***
eeeLOVEnkov: folds 
Barneypok83: folds 
togl63amg: folds 
Uncalled bet ($0.05) returned to Simanov.A
Simanov.A collected $0.18 from pot
Simanov.A: doesn't show hand 
*** SUMMARY ***
Total pot $0.18 | Rake $0 
Seat 1: togl63amg (small blind) folded before Flop
Seat 2: Simanov.A (big blind) collected ($0.18)
Seat 5: eeeLOVEnkov folded before Flop (didn't bet)
Seat 6: Barneypok83 (button) folded before Flop (didn't bet)



PokerStars Hand #201507537686:  Hold'em No Limit ($0.05/$0.10 USD) - 2019/06/18 10:12:27 ET
Table 'Moreau III' 6-max Seat #1 is the button
Seat 1: togl63amg ($11.39 in chips) 
Seat 2: Simanov.A ($10.45 in chips) 
Seat 3: Igasha1 ($8 in chips) 
Seat 5: eeeLOVEnkov ($10 in chips) 
Seat 6: Barneypok83 ($8.69 in chips) 
Simanov.A: posts small blind $0.05
Igasha1: posts big blind $0.10
pichcora 811: sits out 
togl63amg: posts the ante $0.02
Simanov.A: posts the ante $0.02
Igasha1: posts the ante $0.02
eeeLOVEnkov: posts the ante $0.02
Barneypok83: posts the ante $0.02
*** HOLE CARDS ***
eeeLOVEnkov: raises $0.20 to $0.30
Barneypok83: folds 
togl63amg: calls $0.30
Simanov.A: folds 
Igasha1: calls $0.20
*** FLOP *** [2d 6d 3c]
Igasha1: checks 
eeeLOVEnkov: checks 
togl63amg: bets $0.50
Igasha1: folds 
eeeLOVEnkov: folds 
Uncalled bet ($0.50) returned to togl63amg
togl63amg collected $1 from pot
*** SUMMARY ***
Total pot $1.05 | Rake $0.05 
Board [2d 6d 3c]
Seat 1: togl63amg (button) collected ($1)
Seat 2: Simanov.A (small blind) folded before Flop
Seat 3: Igasha1 (big blind) folded on the Flop
Seat 5: eeeLOVEnkov folded on the Flop
Seat 6: Barneypok83 folded before Flop (didn't bet)



PokerStars Hand #201507565149:  Hold'em No Limit ($0.05/$0.10 USD) - 2019/06/18 10:13:39 ET
Table 'Moreau III' 6-max Seat #2 is the button
Seat 1: togl63amg ($12.07 in chips) 
Seat 2: Simanov.A ($10.38 in chips) 
Seat 3: Igasha1 ($7.68 in chips) 
Seat 4: pichcora 811 ($10 in chips) 
Seat 5: eeeLOVEnkov ($10 in chips) 
Seat 6: Barneypok83 ($8.67 in chips) 
Igasha1: posts small blind $0.05
pichcora 811: posts big blind $0.10
togl63amg: posts the ante $0.02
Simanov.A: posts the ante $0.02
Igasha1: posts the ante $0.02
pichcora 811: posts the ante $0.02
eeeLOVEnkov: posts the ante $0.02
Barneypok83: posts the ante $0.02
*** HOLE CARDS ***
eeeLOVEnkov: raises $0.20 to $0.30
Barneypok83: folds 
togl63amg: folds 
Simanov.A: folds 
Igasha1: folds 
pichcora 811: folds 
Uncalled bet ($0.20) returned to eeeLOVEnkov
eeeLOVEnkov collected $0.37 from pot
eeeLOVEnkov: doesn't show hand 
*** SUMMARY ***
Total pot $0.37 | Rake $0 
Seat 1: togl63amg folded before Flop (didn't bet)
Seat 2: Simanov.A (button) folded before Flop (didn't bet)
Seat 3: Igasha1 (small blind) folded before Flop
Seat 4: pichcora 811 (big blind) folded before Flop
Seat 5: eeeLOVEnkov collected ($0.37)
Seat 6: Barneypok83 folded before Flop (didn't bet)



PokerStars Hand #201507571887:  Hold'em No Limit ($0.05/$0.10 USD) - 2019/06/18 10:13:57 ET
Table 'Moreau III' 6-max Seat #3 is the button
Seat 1: togl63amg ($12.05 in chips) 
Seat 2: Simanov.A ($10.36 in chips) 
Seat 3: Igasha1 ($7.61 in chips) 
Seat 4: pichcora 811 ($10 in chips) 
Seat 5: eeeLOVEnkov ($10.25 in chips) 
Seat 6: Barneypok83 ($8.65 in chips) 
pichcora 811: posts small blind $0.05
eeeLOVEnkov: posts big blind $0.10
togl63amg: posts the ante $0.02
Simanov.A: posts the ante $0.02
Igasha1: posts the ante $0.02
pichcora 811: posts the ante $0.02
eeeLOVEnkov: posts the ante $0.02
Barneypok83: posts the ante $0.02
*** HOLE CARDS ***
Barneypok83: folds 
togl63amg: folds 
Simanov.A: folds 
Igasha1: calls $0.10
pichcora 811: folds 
eeeLOVEnkov: checks 
*** FLOP *** [7c Jc 3c]
eeeLOVEnkov: checks 
Igasha1: checks 
*** TURN *** [7c Jc 3c] [Td]
eeeLOVEnkov: checks 
Igasha1: checks 
*** RIVER *** [7c Jc 3c Td] [4h]
eeeLOVEnkov: checks 
Igasha1: checks 
*** SHOW DOWN ***
eeeLOVEnkov: shows [Qd 2d] (high card Queen)
Igasha1: shows [Ah 3h] (a pair of Threes)
Igasha1 collected $0.35 from pot
*** SUMMARY ***
Total pot $0.37 | Rake $0.02 
Board [7c Jc 3c Td 4h]
Seat 1: togl63amg folded before Flop (didn't bet)
Seat 2: Simanov.A folded before Flop (didn't bet)
Seat 3: Igasha1 (button) showed [Ah 3h] and won ($0.35) with a pair of Threes
Seat 4: pichcora 811 (small blind) folded before Flop
Seat 5: eeeLOVEnkov (big blind) showed [Qd 2d] and lost with high card Queen
Seat 6: Barneypok83 folded before Flop (didn't bet)



PokerStars Hand #201507595222:  Hold'em No Limit ($0.05/$0.10 USD) - 2019/06/18 10:14:59 ET
Table 'Moreau III' 6-max Seat #4 is the button
Seat 1: togl63amg ($12.03 in chips) 
Seat 2: Simanov.A ($10.34 in chips) 
Seat 3: Igasha1 ($7.84 in chips) 
Seat 4: pichcora 811 ($10 in chips) 
Seat 5: eeeLOVEnkov ($10.13 in chips) 
Seat 6: Barneypok83 ($8.63 in chips) 
eeeLOVEnkov: posts small blind $0.05
Barneypok83: posts big blind $0.10
togl63amg: posts the ante $0.02
Simanov.A: posts the ante $0.02
Igasha1: posts the ante $0.02
pichcora 811: posts the ante $0.02
eeeLOVEnkov: posts the ante $0.02
Barneypok83: posts the ante $0.02
*** HOLE CARDS ***
togl63amg: folds 
Simanov.A: folds 
Igasha1: calls $0.10
pichcora 811: folds 
eeeLOVEnkov: raises $0.40 to $0.50
Barneypok83: folds 
Igasha1: folds 
Uncalled bet ($0.40) returned to eeeLOVEnkov
eeeLOVEnkov collected $0.42 from pot
eeeLOVEnkov: doesn't show hand 
*** SUMMARY ***
Total pot $0.42 | Rake $0 
Seat 1: togl63amg folded before Flop (didn't bet)
Seat 2: Simanov.A folded before Flop (didn't bet)
Seat 3: Igasha1 folded before Flop
Seat 4: pichcora 811 (button) folded before Flop (didn't bet)
Seat 5: eeeLOVEnkov (small blind) collected ($0.42)
Seat 6: Barneypok83 (big blind) folded before Flop



PokerStars Hand #201507604357:  Hold'em No Limit ($0.05/$0.10 USD) - 2019/06/18 10:15:23 ET
Table 'Moreau III' 6-max Seat #5 is the button
Seat 1: togl63amg ($12.01 in chips) 
Seat 2: Simanov.A ($10.32 in chips) 
Seat 3: Igasha1 ($7.72 in chips) 
Seat 4: pichcora 811 ($10 in chips) 
Seat 5: eeeLOVEnkov ($10.43 in chips) 
Seat 6: Barneypok83 ($8.51 in chips) 
Barneypok83: posts small blind $0.05
togl63amg: posts big blind $0.10
togl63amg: posts the ante $0.02
Simanov.A: posts the ante $0.02
Igasha1: posts the ante $0.02
pichcora 811: posts the ante $0.02
eeeLOVEnkov: posts the ante $0.02
Barneypok83: posts the ante $0.02
*** HOLE CARDS ***
Simanov.A: folds 
Igasha1: folds 
Igasha1 leaves the table
pichcora 811: raises $0.15 to $0.25
ReKych joins the table at seat #3 
eeeLOVEnkov: folds 
Barneypok83: folds 
togl63amg: calls $0.15
*** FLOP *** [9c 4d Qh]
togl63amg: checks 
pichcora 811: checks 
*** TURN *** [9c 4d Qh] [3d]
togl63amg: bets $0.40
pichcora 811: calls $0.40
*** RIVER *** [9c 4d Qh 3d] [4h]
togl63amg: bets $0.90
pichcora 811: calls $0.90
*** SHOW DOWN ***
togl63amg: shows [Qs 9d] (two pair, Queens and Nines)
pichcora 811: mucks hand 
togl63amg collected $3.12 from pot
*** SUMMARY ***
Total pot $3.27 | Rake $0.15 
Board [9c 4d Qh 3d 4h]
Seat 1: togl63amg (big blind) showed [Qs 9d] and won ($3.12) with two pair, Queens and Nines
Seat 2: Simanov.A folded before Flop (didn't bet)
Seat 3: Igasha1 folded before Flop (didn't bet)
Seat 4: pichcora 811 mucked
Seat 5: eeeLOVEnkov (button) folded before Flop (didn't bet)
Seat 6: Barneypok83 (small blind) folded before Flop



PokerStars Hand #201507625987:  Hold'em No Limit ($0.05/$0.10 USD) - 2019/06/18 10:16:20 ET
Table 'Moreau III' 6-max Seat #6 is the button
Seat 1: togl63amg ($13.56 in chips) 
Seat 2: Simanov.A ($10.30 in chips) 
Seat 4: pichcora 811 ($10 in chips) 
Seat 5: eeeLOVEnkov ($10.41 in chips) 
Seat 6: Barneypok83 ($8.44 in chips) 
togl63amg: posts small blind $0.05
Simanov.A: posts big blind $0.10
ReKych: sits out 
togl63amg: posts the ante $0.02
Simanov.A: posts the ante $0.02
pichcora 811: posts the ante $0.02
eeeLOVEnkov: posts the ante $0.02
Barneypok83: posts the ante $0.02
*** HOLE CARDS ***
pichcora 811: folds 
eeeLOVEnkov: raises $0.20 to $0.30
Barneypok83: folds 
Barneypok83 leaves the table
togl63amg: folds 
Simanov.A: folds 
Uncalled bet ($0.20) returned to eeeLOVEnkov
eeeLOVEnkov collected $0.35 from pot
eeeLOVEnkov: doesn't show hand 
*** SUMMARY ***
Total pot $0.35 | Rake $0 
Seat 1: togl63amg (small blind) folded before Flop
Seat 2: Simanov.A (big blind) folded before Flop
Seat 4: pichcora 811 folded before Flop (didn't bet)
Seat 5: eeeLOVEnkov collected ($0.35)
Seat 6: Barneypok83 (button) folded before Flop (didn't bet)



PokerStars Hand #201507634402:  Hold'em No Limit ($0.05/$0.10 USD) - 2019/06/18 10:16:42 ET
Table 'Moreau III' 6-max Seat #1 is the button
Seat 1: togl63amg ($13.49 in chips) 
Seat 2: Simanov.A ($10.18 in chips) 
Seat 3: ReKych ($10 in chips) 
Seat 4: pichcora 811 ($10 in chips) 
Seat 5: eeeLOVEnkov ($10.64 in chips) 
Simanov.A: posts small blind $0.05
ReKych: posts big blind $0.10
togl63amg: posts the ante $0.02
Simanov.A: posts the ante $0.02
ReKych: posts the ante $0.02
pichcora 811: posts the ante $0.02
eeeLOVEnkov: posts the ante $0.02
*** HOLE CARDS ***
pichcora 811: folds 
eeeLOVEnkov: raises $0.20 to $0.30
togl63amg: folds 
hali ya hewa joins the table at seat #6 
Simanov.A: calls $0.25
ReKych: folds 
*** FLOP *** [3c Js Jc]
Simanov.A: checks 
eeeLOVEnkov: checks 
*** TURN *** [3c Js Jc] [Tc]
Simanov.A: checks 
eeeLOVEnkov: bets $0.54
Simanov.A: folds 
Uncalled bet ($0.54) returned to eeeLOVEnkov
eeeLOVEnkov collected $0.76 from pot
eeeLOVEnkov: doesn't show hand 
*** SUMMARY ***
Total pot $0.80 | Rake $0.04 
Board [3c Js Jc Tc]
Seat 1: togl63amg (button) folded before Flop (didn't bet)
Seat 2: Simanov.A (small blind) folded on the Turn
Seat 3: ReKych (big blind) folded before Flop
Seat 4: pichcora 811 folded before Flop (didn't bet)
Seat 5: eeeLOVEnkov collected ($0.76)



PokerStars Hand #201507649414:  Hold'em No Limit ($0.05/$0.10 USD) - 2019/06/18 10:17:21 ET
Table 'Moreau III' 6-max Seat #2 is the button
Seat 1: togl63amg ($13.47 in chips) 
Seat 2: Simanov.A ($9.86 in chips) 
Seat 3: ReKych ($10 in chips) 
Seat 4: pichcora 811 ($10 in chips) 
Seat 5: eeeLOVEnkov ($11.08 in chips) 
ReKych: posts small blind $0.05
pichcora 811: posts big blind $0.10
hali ya hewa: sits out 
togl63amg: posts the ante $0.02
Simanov.A: posts the ante $0.02
ReKych: posts the ante $0.02
pichcora 811: posts the ante $0.02
eeeLOVEnkov: posts the ante $0.02
*** HOLE CARDS ***
eeeLOVEnkov: folds 
togl63amg: folds 
Simanov.A: folds 
ReKych: folds 
Uncalled bet ($0.05) returned to pichcora 811
pichcora 811 collected $0.20 from pot
pichcora 811: doesn't show hand 
*** SUMMARY ***
Total pot $0.20 | Rake $0 
Seat 1: togl63amg folded before Flop (didn't bet)
Seat 2: Simanov.A (button) folded before Flop (didn't bet)
Seat 3: ReKych (small blind) folded before Flop
Seat 4: pichcora 811 (big blind) collected ($0.20)
Seat 5: eeeLOVEnkov folded before Flop (didn't bet)



PokerStars Hand #201507657661:  Hold'em No Limit ($0.05/$0.10 USD) - 2019/06/18 10:17:43 ET
Table 'Moreau III' 6-max Seat #3 is the button
Seat 1: togl63amg ($13.45 in chips) 
Seat 2: Simanov.A ($9.84 in chips) 
Seat 3: ReKych ($10 in chips) 
Seat 4: pichcora 811 ($10.13 in chips) 
Seat 5: eeeLOVEnkov ($11.06 in chips) 
pichcora 811: posts small blind $0.05
eeeLOVEnkov: posts big blind $0.10
hali ya hewa: sits out 
togl63amg: posts the ante $0.02
Simanov.A: posts the ante $0.02
ReKych: posts the ante $0.02
pichcora 811: posts the ante $0.02
eeeLOVEnkov: posts the ante $0.02
*** HOLE CARDS ***
togl63amg: folds 
Simanov.A: folds 
ReKych: folds 
pichcora 811: folds 
Uncalled bet ($0.05) returned to eeeLOVEnkov
eeeLOVEnkov collected $0.20 from pot
eeeLOVEnkov: doesn't show hand 
*** SUMMARY ***
Total pot $0.20 | Rake $0 
Seat 1: togl63amg folded before Flop (didn't bet)
Seat 2: Simanov.A folded before Flop (didn't bet)
Seat 3: ReKych (button) folded before Flop (didn't bet)
Seat 4: pichcora 811 (small blind) folded before Flop
Seat 5: eeeLOVEnkov (big blind) collected ($0.20)



PokerStars Hand #201507666231:  Hold'em No Limit ($0.05/$0.10 USD) - 2019/06/18 10:18:05 ET
Table 'Moreau III' 6-max Seat #4 is the button
Seat 1: togl63amg ($13.43 in chips) 
Seat 2: Simanov.A ($9.82 in chips) 
Seat 3: ReKych ($10 in chips) 
Seat 4: pichcora 811 ($10.06 in chips) 
Seat 5: eeeLOVEnkov ($11.19 in chips) 
Seat 6: hali ya hewa ($7.80 in chips) 
eeeLOVEnkov: posts small blind $0.05
hali ya hewa: posts big blind $0.10
togl63amg: posts the ante $0.02
Simanov.A: posts the ante $0.02
ReKych: posts the ante $0.02
pichcora 811: posts the ante $0.02
eeeLOVEnkov: posts the ante $0.02
hali ya hewa: posts the ante $0.02
*** HOLE CARDS ***
togl63amg: raises $0.20 to $0.30
Simanov.A: folds 
ReKych: folds 
pichcora 811: folds 
eeeLOVEnkov: folds 
hali ya hewa: folds 
Uncalled bet ($0.20) returned to togl63amg
togl63amg collected $0.37 from pot
*** SUMMARY ***
Total pot $0.37 | Rake $0 
Seat 1: togl63amg collected ($0.37)
Seat 2: Simanov.A folded before Flop (didn't bet)
Seat 3: ReKych folded before Flop (didn't bet)
Seat 4: pichcora 811 (button) folded before Flop (didn't bet)
Seat 5: eeeLOVEnkov (small blind) folded before Flop
Seat 6: hali ya hewa (big blind) folded before Flop



PokerStars Hand #201507680464:  Hold'em No Limit ($0.05/$0.10 USD) - 2019/06/18 10:18:43 ET
Table 'Moreau III' 6-max Seat #5 is the button
Seat 1: togl63amg ($13.68 in chips) 
Seat 2: Simanov.A ($9.80 in chips) 
Seat 3: ReKych ($10 in chips) 
Seat 4: pichcora 811 ($10.04 in chips) 
Seat 5: eeeLOVEnkov ($11.12 in chips) 
Seat 6: hali ya hewa ($7.68 in chips) 
hali ya hewa: posts small blind $0.05
togl63amg: posts big blind $0.10
togl63amg: posts the ante $0.02
Simanov.A: posts the ante $0.02
ReKych: posts the ante $0.02
pichcora 811: posts the ante $0.02
eeeLOVEnkov: posts the ante $0.02
hali ya hewa: posts the ante $0.02
*** HOLE CARDS ***
Simanov.A: folds 
ReKych: folds 
pichcora 811: folds 
eeeLOVEnkov: raises $0.15 to $0.25
hali ya hewa: folds 
togl63amg: folds 
Uncalled bet ($0.15) returned to eeeLOVEnkov
eeeLOVEnkov collected $0.37 from pot
eeeLOVEnkov: doesn't show hand 
*** SUMMARY ***
Total pot $0.37 | Rake $0 
Seat 1: togl63amg (big blind) folded before Flop
Seat 2: Simanov.A folded before Flop (didn't bet)
Seat 3: ReKych folded before Flop (didn't bet)
Seat 4: pichcora 811 folded before Flop (didn't bet)
Seat 5: eeeLOVEnkov (button) collected ($0.37)
Seat 6: hali ya hewa (small blind) folded before Flop



PokerStars Hand #201507686420:  Hold'em No Limit ($0.05/$0.10 USD) - 2019/06/18 10:18:58 ET
Table 'Moreau III' 6-max Seat #6 is the button
Seat 1: togl63amg ($13.56 in chips) 
Seat 2: Simanov.A ($9.78 in chips) 
Seat 3: ReKych ($10 in chips) 
Seat 4: pichcora 811 ($10.02 in chips) 
Seat 5: eeeLOVEnkov ($11.37 in chips) 
Seat 6: hali ya hewa ($7.61 in chips) 
togl63amg: posts small blind $0.05
Simanov.A: posts big blind $0.10
togl63amg: posts the ante $0.02
Simanov.A: posts the ante $0.02
ReKych: posts the ante $0.02
pichcora 811: posts the ante $0.02
eeeLOVEnkov: posts the ante $0.02
hali ya hewa: posts the ante $0.02
*** HOLE CARDS ***
ReKych: folds 
pichcora 811: folds 
eeeLOVEnkov: folds 
hali ya hewa: raises $0.20 to $0.30
togl63amg: raises $0.60 to $0.90
Simanov.A: folds 
hali ya hewa: calls $0.60
*** FLOP *** [2d 5s As]
togl63amg: bets $0.70
hali ya hewa: calls $0.70
*** TURN *** [2d 5s As] [Ks]
togl63amg: bets $1.50
hali ya hewa: raises $4.49 to $5.99 and is all-in
togl63amg: calls $4.49
*** RIVER *** [2d 5s As Ks] [Kc]
*** SHOW DOWN ***
togl63amg: shows [Ad Qd] (two pair, Aces and Kings)
hali ya hewa: shows [Kh 5h] (a full house, Kings full of Fives)
hali ya hewa collected $14.71 from pot
*** SUMMARY ***
Total pot $15.40 | Rake $0.69 
Board [2d 5s As Ks Kc]
Seat 1: togl63amg (small blind) showed [Ad Qd] and lost with two pair, Aces and Kings
Seat 2: Simanov.A (big blind) folded before Flop
Seat 3: ReKych folded before Flop (didn't bet)
Seat 4: pichcora 811 folded before Flop (didn't bet)
Seat 5: eeeLOVEnkov folded before Flop (didn't bet)
Seat 6: hali ya hewa (button) showed [Kh 5h] and won ($14.71) with a full house, Kings full of Fives



PokerStars Hand #201507707829:  Hold'em No Limit ($0.05/$0.10 USD) - 2019/06/18 10:19:54 ET
Table 'Moreau III' 6-max Seat #1 is the button
Seat 1: togl63amg ($10 in chips) 
Seat 2: Simanov.A ($9.66 in chips) 
Seat 3: ReKych ($10 in chips) 
Seat 4: pichcora 811 ($10 in chips) 
Seat 5: eeeLOVEnkov ($11.35 in chips) 
Seat 6: hali ya hewa ($14.71 in chips) 
Simanov.A: posts small blind $0.05
ReKych: posts big blind $0.10
togl63amg: posts the ante $0.02
Simanov.A: posts the ante $0.02
ReKych: posts the ante $0.02
pichcora 811: posts the ante $0.02
eeeLOVEnkov: posts the ante $0.02
hali ya hewa: posts the ante $0.02
*** HOLE CARDS ***
pichcora 811: folds 
eeeLOVEnkov: folds 
hali ya hewa: folds 
togl63amg: raises $0.20 to $0.30
Simanov.A: calls $0.25
ReKych: folds 
*** FLOP *** [3s 5h 3d]
Simanov.A: checks 
togl63amg: bets $0.31
Simanov.A: calls $0.31
*** TURN *** [3s 5h 3d] [2s]
Simanov.A: checks 
togl63amg: checks 
*** RIVER *** [3s 5h 3d 2s] [Qc]
Simanov.A: bets $2.20
togl63amg: folds 
Uncalled bet ($2.20) returned to Simanov.A
Simanov.A collected $1.38 from pot
Simanov.A: doesn't show hand 
*** SUMMARY ***
Total pot $1.44 | Rake $0.06 
Board [3s 5h 3d 2s Qc]
Seat 1: togl63amg (button) folded on the River
Seat 2: Simanov.A (small blind) collected ($1.38)
Seat 3: ReKych (big blind) folded before Flop
Seat 4: pichcora 811 folded before Flop (didn't bet)
Seat 5: eeeLOVEnkov folded before Flop (didn't bet)
Seat 6: hali ya hewa folded before Flop (didn't bet)



PokerStars Hand #201507774465:  Hold'em No Limit ($0.05/$0.10 USD) - 2019/06/18 10:22:48 ET
Table 'Moreau III' 6-max Seat #6 is the button
Seat 1: togl63amg ($11.12 in chips) 
Seat 2: Simanov.A ($10.33 in chips) 
Seat 3: ReKych ($10 in chips) 
Seat 4: pichcora 811 ($10 in chips) 
Seat 5: eeeLOVEnkov ($11.10 in chips) 
Seat 6: hali ya hewa ($14.46 in chips) 
togl63amg: posts small blind $0.05
Simanov.A: posts big blind $0.10
togl63amg: posts the ante $0.02
Simanov.A: posts the ante $0.02
ReKych: posts the ante $0.02
pichcora 811: posts the ante $0.02
eeeLOVEnkov: posts the ante $0.02
hali ya hewa: posts the ante $0.02
*** HOLE CARDS ***
ReKych: folds 
pichcora 811: folds 
eeeLOVEnkov: folds 
hali ya hewa: raises $0.20 to $0.30
togl63amg: folds 
Simanov.A: folds 
Uncalled bet ($0.20) returned to hali ya hewa
hali ya hewa collected $0.37 from pot
hali ya hewa: doesn't show hand 
*** SUMMARY ***
Total pot $0.37 | Rake $0 
Seat 1: togl63amg (small blind) folded before Flop
Seat 2: Simanov.A (big blind) folded before Flop
Seat 3: ReKych folded before Flop (didn't bet)
Seat 4: pichcora 811 folded before Flop (didn't bet)
Seat 5: eeeLOVEnkov folded before Flop (didn't bet)
Seat 6: hali ya hewa (button) collected ($0.37)



PokerStars Hand #201507786168:  Hold'em No Limit ($0.05/$0.10 USD) - 2019/06/18 10:23:19 ET
Table 'Moreau III' 6-max Seat #1 is the button
Seat 1: togl63amg ($11.05 in chips) 
Seat 2: Simanov.A ($10.21 in chips) 
Seat 3: ReKych ($10 in chips) 
Seat 4: pichcora 811 ($10 in chips) 
Seat 5: eeeLOVEnkov ($11.08 in chips) 
Seat 6: hali ya hewa ($14.71 in chips) 
Simanov.A: posts small blind $0.05
ReKych: posts big blind $0.10
togl63amg: posts the ante $0.02
Simanov.A: posts the ante $0.02
ReKych: posts the ante $0.02
pichcora 811: posts the ante $0.02
eeeLOVEnkov: posts the ante $0.02
hali ya hewa: posts the ante $0.02
*** HOLE CARDS ***
pichcora 811: folds 
eeeLOVEnkov: folds 
hali ya hewa: folds 
togl63amg: raises $0.20 to $0.30
Simanov.A: folds 
ReKych: folds 
Uncalled bet ($0.20) returned to togl63amg
togl63amg collected $0.37 from pot
*** SUMMARY ***
Total pot $0.37 | Rake $0 
Seat 1: togl63amg (button) collected ($0.37)
Seat 2: Simanov.A (small blind) folded before Flop
Seat 3: ReKych (big blind) folded before Flop
Seat 4: pichcora 811 folded before Flop (didn't bet)
Seat 5: eeeLOVEnkov folded before Flop (didn't bet)
Seat 6: hali ya hewa folded before Flop (didn't bet)



PokerStars Hand #201507792228:  Hold'em No Limit ($0.05/$0.10 USD) - 2019/06/18 10:23:35 ET
Table 'Moreau III' 6-max Seat #2 is the button
Seat 1: togl63amg ($11.30 in chips) 
Seat 2: Simanov.A ($10.14 in chips) 
Seat 3: ReKych ($10 in chips) 
Seat 5: eeeLOVEnkov ($11.06 in chips) 
Seat 6: hali ya hewa ($14.69 in chips) 
ReKych: posts small blind $0.05
pichcora 811: is sitting out 
eeeLOVEnkov: posts big blind $0.10
togl63amg: posts the ante $0.02
Simanov.A: posts the ante $0.02
ReKych: posts the ante $0.02
eeeLOVEnkov: posts the ante $0.02
hali ya hewa: posts the ante $0.02
*** HOLE CARDS ***
pichcora 811 leaves the table
hali ya hewa: folds 
togl63amg: folds 
Simanov.A: raises $0.20 to $0.30
ReKych: folds 
eeeLOVEnkov: folds 
Uncalled bet ($0.20) returned to Simanov.A
Simanov.A collected $0.35 from pot
Simanov.A: doesn't show hand 
*** SUMMARY ***
Total pot $0.35 | Rake $0 
Seat 1: togl63amg folded before Flop (didn't bet)
Seat 2: Simanov.A (button) collected ($0.35)
Seat 3: ReKych (small blind) folded before Flop
Seat 5: eeeLOVEnkov (big blind) folded before Flop
Seat 6: hali ya hewa folded before Flop (didn't bet)



PokerStars Hand #201507798713:  Hold'em No Limit ($0.05/$0.10 USD) - 2019/06/18 10:23:52 ET
Table 'Moreau III' 6-max Seat #3 is the button
Seat 1: togl63amg ($11.28 in chips) 
Seat 2: Simanov.A ($10.37 in chips) 
Seat 3: ReKych ($10 in chips) 
Seat 5: eeeLOVEnkov ($10.94 in chips) 
Seat 6: hali ya hewa ($14.67 in chips) 
eeeLOVEnkov: posts small blind $0.05
hali ya hewa: posts big blind $0.10
togl63amg: posts the ante $0.02
Simanov.A: posts the ante $0.02
ReKych: posts the ante $0.02
eeeLOVEnkov: posts the ante $0.02
hali ya hewa: posts the ante $0.02
*** HOLE CARDS ***
togl63amg: folds 
Simanov.A: raises $0.20 to $0.30
ReKych: folds 
eeeLOVEnkov: folds 
hali ya hewa: calls $0.20
*** FLOP *** [2c 8d Qd]
DDarks joins the table at seat #4 
hali ya hewa: bets $0.40
Simanov.A: calls $0.40
*** TURN *** [2c 8d Qd] [9d]
hali ya hewa: bets $0.70
Simanov.A: folds 
Uncalled bet ($0.70) returned to hali ya hewa
hali ya hewa collected $1.48 from pot
hali ya hewa: doesn't show hand 
*** SUMMARY ***
Total pot $1.55 | Rake $0.07 
Board [2c 8d Qd 9d]
Seat 1: togl63amg folded before Flop (didn't bet)
Seat 2: Simanov.A folded on the Turn
Seat 3: ReKych (button) folded before Flop (didn't bet)
Seat 5: eeeLOVEnkov (small blind) folded before Flop
Seat 6: hali ya hewa (big blind) collected ($1.48)



PokerStars Hand #201507826614:  Hold'em No Limit ($0.05/$0.10 USD) - 2019/06/18 10:25:05 ET
Table 'Moreau III' 6-max Seat #5 is the button
Seat 1: togl63amg ($11.26 in chips) 
Seat 2: Simanov.A ($9.65 in chips) 
Seat 3: ReKych ($10 in chips) 
Seat 5: eeeLOVEnkov ($10.87 in chips) 
Seat 6: hali ya hewa ($15.43 in chips) 
hali ya hewa: posts small blind $0.05
togl63amg: posts big blind $0.10
DDarks: sits out 
togl63amg: posts the ante $0.02
Simanov.A: posts the ante $0.02
ReKych: posts the ante $0.02
eeeLOVEnkov: posts the ante $0.02
hali ya hewa: posts the ante $0.02
*** HOLE CARDS ***
Simanov.A: folds 
ReKych: folds 
eeeLOVEnkov: folds 
hali ya hewa: raises $0.20 to $0.30
togl63amg: calls $0.20
*** FLOP *** [Ks 5h Th]
hali ya hewa: bets $0.30
togl63amg: folds 
Uncalled bet ($0.30) returned to hali ya hewa
hali ya hewa collected $0.67 from pot
hali ya hewa: doesn't show hand 
*** SUMMARY ***
Total pot $0.70 | Rake $0.03 
Board [Ks 5h Th]
Seat 1: togl63amg (big blind) folded on the Flop
Seat 2: Simanov.A folded before Flop (didn't bet)
Seat 3: ReKych folded before Flop (didn't bet)
Seat 5: eeeLOVEnkov (button) folded before Flop (didn't bet)
Seat 6: hali ya hewa (small blind) collected ($0.67)



PokerStars Hand #201507842811:  Hold'em No Limit ($0.05/$0.10 USD) - 2019/06/18 10:25:47 ET
Table 'Moreau III' 6-max Seat #6 is the button
Seat 1: togl63amg ($10.94 in chips) 
Seat 2: Simanov.A ($9.63 in chips) 
Seat 3: ReKych ($10 in chips) 
Seat 5: eeeLOVEnkov ($10.85 in chips) 
Seat 6: hali ya hewa ($15.78 in chips) 
togl63amg: posts small blind $0.05
Simanov.A: posts big blind $0.10
DDarks: sits out 
togl63amg: posts the ante $0.02
Simanov.A: posts the ante $0.02
ReKych: posts the ante $0.02
eeeLOVEnkov: posts the ante $0.02
hali ya hewa: posts the ante $0.02
*** HOLE CARDS ***
ReKych: folds 
eeeLOVEnkov: folds 
hali ya hewa: raises $0.20 to $0.30
togl63amg: calls $0.25
Simanov.A: calls $0.20
*** FLOP *** [7s 9c 8c]
togl63amg: checks 
Simanov.A: checks 
hali ya hewa: checks 
*** TURN *** [7s 9c 8c] [Qc]
togl63amg: checks 
Simanov.A: bets $0.40
hali ya hewa: folds 
togl63amg: raises $0.70 to $1.10
Simanov.A: calls $0.70
*** RIVER *** [7s 9c 8c Qc] [7d]
togl63amg: bets $2.14
Simanov.A: calls $2.14
*** SHOW DOWN ***
togl63amg: shows [Tc Js] (a straight, Eight to Queen)
Simanov.A: mucks hand 
togl63amg collected $7.14 from pot
*** SUMMARY ***
Total pot $7.48 | Rake $0.34 
Board [7s 9c 8c Qc 7d]
Seat 1: togl63amg (small blind) showed [Tc Js] and won ($7.14) with a straight, Eight to Queen
Seat 2: Simanov.A (big blind) mucked
Seat 3: ReKych folded before Flop (didn't bet)
Seat 5: eeeLOVEnkov folded before Flop (didn't bet)
Seat 6: hali ya hewa (button) folded on the Turn



PokerStars Hand #201507865523:  Hold'em No Limit ($0.05/$0.10 USD) - 2019/06/18 10:26:46 ET
Table 'Moreau III' 6-max Seat #1 is the button
Seat 1: togl63amg ($14.52 in chips) 
Seat 2: Simanov.A ($6.07 in chips) 
Seat 3: ReKych ($10 in chips) 
Seat 5: eeeLOVEnkov ($10.83 in chips) 
Seat 6: hali ya hewa ($15.46 in chips) 
Simanov.A: posts small blind $0.05
ReKych: posts big blind $0.10
DDarks: sits out 
togl63amg: posts the ante $0.02
Simanov.A: posts the ante $0.02
ReKych: posts the ante $0.02
eeeLOVEnkov: posts the ante $0.02
hali ya hewa: posts the ante $0.02
*** HOLE CARDS ***
eeeLOVEnkov: folds 
hali ya hewa: raises $0.20 to $0.30
togl63amg: folds 
Simanov.A: folds 
ReKych: calls $0.20
*** FLOP *** [4d 6s Ks]
ReKych: checks 
hali ya hewa: checks 
*** TURN *** [4d 6s Ks] [6d]
ReKych: checks 
hali ya hewa: checks 
*** RIVER *** [4d 6s Ks 6d] [8s]
ReKych: bets $1.05
hali ya hewa: folds 
Uncalled bet ($1.05) returned to ReKych
ReKych collected $0.72 from pot
ReKych: doesn't show hand 
*** SUMMARY ***
Total pot $0.75 | Rake $0.03 
Board [4d 6s Ks 6d 8s]
Seat 1: togl63amg (button) folded before Flop (didn't bet)
Seat 2: Simanov.A (small blind) folded before Flop
Seat 3: ReKych (big blind) collected ($0.72)
Seat 5: eeeLOVEnkov folded before Flop (didn't bet)
Seat 6: hali ya hewa folded on the River



PokerStars Hand #201507880510:  Hold'em No Limit ($0.05/$0.10 USD) - 2019/06/18 10:27:24 ET
Table 'Moreau III' 6-max Seat #2 is the button
Seat 1: togl63amg ($14.50 in chips) 
Seat 2: Simanov.A ($6 in chips) 
Seat 3: ReKych ($10.40 in chips) 
Seat 4: DDarks ($8 in chips) 
Seat 5: eeeLOVEnkov ($10.81 in chips) 
Seat 6: hali ya hewa ($15.14 in chips) 
ReKych: posts small blind $0.05
DDarks: posts big blind $0.10
togl63amg: posts the ante $0.02
Simanov.A: posts the ante $0.02
ReKych: posts the ante $0.02
DDarks: posts the ante $0.02
eeeLOVEnkov: posts the ante $0.02
hali ya hewa: posts the ante $0.02
*** HOLE CARDS ***
eeeLOVEnkov: folds 
hali ya hewa: folds 
togl63amg: raises $0.20 to $0.30
Simanov.A: folds 
ReKych: folds 
DDarks: calls $0.20
*** FLOP *** [5d 3s 9h]
DDarks: checks 
togl63amg: bets $0.41
DDarks: folds 
Uncalled bet ($0.41) returned to togl63amg
togl63amg collected $0.74 from pot
*** SUMMARY ***
Total pot $0.77 | Rake $0.03 
Board [5d 3s 9h]
Seat 1: togl63amg collected ($0.74)
Seat 2: Simanov.A (button) folded before Flop (didn't bet)
Seat 3: ReKych (small blind) folded before Flop
Seat 4: DDarks (big blind) folded on the Flop
Seat 5: eeeLOVEnkov folded before Flop (didn't bet)
Seat 6: hali ya hewa folded before Flop (didn't bet)



PokerStars Hand #201507890214:  Hold'em No Limit ($0.05/$0.10 USD) - 2019/06/18 10:27:50 ET
Table 'Moreau III' 6-max Seat #3 is the button
Seat 1: togl63amg ($14.92 in chips) 
Seat 2: Simanov.A ($5.98 in chips) 
Seat 3: ReKych ($10.33 in chips) 
Seat 4: DDarks ($7.68 in chips) 
Seat 6: hali ya hewa ($15.12 in chips) 
DDarks: posts small blind $0.05
eeeLOVEnkov: is sitting out 
eeeLOVEnkov leaves the table
hali ya hewa: posts big blind $0.10
togl63amg: posts the ante $0.02
Simanov.A: posts the ante $0.02
ReKych: posts the ante $0.02
DDarks: posts the ante $0.02
hali ya hewa: posts the ante $0.02
*** HOLE CARDS ***
Klim_89 joins the table at seat #5 
togl63amg: raises $0.20 to $0.30
Simanov.A: folds 
ReKych: folds 
DDarks: folds 
hali ya hewa: calls $0.20
*** FLOP *** [Ac 6s 5c]
hali ya hewa: checks 
togl63amg: bets $0.50
hali ya hewa: folds 
Uncalled bet ($0.50) returned to togl63amg
togl63amg collected $0.72 from pot
*** SUMMARY ***
Total pot $0.75 | Rake $0.03 
Board [Ac 6s 5c]
Seat 1: togl63amg collected ($0.72)
Seat 2: Simanov.A folded before Flop (didn't bet)
Seat 3: ReKych (button) folded before Flop (didn't bet)
Seat 4: DDarks (small blind) folded before Flop
Seat 6: hali ya hewa (big blind) folded on the Flop



PokerStars Hand #201507902829:  Hold'em No Limit ($0.05/$0.10 USD) - 2019/06/18 10:28:23 ET
Table 'Moreau III' 6-max Seat #4 is the button
Seat 1: togl63amg ($15.32 in chips) 
Seat 2: Simanov.A ($5.96 in chips) 
Seat 3: ReKych ($10.31 in chips) 
Seat 4: DDarks ($7.61 in chips) 
Seat 6: hali ya hewa ($14.80 in chips) 
hali ya hewa: posts small blind $0.05
togl63amg: posts big blind $0.10
togl63amg: posts the ante $0.02
Simanov.A: posts the ante $0.02
ReKych: posts the ante $0.02
DDarks: posts the ante $0.02
hali ya hewa: posts the ante $0.02
*** HOLE CARDS ***
Simanov.A: folds 
ReKych: folds 
DDarks: folds 
hali ya hewa: folds 
Uncalled bet ($0.05) returned to togl63amg
togl63amg collected $0.20 from pot
*** SUMMARY ***
Total pot $0.20 | Rake $0 
Seat 1: togl63amg (big blind) collected ($0.20)
Seat 2: Simanov.A folded before Flop (didn't bet)
Seat 3: ReKych folded before Flop (didn't bet)
Seat 4: DDarks (button) folded before Flop (didn't bet)
Seat 6: hali ya hewa (small blind) folded before Flop



PokerStars Hand #201507907510:  Hold'em No Limit ($0.05/$0.10 USD) - 2019/06/18 10:28:35 ET
Table 'Moreau III' 6-max Seat #6 is the button
Seat 1: togl63amg ($15.45 in chips) 
Seat 2: Simanov.A ($5.94 in chips) 
Seat 3: ReKych ($10.29 in chips) 
Seat 4: DDarks ($7.59 in chips) 
Seat 6: hali ya hewa ($14.73 in chips) 
togl63amg: posts small blind $0.05
Simanov.A: posts big blind $0.10
Klim_89: sits out 
togl63amg: posts the ante $0.02
Simanov.A: posts the ante $0.02
ReKych: posts the ante $0.02
DDarks: posts the ante $0.02
hali ya hewa: posts the ante $0.02
*** HOLE CARDS ***
ReKych: raises $0.20 to $0.30
DDarks: raises $0.20 to $0.50
hali ya hewa: folds 
togl63amg: folds 
Simanov.A: calls $0.40
ReKych: calls $0.20
*** FLOP *** [9d Jd Qd]
Simanov.A: checks 
ReKych: checks 
DDarks: bets $1
Simanov.A: folds 
ReKych: folds 
Uncalled bet ($1) returned to DDarks
DDarks collected $1.58 from pot
DDarks: doesn't show hand 
*** SUMMARY ***
Total pot $1.65 | Rake $0.07 
Board [9d Jd Qd]
Seat 1: togl63amg (small blind) folded before Flop
Seat 2: Simanov.A (big blind) folded on the Flop
Seat 3: ReKych folded on the Flop
Seat 4: DDarks collected ($1.58)
Seat 6: hali ya hewa (button) folded before Flop (didn't bet)



PokerStars Hand #201507929035:  Hold'em No Limit ($0.05/$0.10 USD) - 2019/06/18 10:29:32 ET
Table 'Moreau III' 6-max Seat #1 is the button
Seat 1: togl63amg ($15.38 in chips) 
Seat 2: Simanov.A ($5.42 in chips) 
Seat 3: ReKych ($10 in chips) 
Seat 4: DDarks ($8.65 in chips) 
Seat 6: hali ya hewa ($14.71 in chips) 
Simanov.A: posts small blind $0.05
ReKych: posts big blind $0.10
Klim_89: sits out 
togl63amg: posts the ante $0.02
Simanov.A: posts the ante $0.02
ReKych: posts the ante $0.02
DDarks: posts the ante $0.02
hali ya hewa: posts the ante $0.02
*** HOLE CARDS ***
DDarks: calls $0.10
hali ya hewa is disconnected 
hali ya hewa is connected 
hali ya hewa: raises $0.20 to $0.30
togl63amg: calls $0.30
Simanov.A: folds 
ReKych: folds 
DDarks: calls $0.20
*** FLOP *** [Tc Ac 9c]
DDarks: bets $0.50
hali ya hewa: folds 
togl63amg: folds 
Uncalled bet ($0.50) returned to DDarks
DDarks collected $1.10 from pot
DDarks: doesn't show hand 
*** SUMMARY ***
Total pot $1.15 | Rake $0.05 
Board [Tc Ac 9c]
Seat 1: togl63amg (button) folded on the Flop
Seat 2: Simanov.A (small blind) folded before Flop
Seat 3: ReKych (big blind) folded before Flop
Seat 4: DDarks collected ($1.10)
Seat 6: hali ya hewa folded on the Flop



PokerStars Hand #201507951450:  Hold'em No Limit ($0.05/$0.10 USD) - 2019/06/18 10:30:31 ET
Table 'Moreau III' 6-max Seat #2 is the button
Seat 1: togl63amg ($15.06 in chips) 
Seat 2: Simanov.A ($5.35 in chips) 
Seat 3: ReKych ($10 in chips) 
Seat 4: DDarks ($9.43 in chips) 
Seat 6: hali ya hewa ($14.39 in chips) 
ReKych: posts small blind $0.05
DDarks: posts big blind $0.10
Klim_89: sits out 
togl63amg: posts the ante $0.02
Simanov.A: posts the ante $0.02
ReKych: posts the ante $0.02
DDarks: posts the ante $0.02
hali ya hewa: posts the ante $0.02
*** HOLE CARDS ***
hali ya hewa: raises $0.20 to $0.30
togl63amg: folds 
Simanov.A: folds 
ReKych: calls $0.25
DDarks: calls $0.20
*** FLOP *** [5d Ah Ks]
ReKych: checks 
DDarks: bets $0.40
hali ya hewa: folds 
ReKych: calls $0.40
*** TURN *** [5d Ah Ks] [2h]
ReKych: checks 
DDarks: bets $0.50
ReKych: folds 
Uncalled bet ($0.50) returned to DDarks
DDarks collected $1.72 from pot
DDarks: doesn't show hand 
*** SUMMARY ***
Total pot $1.80 | Rake $0.08 
Board [5d Ah Ks 2h]
Seat 1: togl63amg folded before Flop (didn't bet)
Seat 2: Simanov.A (button) folded before Flop (didn't bet)
Seat 3: ReKych (small blind) folded on the Turn
Seat 4: DDarks (big blind) collected ($1.72)
Seat 6: hali ya hewa folded on the Flop



PokerStars Hand #201507972761:  Hold'em No Limit ($0.05/$0.10 USD) - 2019/06/18 10:31:27 ET
Table 'Moreau III' 6-max Seat #3 is the button
Seat 1: togl63amg ($15.04 in chips) 
Seat 2: Simanov.A ($5.33 in chips) 
Seat 3: ReKych ($10 in chips) 
Seat 4: DDarks ($10.43 in chips) 
Seat 5: Klim_89 ($10.23 in chips) 
Seat 6: hali ya hewa ($14.07 in chips) 
DDarks: posts small blind $0.05
Klim_89: posts big blind $0.10
togl63amg: posts the ante $0.02
Simanov.A: posts the ante $0.02
ReKych: posts the ante $0.02
DDarks: posts the ante $0.02
Klim_89: posts the ante $0.02
hali ya hewa: posts the ante $0.02
*** HOLE CARDS ***
hali ya hewa: folds 
togl63amg: folds 
Simanov.A: calls $0.10
ReKych: raises $0.35 to $0.45
DDarks: calls $0.40
Klim_89: folds 
Simanov.A: folds 
*** FLOP *** [8s 2c 8h]
DDarks: checks 
ReKych: checks 
*** TURN *** [8s 2c 8h] [Jc]
DDarks: bets $0.30
ReKych: folds 
Uncalled bet ($0.30) returned to DDarks
DDarks collected $1.17 from pot
DDarks: doesn't show hand 
*** SUMMARY ***
Total pot $1.22 | Rake $0.05 
Board [8s 2c 8h Jc]
Seat 1: togl63amg folded before Flop (didn't bet)
Seat 2: Simanov.A folded before Flop
Seat 3: ReKych (button) folded on the Turn
Seat 4: DDarks (small blind) collected ($1.17)
Seat 5: Klim_89 (big blind) folded before Flop
Seat 6: hali ya hewa folded before Flop (didn't bet)



PokerStars Hand #201507999521:  Hold'em No Limit ($0.05/$0.10 USD) - 2019/06/18 10:32:37 ET
Table 'Moreau III' 6-max Seat #4 is the button
Seat 1: togl63amg ($15.02 in chips) 
Seat 2: Simanov.A ($5.21 in chips) 
Seat 3: ReKych ($10 in chips) 
Seat 4: DDarks ($11.13 in chips) 
Seat 5: Klim_89 ($10.11 in chips) 
Seat 6: hali ya hewa ($14.05 in chips) 
Klim_89: posts small blind $0.05
hali ya hewa: posts big blind $0.10
togl63amg: posts the ante $0.02
Simanov.A: posts the ante $0.02
ReKych: posts the ante $0.02
DDarks: posts the ante $0.02
Klim_89: posts the ante $0.02
hali ya hewa: posts the ante $0.02
*** HOLE CARDS ***
togl63amg: raises $0.20 to $0.30
Simanov.A: folds 
ReKych: folds 
DDarks: calls $0.30
Klim_89: calls $0.25
hali ya hewa: calls $0.20
*** FLOP *** [As 7d 7c]
Klim_89: checks 
hali ya hewa: checks 
togl63amg: checks 
DDarks: bets $0.40
Klim_89: folds 
hali ya hewa: calls $0.40
togl63amg: calls $0.40
*** TURN *** [As 7d 7c] [Ts]
hali ya hewa: checks 
togl63amg: checks 
DDarks: checks 
*** RIVER *** [As 7d 7c Ts] [Kh]
hali ya hewa: checks 
togl63amg: checks 
DDarks: bets $0.40
hali ya hewa: raises $1.60 to $2
togl63amg: folds 
DDarks: calls $1.60
*** SHOW DOWN ***
hali ya hewa: shows [2d 2s] (two pair, Sevens and Deuces)
DDarks: shows [9s Kd] (two pair, Kings and Sevens)
DDarks collected $6.23 from pot
*** SUMMARY ***
Total pot $6.52 | Rake $0.29 
Board [As 7d 7c Ts Kh]
Seat 1: togl63amg folded on the River
Seat 2: Simanov.A folded before Flop (didn't bet)
Seat 3: ReKych folded before Flop (didn't bet)
Seat 4: DDarks (button) showed [9s Kd] and won ($6.23) with two pair, Kings and Sevens
Seat 5: Klim_89 (small blind) folded on the Flop
Seat 6: hali ya hewa (big blind) showed [2d 2s] and lost with two pair, Sevens and Deuces



PokerStars Hand #201508021705:  Hold'em No Limit ($0.05/$0.10 USD) - 2019/06/18 10:33:35 ET
Table 'Moreau III' 6-max Seat #5 is the button
Seat 1: togl63amg ($14.30 in chips) 
Seat 2: Simanov.A ($5.19 in chips) 
Seat 3: ReKych ($10 in chips) 
Seat 4: DDarks ($14.64 in chips) 
Seat 5: Klim_89 ($10 in chips) 
Seat 6: hali ya hewa ($11.33 in chips) 
hali ya hewa: posts small blind $0.05
togl63amg: posts big blind $0.10
togl63amg: posts the ante $0.02
Simanov.A: posts the ante $0.02
ReKych: posts the ante $0.02
DDarks: posts the ante $0.02
Klim_89: posts the ante $0.02
hali ya hewa: posts the ante $0.02
*** HOLE CARDS ***
Simanov.A: folds 
ReKych: folds 
DDarks: calls $0.10
Klim_89: folds 
hali ya hewa: folds 
togl63amg: raises $0.37 to $0.47
DDarks: calls $0.37
*** FLOP *** [2h Kd 6d]
togl63amg: checks 
DDarks: checks 
*** TURN *** [2h Kd 6d] [7d]
togl63amg: bets $0.74
DDarks: folds 
Uncalled bet ($0.74) returned to togl63amg
togl63amg collected $1.06 from pot
*** SUMMARY ***
Total pot $1.11 | Rake $0.05 
Board [2h Kd 6d 7d]
Seat 1: togl63amg (big blind) collected ($1.06)
Seat 2: Simanov.A folded before Flop (didn't bet)
Seat 3: ReKych folded before Flop (didn't bet)
Seat 4: DDarks folded on the Turn
Seat 5: Klim_89 (button) folded before Flop (didn't bet)
Seat 6: hali ya hewa (small blind) folded before Flop



PokerStars Hand #201508033104:  Hold'em No Limit ($0.05/$0.10 USD) - 2019/06/18 10:34:05 ET
Table 'Moreau III' 6-max Seat #6 is the button
Seat 1: togl63amg ($14.87 in chips) 
Seat 2: Simanov.A ($5.17 in chips) 
Seat 3: ReKych ($10 in chips) 
Seat 4: DDarks ($14.15 in chips) 
Seat 5: Klim_89 ($10 in chips) 
Seat 6: hali ya hewa ($11.26 in chips) 
togl63amg: posts small blind $0.05
Simanov.A: posts big blind $0.10
togl63amg: posts the ante $0.02
Simanov.A: posts the ante $0.02
ReKych: posts the ante $0.02
DDarks: posts the ante $0.02
Klim_89: posts the ante $0.02
hali ya hewa: posts the ante $0.02
*** HOLE CARDS ***
ReKych: folds 
DDarks: folds 
Klim_89: folds 
hali ya hewa: folds 
togl63amg: folds 
Uncalled bet ($0.05) returned to Simanov.A
Simanov.A collected $0.22 from pot
Simanov.A: doesn't show hand 
*** SUMMARY ***
Total pot $0.22 | Rake $0 
Seat 1: togl63amg (small blind) folded before Flop
Seat 2: Simanov.A (big blind) collected ($0.22)
Seat 3: ReKych folded before Flop (didn't bet)
Seat 4: DDarks folded before Flop (didn't bet)
Seat 5: Klim_89 folded before Flop (didn't bet)
Seat 6: hali ya hewa (button) folded before Flop (didn't bet)



PokerStars Hand #201508041024:  Hold'em No Limit ($0.05/$0.10 USD) - 2019/06/18 10:34:25 ET
Table 'Moreau III' 6-max Seat #1 is the button
Seat 1: togl63amg ($14.80 in chips) 
Seat 2: Simanov.A ($5.32 in chips) 
Seat 3: ReKych ($10 in chips) 
Seat 4: DDarks ($14.13 in chips) 
Seat 5: Klim_89 ($10 in chips) 
Seat 6: hali ya hewa ($11.24 in chips) 
Simanov.A: posts small blind $0.05
ReKych: posts big blind $0.10
togl63amg: posts the ante $0.02
Simanov.A: posts the ante $0.02
ReKych: posts the ante $0.02
DDarks: posts the ante $0.02
Klim_89: posts the ante $0.02
hali ya hewa: posts the ante $0.02
*** HOLE CARDS ***
DDarks: folds 
Klim_89: folds 
hali ya hewa: folds 
togl63amg: folds 
Simanov.A: raises $0.20 to $0.30
ReKych: calls $0.20
*** FLOP *** [8h Js Kc]
Simanov.A: checks 
ReKych: bets $0.45
Simanov.A: calls $0.45
*** TURN *** [8h Js Kc] [7d]
Simanov.A: checks 
ReKych: checks 
*** RIVER *** [8h Js Kc 7d] [Jc]
Simanov.A: checks 
ReKych: checks 
*** SHOW DOWN ***
Simanov.A: shows [As Qs] (a pair of Jacks)
ReKych: shows [4h 4s] (two pair, Jacks and Fours)
ReKych collected $1.55 from pot
*** SUMMARY ***
Total pot $1.62 | Rake $0.07 
Board [8h Js Kc 7d Jc]
Seat 1: togl63amg (button) folded before Flop (didn't bet)
Seat 2: Simanov.A (small blind) showed [As Qs] and lost with a pair of Jacks
Seat 3: ReKych (big blind) showed [4h 4s] and won ($1.55) with two pair, Jacks and Fours
Seat 4: DDarks folded before Flop (didn't bet)
Seat 5: Klim_89 folded before Flop (didn't bet)
Seat 6: hali ya hewa folded before Flop (didn't bet)



PokerStars Hand #201508066312:  Hold'em No Limit ($0.05/$0.10 USD) - 2019/06/18 10:35:34 ET
Table 'Moreau III' 6-max Seat #2 is the button
Seat 1: togl63amg ($14.78 in chips) 
Seat 2: Simanov.A ($4.55 in chips) 
Seat 3: ReKych ($10.78 in chips) 
Seat 4: DDarks ($14.11 in chips) 
Seat 5: Klim_89 ($10 in chips) 
Seat 6: hali ya hewa ($11.22 in chips) 
ReKych: posts small blind $0.05
DDarks: posts big blind $0.10
togl63amg: posts the ante $0.02
Simanov.A: posts the ante $0.02
ReKych: posts the ante $0.02
DDarks: posts the ante $0.02
Klim_89: posts the ante $0.02
hali ya hewa: posts the ante $0.02
*** HOLE CARDS ***
Klim_89: folds 
hali ya hewa: raises $0.20 to $0.30
togl63amg: folds 
Simanov.A: calls $0.30
ReKych: folds 
DDarks: calls $0.20
*** FLOP *** [Qs Ks Th]
DDarks: checks 
hali ya hewa: bets $0.50
Simanov.A: folds 
DDarks: calls $0.50
*** TURN *** [Qs Ks Th] [2h]
DDarks: checks 
hali ya hewa: bets $1
DDarks: folds 
Uncalled bet ($1) returned to hali ya hewa
hali ya hewa collected $1.98 from pot
hali ya hewa: doesn't show hand 
*** SUMMARY ***
Total pot $2.07 | Rake $0.09 
Board [Qs Ks Th 2h]
Seat 1: togl63amg folded before Flop (didn't bet)
Seat 2: Simanov.A (button) folded on the Flop
Seat 3: ReKych (small blind) folded before Flop
Seat 4: DDarks (big blind) folded on the Turn
Seat 5: Klim_89 folded before Flop (didn't bet)
Seat 6: hali ya hewa collected ($1.98)



PokerStars Hand #201508081527:  Hold'em No Limit ($0.05/$0.10 USD) - 2019/06/18 10:36:14 ET
Table 'Moreau III' 6-max Seat #3 is the button
Seat 1: togl63amg ($14.76 in chips) 
Seat 2: Simanov.A ($4.23 in chips) 
Seat 3: ReKych ($10.71 in chips) 
Seat 4: DDarks ($13.29 in chips) 
Seat 5: Klim_89 ($10 in chips) 
Seat 6: hali ya hewa ($12.38 in chips) 
DDarks: posts small blind $0.05
Klim_89: posts big blind $0.10
togl63amg: posts the ante $0.02
Simanov.A: posts the ante $0.02
ReKych: posts the ante $0.02
DDarks: posts the ante $0.02
Klim_89: posts the ante $0.02
hali ya hewa: posts the ante $0.02
*** HOLE CARDS ***
hali ya hewa: folds 
togl63amg: folds 
Simanov.A: raises $0.20 to $0.30
ReKych: raises $0.70 to $1
DDarks: folds 
Klim_89: raises $1.20 to $2.20
Simanov.A: folds 
ReKych: folds 
Uncalled bet ($1.20) returned to Klim_89
Klim_89 collected $2.47 from pot
Klim_89: doesn't show hand 
*** SUMMARY ***
Total pot $2.47 | Rake $0 
Seat 1: togl63amg folded before Flop (didn't bet)
Seat 2: Simanov.A folded before Flop
Seat 3: ReKych (button) folded before Flop
Seat 4: DDarks (small blind) folded before Flop
Seat 5: Klim_89 (big blind) collected ($2.47)
Seat 6: hali ya hewa folded before Flop (didn't bet)



PokerStars Hand #201508091436:  Hold'em No Limit ($0.05/$0.10 USD) - 2019/06/18 10:36:39 ET
Table 'Moreau III' 6-max Seat #4 is the button
Seat 1: togl63amg ($14.74 in chips) 
Seat 2: Simanov.A ($3.91 in chips) 
Seat 3: ReKych ($10 in chips) 
Seat 4: DDarks ($13.22 in chips) 
Seat 5: Klim_89 ($11.45 in chips) 
Seat 6: hali ya hewa ($12.36 in chips) 
Klim_89: posts small blind $0.05
hali ya hewa: posts big blind $0.10
togl63amg: posts the ante $0.02
Simanov.A: posts the ante $0.02
ReKych: posts the ante $0.02
DDarks: posts the ante $0.02
Klim_89: posts the ante $0.02
hali ya hewa: posts the ante $0.02
*** HOLE CARDS ***
togl63amg: folds 
Simanov.A: folds 
ReKych: folds 
DDarks: folds 
Klim_89: raises $0.12 to $0.22
hali ya hewa: calls $0.12
*** FLOP *** [Qh 7s 2c]
Klim_89: bets $0.20
hali ya hewa: calls $0.20
*** TURN *** [Qh 7s 2c] [8s]
Klim_89: checks 
hali ya hewa: checks 
*** RIVER *** [Qh 7s 2c 8s] [Js]
Klim_89: checks 
hali ya hewa: checks 
*** SHOW DOWN ***
Klim_89: shows [3h 3d] (a pair of Threes)
hali ya hewa: mucks hand 
Klim_89 collected $0.92 from pot
*** SUMMARY ***
Total pot $0.96 | Rake $0.04 
Board [Qh 7s 2c 8s Js]
Seat 1: togl63amg folded before Flop (didn't bet)
Seat 2: Simanov.A folded before Flop (didn't bet)
Seat 3: ReKych folded before Flop (didn't bet)
Seat 4: DDarks (button) folded before Flop (didn't bet)
Seat 5: Klim_89 (small blind) showed [3h 3d] and won ($0.92) with a pair of Threes
Seat 6: hali ya hewa (big blind) mucked



PokerStars Hand #201508101901:  Hold'em No Limit ($0.05/$0.10 USD) - 2019/06/18 10:37:06 ET
Table 'Moreau III' 6-max Seat #5 is the button
Seat 1: togl63amg ($14.72 in chips) 
Seat 2: Simanov.A ($3.89 in chips) 
Seat 3: ReKych ($10 in chips) 
Seat 4: DDarks ($13.20 in chips) 
Seat 5: Klim_89 ($11.93 in chips) 
Seat 6: hali ya hewa ($11.92 in chips) 
hali ya hewa: posts small blind $0.05
togl63amg: posts big blind $0.10
togl63amg: posts the ante $0.02
Simanov.A: posts the ante $0.02
ReKych: posts the ante $0.02
DDarks: posts the ante $0.02
Klim_89: posts the ante $0.02
hali ya hewa: posts the ante $0.02
*** HOLE CARDS ***
Simanov.A: raises $0.20 to $0.30
ReKych: folds 
DDarks: folds 
Klim_89: calls $0.30
hali ya hewa: folds 
togl63amg: raises $1.07 to $1.37
Simanov.A: calls $1.07
Klim_89: calls $1.07
*** FLOP *** [2h 6d Js]
togl63amg: checks 
Simanov.A: checks 
Klim_89: checks 
*** TURN *** [2h 6d Js] [3h]
togl63amg: bets $2.86
Simanov.A: calls $2.50 and is all-in
Klim_89: raises $7.68 to $10.54 and is all-in
togl63amg: calls $7.68
*** RIVER *** [2h 6d Js 3h] [3c]
*** SHOW DOWN ***
togl63amg: shows [Ad Ac] (two pair, Aces and Threes)
Klim_89: shows [6h 6s] (a full house, Sixes full of Threes)
Klim_89 collected $15.36 from side pot
Simanov.A: shows [Kd Jh] (two pair, Jacks and Threes)
Klim_89 collected $11.25 from main pot
*** SUMMARY ***
Total pot $27.86 Main pot $11.25. Side pot $15.36. | Rake $1.25 
Board [2h 6d Js 3h 3c]
Seat 1: togl63amg (big blind) showed [Ad Ac] and lost with two pair, Aces and Threes
Seat 2: Simanov.A showed [Kd Jh] and lost with two pair, Jacks and Threes
Seat 3: ReKych folded before Flop (didn't bet)
Seat 4: DDarks folded before Flop (didn't bet)
Seat 5: Klim_89 (button) showed [6h 6s] and won ($26.61) with a full house, Sixes full of Threes
Seat 6: hali ya hewa (small blind) folded before Flop



PokerStars Hand #201508132704:  Hold'em No Limit ($0.05/$0.10 USD) - 2019/06/18 10:38:25 ET
Table 'Moreau III' 6-max Seat #6 is the button
Seat 1: togl63amg ($10 in chips) 
Seat 3: ReKych ($10 in chips) 
Seat 4: DDarks ($13.18 in chips) 
Seat 5: Klim_89 ($26.61 in chips) 
Seat 6: hali ya hewa ($11.85 in chips) 
togl63amg: posts small blind $0.05
ReKych: posts big blind $0.10
togl63amg: posts the ante $0.02
ReKych: posts the ante $0.02
DDarks: posts the ante $0.02
Klim_89: posts the ante $0.02
hali ya hewa: posts the ante $0.02
*** HOLE CARDS ***
DDarks: calls $0.10
Klim_89: folds 
Simanov.A leaves the table
hali ya hewa: raises $0.45 to $0.55
togl63amg: folds 
ReKych: calls $0.45
DDarks: calls $0.45
*** FLOP *** [3s Ac 5h]
ReKych: checks 
DDarks: checks 
hali ya hewa: bets $0.90
ReKych: folds 
DDarks: folds 
Uncalled bet ($0.90) returned to hali ya hewa
Heisenber699 joins the table at seat #2 
hali ya hewa collected $1.72 from pot
hali ya hewa: doesn't show hand 
*** SUMMARY ***
Total pot $1.80 | Rake $0.08 
Board [3s Ac 5h]
Seat 1: togl63amg (small blind) folded before Flop
Seat 3: ReKych (big blind) folded on the Flop
Seat 4: DDarks folded on the Flop
Seat 5: Klim_89 folded before Flop (didn't bet)
Seat 6: hali ya hewa (button) collected ($1.72)



PokerStars Hand #201508148457:  Hold'em No Limit ($0.05/$0.10 USD) - 2019/06/18 10:39:06 ET
Table 'Moreau III' 6-max Seat #1 is the button
Seat 1: togl63amg ($10 in chips) 
Seat 3: ReKych ($10 in chips) 
Seat 4: DDarks ($12.61 in chips) 
Seat 5: Klim_89 ($26.59 in chips) 
Seat 6: hali ya hewa ($13 in chips) 
ReKych: posts small blind $0.05
DDarks: posts big blind $0.10
togl63amg: posts the ante $0.02
ReKych: posts the ante $0.02
DDarks: posts the ante $0.02
Klim_89: posts the ante $0.02
hali ya hewa: posts the ante $0.02
*** HOLE CARDS ***
Klim_89: folds 
hali ya hewa: folds 
togl63amg: folds 
ReKych: raises $0.20 to $0.30
Heisenber699 leaves the table
DDarks: calls $0.20
*** FLOP *** [7s Tc 5h]
ReKych: bets $0.22
DDarks: calls $0.22
*** TURN *** [7s Tc 5h] [2h]
ReKych: checks 
DDarks: checks 
*** RIVER *** [7s Tc 5h 2h] [Jh]
ReKych: checks 
DDarks: bets $1
ReKych: folds 
Uncalled bet ($1) returned to DDarks
DDarks collected $1.09 from pot
DDarks: doesn't show hand 
*** SUMMARY ***
Total pot $1.14 | Rake $0.05 
Board [7s Tc 5h 2h Jh]
Seat 1: togl63amg (button) folded before Flop (didn't bet)
Seat 3: ReKych (small blind) folded on the River
Seat 4: DDarks (big blind) collected ($1.09)
Seat 5: Klim_89 folded before Flop (didn't bet)
Seat 6: hali ya hewa folded before Flop (didn't bet)



PokerStars Hand #201508169956:  Hold'em No Limit ($0.05/$0.10 USD) - 2019/06/18 10:40:01 ET
Table 'Moreau III' 6-max Seat #3 is the button
Seat 1: togl63amg ($10 in chips) 
Seat 3: ReKych ($10 in chips) 
Seat 4: DDarks ($13.16 in chips) 
Seat 6: hali ya hewa ($12.98 in chips) 
DDarks: posts small blind $0.05
Klim_89: is sitting out 
Klim_89 leaves the table
hali ya hewa: posts big blind $0.10
togl63amg: posts the ante $0.02
ReKych: posts the ante $0.02
DDarks: posts the ante $0.02
hali ya hewa: posts the ante $0.02
*** HOLE CARDS ***
togl63amg: folds 
ReKych: raises $0.20 to $0.30
DDarks: folds 
Paker 3 joins the table at seat #5 
hali ya hewa: raises $0.80 to $1.10
ReKych: folds 
Uncalled bet ($0.80) returned to hali ya hewa
hali ya hewa collected $0.73 from pot
hali ya hewa: doesn't show hand 
*** SUMMARY ***
Total pot $0.73 | Rake $0 
Seat 1: togl63amg folded before Flop (didn't bet)
Seat 3: ReKych (button) folded before Flop
Seat 4: DDarks (small blind) folded before Flop
Seat 6: hali ya hewa (big blind) collected ($0.73)



PokerStars Hand #201508188018:  Hold'em No Limit ($0.05/$0.10 USD) - 2019/06/18 10:40:47 ET
Table 'Moreau III' 6-max Seat #4 is the button
Seat 1: togl63amg ($10 in chips) 
Seat 3: ReKych ($10 in chips) 
Seat 4: DDarks ($13.09 in chips) 
Seat 6: hali ya hewa ($13.39 in chips) 
hali ya hewa: posts small blind $0.05
togl63amg: posts big blind $0.10
togl63amg: posts the ante $0.02
ReKych: posts the ante $0.02
DDarks: posts the ante $0.02
hali ya hewa: posts the ante $0.02
*** HOLE CARDS ***
ReKych: folds 
DDarks: folds 
hali ya hewa: folds 
Uncalled bet ($0.05) returned to togl63amg
togl63amg collected $0.18 from pot
*** SUMMARY ***
Total pot $0.18 | Rake $0 
Seat 1: togl63amg (big blind) collected ($0.18)
Seat 3: ReKych folded before Flop (didn't bet)
Seat 4: DDarks (button) folded before Flop (didn't bet)
Seat 6: hali ya hewa (small blind) folded before Flop



PokerStars Hand #201508192714:  Hold'em No Limit ($0.05/$0.10 USD) - 2019/06/18 10:40:59 ET
Table 'Moreau III' 6-max Seat #6 is the button
Seat 1: togl63amg ($10.11 in chips) 
Seat 3: ReKych ($10 in chips) 
Seat 4: DDarks ($13.07 in chips) 
Seat 6: hali ya hewa ($13.32 in chips) 
togl63amg: posts small blind $0.05
ReKych: posts big blind $0.10
Paker 3: sits out 
togl63amg: posts the ante $0.02
ReKych: posts the ante $0.02
DDarks: posts the ante $0.02
hali ya hewa: posts the ante $0.02
*** HOLE CARDS ***
DDarks: calls $0.10
hali ya hewa: raises $0.30 to $0.40
togl63amg: folds 
ReKych: folds 
DDarks: folds 
Uncalled bet ($0.30) returned to hali ya hewa
hali ya hewa collected $0.43 from pot
hali ya hewa: doesn't show hand 
*** SUMMARY ***
Total pot $0.43 | Rake $0 
Seat 1: togl63amg (small blind) folded before Flop
Seat 3: ReKych (big blind) folded before Flop
Seat 4: DDarks folded before Flop
Seat 6: hali ya hewa (button) collected ($0.43)



PokerStars Hand #201508204450:  Hold'em No Limit ($0.05/$0.10 USD) - 2019/06/18 10:41:29 ET
Table 'Moreau III' 6-max Seat #1 is the button
Seat 1: togl63amg ($10.04 in chips) 
Seat 3: ReKych ($10 in chips) 
Seat 4: DDarks ($12.95 in chips) 
Seat 6: hali ya hewa ($13.63 in chips) 
ReKych: posts small blind $0.05
DDarks: posts big blind $0.10
Paker 3: sits out 
togl63amg: posts the ante $0.02
ReKych: posts the ante $0.02
DDarks: posts the ante $0.02
hali ya hewa: posts the ante $0.02
*** HOLE CARDS ***
hali ya hewa: folds 
togl63amg: raises $0.20 to $0.30
ReKych: folds 
DDarks: raises $0.20 to $0.50
togl63amg: calls $0.20
*** FLOP *** [4d Qh Jd]
DDarks: bets $1
togl63amg: folds 
Uncalled bet ($1) returned to DDarks
DDarks collected $1.08 from pot
DDarks: doesn't show hand 
*** SUMMARY ***
Total pot $1.13 | Rake $0.05 
Board [4d Qh Jd]
Seat 1: togl63amg (button) folded on the Flop
Seat 3: ReKych (small blind) folded before Flop
Seat 4: DDarks (big blind) collected ($1.08)
Seat 6: hali ya hewa folded before Flop (didn't bet)



PokerStars Hand #201508214722:  Hold'em No Limit ($0.05/$0.10 USD) - 2019/06/18 10:41:56 ET
Table 'Moreau III' 6-max Seat #3 is the button
Seat 1: togl63amg ($10 in chips) 
Seat 3: ReKych ($10 in chips) 
Seat 4: DDarks ($13.51 in chips) 
Seat 5: Paker 3 ($10 in chips) 
Seat 6: hali ya hewa ($13.61 in chips) 
DDarks: posts small blind $0.05
Paker 3: posts big blind $0.10
togl63amg: posts the ante $0.02
ReKych: posts the ante $0.02
DDarks: posts the ante $0.02
Paker 3: posts the ante $0.02
hali ya hewa: posts the ante $0.02
*** HOLE CARDS ***
hali ya hewa: folds 
togl63amg: folds 
mrAngryPanda joins the table at seat #2 
ReKych: folds 
DDarks: folds 
Uncalled bet ($0.05) returned to Paker 3
Paker 3 collected $0.20 from pot
*** SUMMARY ***
Total pot $0.20 | Rake $0 
Seat 1: togl63amg folded before Flop (didn't bet)
Seat 3: ReKych (button) folded before Flop (didn't bet)
Seat 4: DDarks (small blind) folded before Flop
Seat 5: Paker 3 (big blind) collected ($0.20)
Seat 6: hali ya hewa folded before Flop (didn't bet)



PokerStars Hand #201508219687:  Hold'em No Limit ($0.05/$0.10 USD) - 2019/06/18 10:42:09 ET
Table 'Moreau III' 6-max Seat #4 is the button
Seat 1: togl63amg ($10 in chips) 
Seat 3: ReKych ($10 in chips) 
Seat 4: DDarks ($13.44 in chips) 
Seat 5: Paker 3 ($10.13 in chips) 
Seat 6: hali ya hewa ($13.59 in chips) 
Paker 3: posts small blind $0.05
hali ya hewa: posts big blind $0.10
mrAngryPanda: sits out 
togl63amg: posts the ante $0.02
ReKych: posts the ante $0.02
DDarks: posts the ante $0.02
Paker 3: posts the ante $0.02
hali ya hewa: posts the ante $0.02
*** HOLE CARDS ***
togl63amg: folds 
ReKych: raises $0.25 to $0.35
DDarks: folds 
mrAngryPanda leaves the table
Paker 3: calls $0.30
hali ya hewa: folds 
*** FLOP *** [5h Ah 5c]
Paker 3: bets $0.43
ReKych: calls $0.43
*** TURN *** [5h Ah 5c] [6s]
Paker 3: bets $4.40
ReKych: raises $4.80 to $9.20 and is all-in
Paker 3: calls $4.80
*** RIVER *** [5h Ah 5c 6s] [8d]
*** SHOW DOWN ***
Paker 3: shows [As 8s] (two pair, Aces and Eights)
ReKych: shows [Ks Ad] (two pair, Aces and Fives)
Paker 3 collected $19.25 from pot
*** SUMMARY ***
Total pot $20.16 | Rake $0.91 
Board [5h Ah 5c 6s 8d]
Seat 1: togl63amg folded before Flop (didn't bet)
Seat 3: ReKych showed [Ks Ad] and lost with two pair, Aces and Fives
Seat 4: DDarks (button) folded before Flop (didn't bet)
Seat 5: Paker 3 (small blind) showed [As 8s] and won ($19.25) with two pair, Aces and Eights
Seat 6: hali ya hewa (big blind) folded before Flop



PokerStars Hand #201508247384:  Hold'em No Limit ($0.05/$0.10 USD) - 2019/06/18 10:43:19 ET
Table 'Moreau III' 6-max Seat #5 is the button
Seat 1: togl63amg ($10 in chips) 
Seat 3: ReKych ($10 in chips) 
Seat 4: DDarks ($13.42 in chips) 
Seat 5: Paker 3 ($19.38 in chips) 
Seat 6: hali ya hewa ($13.47 in chips) 
hali ya hewa: posts small blind $0.05
togl63amg: posts big blind $0.10
togl63amg: posts the ante $0.02
ReKych: posts the ante $0.02
DDarks: posts the ante $0.02
Paker 3: posts the ante $0.02
hali ya hewa: posts the ante $0.02
*** HOLE CARDS ***
ReKych: raises $0.20 to $0.30
DDarks: calls $0.30
Paker 3: folds 
hali ya hewa: folds 
togl63amg: folds 
*** FLOP *** [6s 8h Kh]
ReKych: checks 
DDarks: checks 
*** TURN *** [6s 8h Kh] [4s]
ReKych: checks 
DDarks: checks 
*** RIVER *** [6s 8h Kh 4s] [As]
ReKych: checks 
DDarks: bets $0.30
ReKych: folds 
Uncalled bet ($0.30) returned to DDarks
DDarks collected $0.81 from pot
DDarks: doesn't show hand 
*** SUMMARY ***
Total pot $0.85 | Rake $0.04 
Board [6s 8h Kh 4s As]
Seat 1: togl63amg (big blind) folded before Flop
Seat 3: ReKych folded on the River
Seat 4: DDarks collected ($0.81)
Seat 5: Paker 3 (button) folded before Flop (didn't bet)
Seat 6: hali ya hewa (small blind) folded before Flop



PokerStars Hand #201508264483:  Hold'em No Limit ($0.05/$0.10 USD) - 2019/06/18 10:44:02 ET
Table 'Moreau III' 6-max Seat #6 is the button
Seat 1: togl63amg ($10 in chips) 
Seat 3: ReKych ($10 in chips) 
Seat 4: DDarks ($13.91 in chips) 
Seat 5: Paker 3 ($19.36 in chips) 
Seat 6: hali ya hewa ($13.40 in chips) 
togl63amg: posts small blind $0.05
ReKych: posts big blind $0.10
togl63amg: posts the ante $0.02
ReKych: posts the ante $0.02
DDarks: posts the ante $0.02
Paker 3: posts the ante $0.02
hali ya hewa: posts the ante $0.02
*** HOLE CARDS ***
DDarks: raises $0.10 to $0.20
Paker 3: raises $1.30 to $1.50
hali ya hewa: folds 
togl63amg: folds 
ReKych: folds 
DDarks: folds 
Uncalled bet ($1.30) returned to Paker 3
Paker 3 collected $0.65 from pot
*** SUMMARY ***
Total pot $0.65 | Rake $0 
Seat 1: togl63amg (small blind) folded before Flop
Seat 3: ReKych (big blind) folded before Flop
Seat 4: DDarks folded before Flop
Seat 5: Paker 3 collected ($0.65)
Seat 6: hali ya hewa (button) folded before Flop (didn't bet)



PokerStars Hand #201508273702:  Hold'em No Limit ($0.05/$0.10 USD) - 2019/06/18 10:44:26 ET
Table 'Moreau III' 6-max Seat #1 is the button
Seat 1: togl63amg ($10 in chips) 
Seat 3: ReKych ($10 in chips) 
Seat 4: DDarks ($13.69 in chips) 
Seat 5: Paker 3 ($19.79 in chips) 
Seat 6: hali ya hewa ($13.38 in chips) 
ReKych: posts small blind $0.05
DDarks: posts big blind $0.10
togl63amg: posts the ante $0.02
ReKych: posts the ante $0.02
DDarks: posts the ante $0.02
Paker 3: posts the ante $0.02
hali ya hewa: posts the ante $0.02
*** HOLE CARDS ***
Paker 3: calls $0.10
hali ya hewa: raises $0.30 to $0.40
togl63amg: folds 
ReKych: folds 
DDarks: calls $0.30
Paker 3: calls $0.30
*** FLOP *** [2s Ks Ts]
DDarks: bets $1
Paker 3: folds 
hali ya hewa: folds 
Uncalled bet ($1) returned to DDarks
DDarks collected $1.29 from pot
DDarks: doesn't show hand 
*** SUMMARY ***
Total pot $1.35 | Rake $0.06 
Board [2s Ks Ts]
Seat 1: togl63amg (button) folded before Flop (didn't bet)
Seat 3: ReKych (small blind) folded before Flop
Seat 4: DDarks (big blind) collected ($1.29)
Seat 5: Paker 3 folded on the Flop
Seat 6: hali ya hewa folded on the Flop



PokerStars Hand #201508284897:  Hold'em No Limit ($0.05/$0.10 USD) - 2019/06/18 10:44:54 ET
Table 'Moreau III' 6-max Seat #3 is the button
Seat 1: togl63amg ($10 in chips) 
Seat 3: ReKych ($10 in chips) 
Seat 4: DDarks ($14.56 in chips) 
Seat 5: Paker 3 ($19.37 in chips) 
Seat 6: hali ya hewa ($12.96 in chips) 
DDarks: posts small blind $0.05
Paker 3: posts big blind $0.10
togl63amg: posts the ante $0.02
ReKych: posts the ante $0.02
DDarks: posts the ante $0.02
Paker 3: posts the ante $0.02
hali ya hewa: posts the ante $0.02
*** HOLE CARDS ***
hali ya hewa: folds 
togl63amg: folds 
ReKych: folds 
DDarks: raises $0.10 to $0.20
Paker 3: calls $0.10
*** FLOP *** [Th 4c 7d]
DDarks: bets $0.30
Paker 3: raises $0.30 to $0.60
DDarks: calls $0.30
*** TURN *** [Th 4c 7d] [Jc]
DDarks: checks 
hali ya hewa leaves the table
Paker 3: bets $2.10
DDarks: folds 
Uncalled bet ($2.10) returned to Paker 3
Paker 3 collected $1.62 from pot
*** SUMMARY ***
Total pot $1.70 | Rake $0.08 
Board [Th 4c 7d Jc]
Seat 1: togl63amg folded before Flop (didn't bet)
Seat 3: ReKych (button) folded before Flop (didn't bet)
Seat 4: DDarks (small blind) folded on the Turn
Seat 5: Paker 3 (big blind) collected ($1.62)
Seat 6: hali ya hewa folded before Flop (didn't bet)



PokerStars Hand #201508302319:  Hold'em No Limit ($0.05/$0.10 USD) - 2019/06/18 10:45:39 ET
Table 'Moreau III' 6-max Seat #4 is the button
Seat 1: togl63amg ($10 in chips) 
Seat 3: ReKych ($10 in chips) 
Seat 4: DDarks ($13.74 in chips) 
Seat 5: Paker 3 ($20.17 in chips) 
Paker 3: posts small blind $0.05
togl63amg: posts big blind $0.10
togl63amg: posts the ante $0.02
ReKych: posts the ante $0.02
DDarks: posts the ante $0.02
Paker 3: posts the ante $0.02
*** HOLE CARDS ***
ReKych: raises $0.25 to $0.35
DDarks: calls $0.35
Paker 3: folds 
lillelars888 joins the table at seat #2 
togl63amg: raises $1.25 to $1.60
ReKych: folds 
DDarks: folds 
Uncalled bet ($1.25) returned to togl63amg
togl63amg collected $1.18 from pot
*** SUMMARY ***
Total pot $1.18 | Rake $0 
Seat 1: togl63amg (big blind) collected ($1.18)
Seat 3: ReKych folded before Flop
Seat 4: DDarks (button) folded before Flop
Seat 5: Paker 3 (small blind) folded before Flop



PokerStars Hand #201508318063:  Hold'em No Limit ($0.05/$0.10 USD) - 2019/06/18 10:46:11 ET
Table 'Moreau III' 6-max Seat #5 is the button
Seat 1: togl63amg ($10.81 in chips) 
Seat 2: lillelars888 ($10 in chips) 
Seat 3: ReKych ($10 in chips) 
Seat 4: DDarks ($13.37 in chips) 
Seat 5: Paker 3 ($20.10 in chips) 
togl63amg: posts small blind $0.05
lillelars888: posts big blind $0.10
togl63amg: posts the ante $0.02
lillelars888: posts the ante $0.02
ReKych: posts the ante $0.02
DDarks: posts the ante $0.02
Paker 3: posts the ante $0.02
*** HOLE CARDS ***
ReKych: raises $0.25 to $0.35
DDarks: calls $0.35
Paker 3: folds 
togl63amg: folds 
lillelars888: folds 
*** FLOP *** [2h Qh Ts]
ReKych: bets $0.55
DDarks: calls $0.55
*** TURN *** [2h Qh Ts] [As]
ReKych: bets $1.40
DDarks: folds 
Uncalled bet ($1.40) returned to ReKych
ReKych collected $1.96 from pot
ReKych: doesn't show hand 
*** SUMMARY ***
Total pot $2.05 | Rake $0.09 
Board [2h Qh Ts As]
Seat 1: togl63amg (small blind) folded before Flop
Seat 2: lillelars888 (big blind) folded before Flop
Seat 3: ReKych collected ($1.96)
Seat 4: DDarks folded on the Turn
Seat 5: Paker 3 (button) folded before Flop (didn't bet)



PokerStars Hand #201508332485:  Hold'em No Limit ($0.05/$0.10 USD) - 2019/06/18 10:46:47 ET
Table 'Moreau III' 6-max Seat #1 is the button
Seat 1: togl63amg ($10.74 in chips) 
Seat 2: lillelars888 ($9.88 in chips) 
Seat 3: ReKych ($11.04 in chips) 
Seat 4: DDarks ($12.45 in chips) 
Seat 5: Paker 3 ($20.08 in chips) 
lillelars888: posts small blind $0.05
ReKych: posts big blind $0.10
togl63amg: posts the ante $0.02
lillelars888: posts the ante $0.02
ReKych: posts the ante $0.02
DDarks: posts the ante $0.02
Paker 3: posts the ante $0.02
*** HOLE CARDS ***
DDarks: folds 
Paker 3: folds 
togl63amg: raises $0.20 to $0.30
lillelars888: calls $0.25
ReKych: folds 
*** FLOP *** [9h Qh 3d]
lillelars888: checks 
togl63amg: checks 
*** TURN *** [9h Qh 3d] [6c]
lillelars888: checks 
togl63amg: checks 
*** RIVER *** [9h Qh 3d 6c] [Th]
lillelars888: bets $0.38
togl63amg: folds 
Uncalled bet ($0.38) returned to lillelars888
lillelars888 collected $0.76 from pot
lillelars888: doesn't show hand 
*** SUMMARY ***
Total pot $0.80 | Rake $0.04 
Board [9h Qh 3d 6c Th]
Seat 1: togl63amg (button) folded on the River
Seat 2: lillelars888 (small blind) collected ($0.76)
Seat 3: ReKych (big blind) folded before Flop
Seat 4: DDarks folded before Flop (didn't bet)
Seat 5: Paker 3 folded before Flop (didn't bet)



PokerStars Hand #201508346469:  Hold'em No Limit ($0.05/$0.10 USD) - 2019/06/18 10:47:23 ET
Table 'Moreau III' 6-max Seat #2 is the button
Seat 1: togl63amg ($10.42 in chips) 
Seat 2: lillelars888 ($10.32 in chips) 
Seat 3: ReKych ($10.92 in chips) 
Seat 4: DDarks ($12.43 in chips) 
Seat 5: Paker 3 ($20.06 in chips) 
ReKych: posts small blind $0.05
DDarks: posts big blind $0.10
togl63amg: posts the ante $0.02
lillelars888: posts the ante $0.02
ReKych: posts the ante $0.02
DDarks: posts the ante $0.02
Paker 3: posts the ante $0.02
*** HOLE CARDS ***
Paker 3: calls $0.10
togl63amg: raises $0.45 to $0.55
lillelars888: folds 
ReKych: folds 
DDarks: folds 
Paker 3: raises $0.45 to $1
togl63amg: calls $0.45
*** FLOP *** [3d Ad 6h]
Paker 3: bets $0.60
togl63amg: folds 
Uncalled bet ($0.60) returned to Paker 3
Paker 3 collected $2.15 from pot
*** SUMMARY ***
Total pot $2.25 | Rake $0.10 
Board [3d Ad 6h]
Seat 1: togl63amg folded on the Flop
Seat 2: lillelars888 (button) folded before Flop (didn't bet)
Seat 3: ReKych (small blind) folded before Flop
Seat 4: DDarks (big blind) folded before Flop
Seat 5: Paker 3 collected ($2.15)



PokerStars Hand #201508361364:  Hold'em No Limit ($0.05/$0.10 USD) - 2019/06/18 10:48:00 ET
Table 'Moreau III' 6-max Seat #3 is the button
Seat 1: togl63amg ($10 in chips) 
Seat 2: lillelars888 ($10.30 in chips) 
Seat 3: ReKych ($10.85 in chips) 
Seat 4: DDarks ($12.31 in chips) 
Seat 5: Paker 3 ($21.19 in chips) 
DDarks: posts small blind $0.05
Paker 3: posts big blind $0.10
togl63amg: posts the ante $0.02
lillelars888: posts the ante $0.02
ReKych: posts the ante $0.02
DDarks: posts the ante $0.02
Paker 3: posts the ante $0.02
*** HOLE CARDS ***
togl63amg: folds 
lillelars888: calls $0.10
ReKych: raises $0.40 to $0.50
DDarks: folds 
Paker 3: folds 
lillelars888: calls $0.40
*** FLOP *** [5d 2c Js]
lillelars888: checks 
ReKych: bets $0.40
lillelars888: folds 
Uncalled bet ($0.40) returned to ReKych
ReKych collected $1.19 from pot
ReKych: doesn't show hand 
*** SUMMARY ***
Total pot $1.25 | Rake $0.06 
Board [5d 2c Js]
Seat 1: togl63amg folded before Flop (didn't bet)
Seat 2: lillelars888 folded on the Flop
Seat 3: ReKych (button) collected ($1.19)
Seat 4: DDarks (small blind) folded before Flop
Seat 5: Paker 3 (big blind) folded before Flop



PokerStars Hand #201508375436:  Hold'em No Limit ($0.05/$0.10 USD) - 2019/06/18 10:48:36 ET
Table 'Moreau III' 6-max Seat #4 is the button
Seat 1: togl63amg ($10 in chips) 
Seat 2: lillelars888 ($9.78 in chips) 
Seat 3: ReKych ($11.52 in chips) 
Seat 4: DDarks ($12.24 in chips) 
Seat 5: Paker 3 ($21.07 in chips) 
Paker 3: posts small blind $0.05
togl63amg: posts big blind $0.10
togl63amg: posts the ante $0.02
lillelars888: posts the ante $0.02
ReKych: posts the ante $0.02
DDarks: posts the ante $0.02
Paker 3: posts the ante $0.02
*** HOLE CARDS ***
lillelars888: folds 
ReKych: raises $0.20 to $0.30
DDarks: folds 
Paker 3: folds 
togl63amg: folds 
Uncalled bet ($0.20) returned to ReKych
ReKych collected $0.35 from pot
ReKych: doesn't show hand 
*** SUMMARY ***
Total pot $0.35 | Rake $0 
Seat 1: togl63amg (big blind) folded before Flop
Seat 2: lillelars888 folded before Flop (didn't bet)
Seat 3: ReKych collected ($0.35)
Seat 4: DDarks (button) folded before Flop (didn't bet)
Seat 5: Paker 3 (small blind) folded before Flop



PokerStars Hand #201508381664:  Hold'em No Limit ($0.05/$0.10 USD) - 2019/06/18 10:48:51 ET
Table 'Moreau III' 6-max Seat #5 is the button
Seat 1: togl63amg ($10 in chips) 
Seat 2: lillelars888 ($9.76 in chips) 
Seat 3: ReKych ($11.75 in chips) 
Seat 4: DDarks ($12.22 in chips) 
Seat 5: Paker 3 ($21 in chips) 
togl63amg: posts small blind $0.05
lillelars888: posts big blind $0.10
togl63amg: posts the ante $0.02
lillelars888: posts the ante $0.02
ReKych: posts the ante $0.02
DDarks: posts the ante $0.02
Paker 3: posts the ante $0.02
*** HOLE CARDS ***
ReKych: folds 
DDarks: calls $0.10
Paker 3: folds 
togl63amg: folds 
lillelars888: checks 
*** FLOP *** [2s Qs Js]
lillelars888: checks 
DDarks: checks 
*** TURN *** [2s Qs Js] [Td]
lillelars888: checks 
DDarks: checks 
*** RIVER *** [2s Qs Js Td] [Qd]
lillelars888: checks 
DDarks: checks 
*** SHOW DOWN ***
lillelars888: shows [7h Kh] (a pair of Queens)
DDarks: mucks hand 
lillelars888 collected $0.33 from pot
*** SUMMARY ***
Total pot $0.35 | Rake $0.02 
Board [2s Qs Js Td Qd]
Seat 1: togl63amg (small blind) folded before Flop
Seat 2: lillelars888 (big blind) showed [7h Kh] and won ($0.33) with a pair of Queens
Seat 3: ReKych folded before Flop (didn't bet)
Seat 4: DDarks mucked
Seat 5: Paker 3 (button) folded before Flop (didn't bet)



PokerStars Hand #201508393428:  Hold'em No Limit ($0.05/$0.10 USD) - 2019/06/18 10:49:21 ET
Table 'Moreau III' 6-max Seat #1 is the button
Seat 1: togl63amg ($10 in chips) 
Seat 2: lillelars888 ($9.97 in chips) 
Seat 3: ReKych ($11.73 in chips) 
Seat 4: DDarks ($12.10 in chips) 
Seat 5: Paker 3 ($20.98 in chips) 
lillelars888: posts small blind $0.05
ReKych: posts big blind $0.10
togl63amg: posts the ante $0.02
lillelars888: posts the ante $0.02
ReKych: posts the ante $0.02
DDarks: posts the ante $0.02
Paker 3: posts the ante $0.02
*** HOLE CARDS ***
DDarks: raises $0.40 to $0.50
Paker 3: folds 
togl63amg: folds 
lillelars888: folds 
ReKych: folds 
Uncalled bet ($0.40) returned to DDarks
DDarks collected $0.35 from pot
DDarks: doesn't show hand 
*** SUMMARY ***
Total pot $0.35 | Rake $0 
Seat 1: togl63amg (button) folded before Flop (didn't bet)
Seat 2: lillelars888 (small blind) folded before Flop
Seat 3: ReKych (big blind) folded before Flop
Seat 4: DDarks collected ($0.35)
Seat 5: Paker 3 folded before Flop (didn't bet)



PokerStars Hand #201508399429:  Hold'em No Limit ($0.05/$0.10 USD) - 2019/06/18 10:49:36 ET
Table 'Moreau III' 6-max Seat #2 is the button
Seat 1: togl63amg ($10 in chips) 
Seat 2: lillelars888 ($9.90 in chips) 
Seat 3: ReKych ($11.61 in chips) 
Seat 4: DDarks ($12.33 in chips) 
Seat 5: Paker 3 ($20.96 in chips) 
ReKych: posts small blind $0.05
DDarks: posts big blind $0.10
togl63amg: posts the ante $0.02
lillelars888: posts the ante $0.02
ReKych: posts the ante $0.02
DDarks: posts the ante $0.02
Paker 3: posts the ante $0.02
*** HOLE CARDS ***
Paker 3: folds 
togl63amg: raises $0.20 to $0.30
lillelars888: folds 
ReKych: folds 
DDarks: calls $0.20
*** FLOP *** [Qh 8h Td]
DDarks: bets $0.50
togl63amg: folds 
Uncalled bet ($0.50) returned to DDarks
DDarks collected $0.72 from pot
DDarks: doesn't show hand 
*** SUMMARY ***
Total pot $0.75 | Rake $0.03 
Board [Qh 8h Td]
Seat 1: togl63amg folded on the Flop
Seat 2: lillelars888 (button) folded before Flop (didn't bet)
Seat 3: ReKych (small blind) folded before Flop
Seat 4: DDarks (big blind) collected ($0.72)
Seat 5: Paker 3 folded before Flop (didn't bet)



PokerStars Hand #201508407125:  Hold'em No Limit ($0.05/$0.10 USD) - 2019/06/18 10:49:55 ET
Table 'Moreau III' 6-max Seat #3 is the button
Seat 1: togl63amg ($10 in chips) 
Seat 2: lillelars888 ($9.88 in chips) 
Seat 3: ReKych ($11.54 in chips) 
Seat 4: DDarks ($12.73 in chips) 
Seat 5: Paker 3 ($20.94 in chips) 
DDarks: posts small blind $0.05
Paker 3: posts big blind $0.10
togl63amg: posts the ante $0.02
lillelars888: posts the ante $0.02
ReKych: posts the ante $0.02
DDarks: posts the ante $0.02
Paker 3: posts the ante $0.02
*** HOLE CARDS ***
togl63amg: folds 
lillelars888: folds 
ReKych: raises $0.20 to $0.30
DDarks: calls $0.25
Paker 3: folds 
*** FLOP *** [3s Js 9c]
DDarks: checks 
ReKych: bets $0.30
DDarks: folds 
Uncalled bet ($0.30) returned to ReKych
ReKych collected $0.76 from pot
ReKych: doesn't show hand 
*** SUMMARY ***
Total pot $0.80 | Rake $0.04 
Board [3s Js 9c]
Seat 1: togl63amg folded before Flop (didn't bet)
Seat 2: lillelars888 folded before Flop (didn't bet)
Seat 3: ReKych (button) collected ($0.76)
Seat 4: DDarks (small blind) folded on the Flop
Seat 5: Paker 3 (big blind) folded before Flop



PokerStars Hand #201508420037:  Hold'em No Limit ($0.05/$0.10 USD) - 2019/06/18 10:50:29 ET
Table 'Moreau III' 6-max Seat #4 is the button
Seat 1: togl63amg ($10 in chips) 
Seat 2: lillelars888 ($9.86 in chips) 
Seat 3: ReKych ($11.98 in chips) 
Seat 4: DDarks ($12.41 in chips) 
Seat 5: Paker 3 ($20.82 in chips) 
Paker 3: posts small blind $0.05
togl63amg: posts big blind $0.10
togl63amg: posts the ante $0.02
lillelars888: posts the ante $0.02
ReKych: posts the ante $0.02
DDarks: posts the ante $0.02
Paker 3: posts the ante $0.02
*** HOLE CARDS ***
lillelars888: folds 
ReKych: folds 
DDarks: folds 
Paker 3: raises $0.19 to $0.29
togl63amg: calls $0.19
*** FLOP *** [7d Kh 6s]
Paker 3: checks 
togl63amg: bets $0.26
Paker 3: calls $0.26
*** TURN *** [7d Kh 6s] [9s]
Paker 3: checks 
togl63amg: bets $0.81
Paker 3: raises $0.81 to $1.62
togl63amg: calls $0.81
*** RIVER *** [7d Kh 6s 9s] [2d]
Paker 3: bets $1.10
togl63amg: folds 
Uncalled bet ($1.10) returned to Paker 3
Paker 3 collected $4.24 from pot
*** SUMMARY ***
Total pot $4.44 | Rake $0.20 
Board [7d Kh 6s 9s 2d]
Seat 1: togl63amg (big blind) folded on the River
Seat 2: lillelars888 folded before Flop (didn't bet)
Seat 3: ReKych folded before Flop (didn't bet)
Seat 4: DDarks (button) folded before Flop (didn't bet)
Seat 5: Paker 3 (small blind) collected ($4.24)



PokerStars Hand #201508446376:  Hold'em No Limit ($0.05/$0.10 USD) - 2019/06/18 10:51:35 ET
Table 'Moreau III' 6-max Seat #5 is the button
Seat 1: togl63amg ($10 in chips) 
Seat 2: lillelars888 ($9.84 in chips) 
Seat 3: ReKych ($11.96 in chips) 
Seat 4: DDarks ($12.39 in chips) 
Seat 5: Paker 3 ($22.87 in chips) 
togl63amg: posts small blind $0.05
lillelars888: posts big blind $0.10
togl63amg: posts the ante $0.02
lillelars888: posts the ante $0.02
ReKych: posts the ante $0.02
DDarks: posts the ante $0.02
Paker 3: posts the ante $0.02
*** HOLE CARDS ***
ReKych: folds 
DDarks: raises $0.40 to $0.50
Paker 3: folds 
togl63amg: folds 
lillelars888: folds 
Uncalled bet ($0.40) returned to DDarks
DDarks collected $0.35 from pot
DDarks: doesn't show hand 
*** SUMMARY ***
Total pot $0.35 | Rake $0 
Seat 1: togl63amg (small blind) folded before Flop
Seat 2: lillelars888 (big blind) folded before Flop
Seat 3: ReKych folded before Flop (didn't bet)
Seat 4: DDarks collected ($0.35)
Seat 5: Paker 3 (button) folded before Flop (didn't bet)



PokerStars Hand #201508452981:  Hold'em No Limit ($0.05/$0.10 USD) - 2019/06/18 10:51:52 ET
Table 'Moreau III' 6-max Seat #1 is the button
Seat 1: togl63amg ($10 in chips) 
Seat 2: lillelars888 ($9.72 in chips) 
Seat 3: ReKych ($11.94 in chips) 
Seat 4: DDarks ($12.62 in chips) 
Seat 5: Paker 3 ($22.85 in chips) 
lillelars888: posts small blind $0.05
ReKych: posts big blind $0.10
togl63amg: posts the ante $0.02
lillelars888: posts the ante $0.02
ReKych: posts the ante $0.02
DDarks: posts the ante $0.02
Paker 3: posts the ante $0.02
*** HOLE CARDS ***
DDarks: calls $0.10
Paker 3: folds 
togl63amg: folds 
lillelars888: folds 
ReKych: checks 
*** FLOP *** [7d Jd Qd]
ReKych: checks 
DDarks: bets $0.50
ReKych: folds 
Uncalled bet ($0.50) returned to DDarks
DDarks collected $0.33 from pot
DDarks: doesn't show hand 
*** SUMMARY ***
Total pot $0.35 | Rake $0.02 
Board [7d Jd Qd]
Seat 1: togl63amg (button) folded before Flop (didn't bet)
Seat 2: lillelars888 (small blind) folded before Flop
Seat 3: ReKych (big blind) folded on the Flop
Seat 4: DDarks collected ($0.33)
Seat 5: Paker 3 folded before Flop (didn't bet)



PokerStars Hand #201508470649:  Hold'em No Limit ($0.05/$0.10 USD) - 2019/06/18 10:52:37 ET
Table 'Moreau III' 6-max Seat #2 is the button
Seat 1: togl63amg ($10 in chips) 
Seat 2: lillelars888 ($9.65 in chips) 
Seat 3: ReKych ($11.82 in chips) 
Seat 4: DDarks ($12.83 in chips) 
Seat 5: Paker 3 ($22.83 in chips) 
ReKych: posts small blind $0.05
DDarks: posts big blind $0.10
togl63amg: posts the ante $0.02
lillelars888: posts the ante $0.02
ReKych: posts the ante $0.02
DDarks: posts the ante $0.02
Paker 3: posts the ante $0.02
*** HOLE CARDS ***
Paker 3: folds 
togl63amg: folds 
lillelars888: raises $0.20 to $0.30
ReKych: folds 
DDarks: calls $0.20
*** FLOP *** [8c 3h 3c]
DDarks: checks 
lillelars888: bets $0.40
DDarks: folds 
Uncalled bet ($0.40) returned to lillelars888
lillelars888 collected $0.72 from pot
lillelars888: doesn't show hand 
*** SUMMARY ***
Total pot $0.75 | Rake $0.03 
Board [8c 3h 3c]
Seat 1: togl63amg folded before Flop (didn't bet)
Seat 2: lillelars888 (button) collected ($0.72)
Seat 3: ReKych (small blind) folded before Flop
Seat 4: DDarks (big blind) folded on the Flop
Seat 5: Paker 3 folded before Flop (didn't bet)



PokerStars Hand #201508481844:  Hold'em No Limit ($0.05/$0.10 USD) - 2019/06/18 10:53:05 ET
Table 'Moreau III' 6-max Seat #3 is the button
Seat 1: togl63amg ($10 in chips) 
Seat 2: lillelars888 ($10.05 in chips) 
Seat 3: ReKych ($11.75 in chips) 
Seat 4: DDarks ($12.51 in chips) 
Seat 5: Paker 3 ($22.81 in chips) 
DDarks: posts small blind $0.05
Paker 3: posts big blind $0.10
togl63amg: posts the ante $0.02
lillelars888: posts the ante $0.02
ReKych: posts the ante $0.02
DDarks: posts the ante $0.02
Paker 3: posts the ante $0.02
*** HOLE CARDS ***
togl63amg: folds 
lillelars888: folds 
ReKych: folds 
DDarks: calls $0.05
4Skill joins the table at seat #6 
Paker 3: checks 
*** FLOP *** [4c Tc 8d]
DDarks: checks 
Paker 3: bets $0.12
DDarks: calls $0.12
*** TURN *** [4c Tc 8d] [Qh]
DDarks: checks 
Paker 3: bets $0.12
DDarks: calls $0.12
*** RIVER *** [4c Tc 8d Qh] [Qd]
DDarks: bets $1
Paker 3: folds 
Uncalled bet ($1) returned to DDarks
DDarks collected $0.74 from pot
DDarks: doesn't show hand 
*** SUMMARY ***
Total pot $0.78 | Rake $0.04 
Board [4c Tc 8d Qh Qd]
Seat 1: togl63amg folded before Flop (didn't bet)
Seat 2: lillelars888 folded before Flop (didn't bet)
Seat 3: ReKych (button) folded before Flop (didn't bet)
Seat 4: DDarks (small blind) collected ($0.74)
Seat 5: Paker 3 (big blind) folded on the River



PokerStars Hand #201508503819:  Hold'em No Limit ($0.05/$0.10 USD) - 2019/06/18 10:54:01 ET
Table 'Moreau III' 6-max Seat #4 is the button
Seat 1: togl63amg ($10 in chips) 
Seat 2: lillelars888 ($10.03 in chips) 
Seat 3: ReKych ($11.73 in chips) 
Seat 4: DDarks ($12.89 in chips) 
Seat 5: Paker 3 ($22.45 in chips) 
Seat 6: 4Skill ($10 in chips) 
Paker 3: posts small blind $0.05
4Skill: posts big blind $0.10
togl63amg: posts the ante $0.02
lillelars888: posts the ante $0.02
ReKych: posts the ante $0.02
DDarks: posts the ante $0.02
Paker 3: posts the ante $0.02
4Skill: posts the ante $0.02
*** HOLE CARDS ***
togl63amg: folds 
lillelars888: folds 
ReKych: raises $0.25 to $0.35
DDarks: raises $0.25 to $0.60
Paker 3: calls $0.55
4Skill: folds 
ReKych: calls $0.25
*** FLOP *** [7h Jc 4c]
Paker 3: checks 
ReKych: checks 
DDarks: bets $1
Paker 3: calls $1
ReKych: raises $2.25 to $3.25
DDarks: folds 
Paker 3: calls $2.25
*** TURN *** [7h Jc 4c] [3d]
Paker 3: checks 
ReKych: bets $3
Paker 3: calls $3
*** RIVER *** [7h Jc 4c 3d] [6d]
Paker 3: checks 
ReKych: bets $4.86 and is all-in
Paker 3: calls $4.86
*** SHOW DOWN ***
ReKych: shows [Jh Ac] (a pair of Jacks)
Paker 3: shows [3h 4h] (two pair, Fours and Threes)
Paker 3 collected $24.10 from pot
*** SUMMARY ***
Total pot $25.24 | Rake $1.14 
Board [7h Jc 4c 3d 6d]
Seat 1: togl63amg folded before Flop (didn't bet)
Seat 2: lillelars888 folded before Flop (didn't bet)
Seat 3: ReKych showed [Jh Ac] and lost with a pair of Jacks
Seat 4: DDarks (button) folded on the Flop
Seat 5: Paker 3 (small blind) showed [3h 4h] and won ($24.10) with two pair, Fours and Threes
Seat 6: 4Skill (big blind) folded before Flop



PokerStars Hand #201508535633:  Hold'em No Limit ($0.05/$0.10 USD) - 2019/06/18 10:55:22 ET
Table 'Moreau III' 6-max Seat #5 is the button
Seat 1: togl63amg ($10 in chips) 
Seat 2: lillelars888 ($10.01 in chips) 
Seat 3: ReKych ($10 in chips) 
Seat 4: DDarks ($11.27 in chips) 
Seat 5: Paker 3 ($34.82 in chips) 
Seat 6: 4Skill ($10 in chips) 
4Skill: posts small blind $0.05
togl63amg: posts big blind $0.10
togl63amg: posts the ante $0.02
lillelars888: posts the ante $0.02
ReKych: posts the ante $0.02
DDarks: posts the ante $0.02
Paker 3: posts the ante $0.02
4Skill: posts the ante $0.02
*** HOLE CARDS ***
lillelars888: folds 
ReKych: folds 
DDarks: folds 
Paker 3: calls $0.10
4Skill: calls $0.05
togl63amg: raises $0.50 to $0.60
Paker 3: folds 
4Skill: folds 
Uncalled bet ($0.50) returned to togl63amg
togl63amg collected $0.42 from pot
*** SUMMARY ***
Total pot $0.42 | Rake $0 
Seat 1: togl63amg (big blind) collected ($0.42)
Seat 2: lillelars888 folded before Flop (didn't bet)
Seat 3: ReKych folded before Flop (didn't bet)
Seat 4: DDarks folded before Flop (didn't bet)
Seat 5: Paker 3 (button) folded before Flop
Seat 6: 4Skill (small blind) folded before Flop



PokerStars Hand #201508545701:  Hold'em No Limit ($0.05/$0.10 USD) - 2019/06/18 10:55:52 ET
Table 'Moreau III' 6-max Seat #6 is the button
Seat 1: togl63amg ($10.30 in chips) 
Seat 2: lillelars888 ($9.99 in chips) 
Seat 3: ReKych ($10 in chips) 
Seat 4: DDarks ($11.25 in chips) 
Seat 5: Paker 3 ($34.70 in chips) 
Seat 6: 4Skill ($10 in chips) 
togl63amg: posts small blind $0.05
lillelars888: posts big blind $0.10
togl63amg: posts the ante $0.02
lillelars888: posts the ante $0.02
ReKych: posts the ante $0.02
DDarks: posts the ante $0.02
Paker 3: posts the ante $0.02
4Skill: posts the ante $0.02
*** HOLE CARDS ***
ReKych: folds 
DDarks: folds 
Paker 3: folds 
4Skill: raises $0.15 to $0.25
togl63amg: folds 
lillelars888: folds 
Uncalled bet ($0.15) returned to 4Skill
4Skill collected $0.37 from pot
4Skill: doesn't show hand 
*** SUMMARY ***
Total pot $0.37 | Rake $0 
Seat 1: togl63amg (small blind) folded before Flop
Seat 2: lillelars888 (big blind) folded before Flop
Seat 3: ReKych folded before Flop (didn't bet)
Seat 4: DDarks folded before Flop (didn't bet)
Seat 5: Paker 3 folded before Flop (didn't bet)
Seat 6: 4Skill (button) collected ($0.37)



PokerStars Hand #201508552332:  Hold'em No Limit ($0.05/$0.10 USD) - 2019/06/18 10:56:12 ET
Table 'Moreau III' 6-max Seat #1 is the button
Seat 1: togl63amg ($10.23 in chips) 
Seat 2: lillelars888 ($9.87 in chips) 
Seat 3: ReKych ($10 in chips) 
Seat 4: DDarks ($11.23 in chips) 
Seat 5: Paker 3 ($34.68 in chips) 
Seat 6: 4Skill ($10.25 in chips) 
lillelars888: posts small blind $0.05
ReKych: posts big blind $0.10
togl63amg: posts the ante $0.02
lillelars888: posts the ante $0.02
ReKych: posts the ante $0.02
DDarks: posts the ante $0.02
Paker 3: posts the ante $0.02
4Skill: posts the ante $0.02
*** HOLE CARDS ***
DDarks: raises $0.10 to $0.20
Paker 3: calls $0.20
4Skill: folds 
togl63amg: folds 
lillelars888: folds 
ReKych: folds 
*** FLOP *** [Qd 6h 7h]
DDarks: bets $0.50
Paker 3: folds 
Uncalled bet ($0.50) returned to DDarks
DDarks collected $0.64 from pot
DDarks: doesn't show hand 
*** SUMMARY ***
Total pot $0.67 | Rake $0.03 
Board [Qd 6h 7h]
Seat 1: togl63amg (button) folded before Flop (didn't bet)
Seat 2: lillelars888 (small blind) folded before Flop
Seat 3: ReKych (big blind) folded before Flop
Seat 4: DDarks collected ($0.64)
Seat 5: Paker 3 folded on the Flop
Seat 6: 4Skill folded before Flop (didn't bet)



PokerStars Hand #201508558418:  Hold'em No Limit ($0.05/$0.10 USD) - 2019/06/18 10:56:30 ET
Table 'Moreau III' 6-max Seat #2 is the button
Seat 1: togl63amg ($10.21 in chips) 
Seat 2: lillelars888 ($9.80 in chips) 
Seat 3: ReKych ($10 in chips) 
Seat 4: DDarks ($11.65 in chips) 
Seat 5: Paker 3 ($34.46 in chips) 
Seat 6: 4Skill ($10.23 in chips) 
ReKych: posts small blind $0.05
DDarks: posts big blind $0.10
togl63amg: posts the ante $0.02
lillelars888: posts the ante $0.02
ReKych: posts the ante $0.02
DDarks: posts the ante $0.02
Paker 3: posts the ante $0.02
4Skill: posts the ante $0.02
*** HOLE CARDS ***
Paker 3: calls $0.10
4Skill: folds 
togl63amg: raises $0.40 to $0.50
lillelars888: folds 
ReKych: folds 
DDarks: calls $0.40
Paker 3: raises $0.75 to $1.25
togl63amg: calls $0.75
DDarks: calls $0.75
*** FLOP *** [Js Ac 3h]
DDarks: checks 
Paker 3: bets $1.10
togl63amg: calls $1.10
DDarks: folds 
*** TURN *** [Js Ac 3h] [Ah]
Paker 3: bets $2.10
togl63amg: calls $2.10
*** RIVER *** [Js Ac 3h Ah] [Jc]
Paker 3: checks 
togl63amg: bets $5.74 and is all-in
Paker 3: folds 
Uncalled bet ($5.74) returned to togl63amg
togl63amg collected $9.86 from pot
togl63amg: shows [9s 9h] (two pair, Aces and Jacks)
*** SUMMARY ***
Total pot $10.32 | Rake $0.46 
Board [Js Ac 3h Ah Jc]
Seat 1: togl63amg collected ($9.86)
Seat 2: lillelars888 (button) folded before Flop (didn't bet)
Seat 3: ReKych (small blind) folded before Flop
Seat 4: DDarks (big blind) folded on the Flop
Seat 5: Paker 3 folded on the River
Seat 6: 4Skill folded before Flop (didn't bet)



PokerStars Hand #201508587661:  Hold'em No Limit ($0.05/$0.10 USD) - 2019/06/18 10:57:55 ET
Table 'Moreau III' 6-max Seat #3 is the button
Seat 1: togl63amg ($15.60 in chips) 
Seat 2: lillelars888 ($9.78 in chips) 
Seat 3: ReKych ($10 in chips) 
Seat 4: DDarks ($10.38 in chips) 
Seat 5: Paker 3 ($29.99 in chips) 
Seat 6: 4Skill ($10.21 in chips) 
DDarks: posts small blind $0.05
Paker 3: posts big blind $0.10
togl63amg: posts the ante $0.02
lillelars888: posts the ante $0.02
ReKych: posts the ante $0.02
DDarks: posts the ante $0.02
Paker 3: posts the ante $0.02
4Skill: posts the ante $0.02
*** HOLE CARDS ***
4Skill: folds 
togl63amg: folds 
lillelars888: folds 
ReKych: raises $0.20 to $0.30
DDarks: calls $0.25
Paker 3: calls $0.20
*** FLOP *** [Td 5d Jc]
DDarks: checks 
Paker 3: checks 
ReKych: bets $0.40
DDarks: folds 
Paker 3: calls $0.40
*** TURN *** [Td 5d Jc] [8s]
Paker 3: checks 
ReKych: bets $0.60
Paker 3: calls $0.60
*** RIVER *** [Td 5d Jc 8s] [Kh]
Paker 3: checks 
ReKych: checks 
*** SHOW DOWN ***
Paker 3: shows [9d 8c] (a pair of Eights)
ReKych: shows [Th 7c] (a pair of Tens)
ReKych collected $2.88 from pot
*** SUMMARY ***
Total pot $3.02 | Rake $0.14 
Board [Td 5d Jc 8s Kh]
Seat 1: togl63amg folded before Flop (didn't bet)
Seat 2: lillelars888 folded before Flop (didn't bet)
Seat 3: ReKych (button) showed [Th 7c] and won ($2.88) with a pair of Tens
Seat 4: DDarks (small blind) folded on the Flop
Seat 5: Paker 3 (big blind) showed [9d 8c] and lost with a pair of Eights
Seat 6: 4Skill folded before Flop (didn't bet)



PokerStars Hand #201508601678:  Hold'em No Limit ($0.05/$0.10 USD) - 2019/06/18 10:58:36 ET
Table 'Moreau III' 6-max Seat #4 is the button
Seat 1: togl63amg ($15.58 in chips) 
Seat 2: lillelars888 ($9.76 in chips) 
Seat 3: ReKych ($11.56 in chips) 
Seat 4: DDarks ($10.06 in chips) 
Seat 5: Paker 3 ($28.67 in chips) 
Paker 3: posts small blind $0.05
4Skill: is sitting out 
togl63amg: posts big blind $0.10
togl63amg: posts the ante $0.02
lillelars888: posts the ante $0.02
ReKych: posts the ante $0.02
DDarks: posts the ante $0.02
Paker 3: posts the ante $0.02
*** HOLE CARDS ***
lillelars888: folds 
ReKych: raises $0.20 to $0.30
4Skill leaves the table
DDarks: raises $0.30 to $0.60
ale9030 joins the table at seat #6 
Paker 3: folds 
togl63amg: folds 
ReKych: calls $0.30
*** FLOP *** [7d Kc 2s]
ReKych: checks 
DDarks: bets $0.50
ReKych: calls $0.50
*** TURN *** [7d Kc 2s] [9s]
ReKych: checks 
DDarks: bets $0.50
ReKych: calls $0.50
*** RIVER *** [7d Kc 2s 9s] [Qh]
ReKych: checks 
DDarks: checks 
*** SHOW DOWN ***
ReKych: shows [Kh 4h] (a pair of Kings)
DDarks: mucks hand 
ReKych collected $3.29 from pot
*** SUMMARY ***
Total pot $3.45 | Rake $0.16 
Board [7d Kc 2s 9s Qh]
Seat 1: togl63amg (big blind) folded before Flop
Seat 2: lillelars888 folded before Flop (didn't bet)
Seat 3: ReKych showed [Kh 4h] and won ($3.29) with a pair of Kings
Seat 4: DDarks (button) mucked
Seat 5: Paker 3 (small blind) folded before Flop



PokerStars Hand #201508619833:  Hold'em No Limit ($0.05/$0.10 USD) - 2019/06/18 10:59:29 ET
Table 'Moreau III' 6-max Seat #5 is the button
Seat 1: togl63amg ($15.46 in chips) 
Seat 2: lillelars888 ($9.74 in chips) 
Seat 3: ReKych ($13.23 in chips) 
Seat 4: DDarks ($8.44 in chips) 
Seat 5: Paker 3 ($28.60 in chips) 
togl63amg: posts small blind $0.05
lillelars888: posts big blind $0.10
togl63amg: posts the ante $0.02
lillelars888: posts the ante $0.02
ReKych: posts the ante $0.02
DDarks: posts the ante $0.02
Paker 3: posts the ante $0.02
*** HOLE CARDS ***
ReKych: raises $0.30 to $0.40
DDarks: calls $0.40
Paker 3: calls $0.40
togl63amg: folds 
lillelars888: folds 
*** FLOP *** [Tc Js 7h]
ReKych: bets $1
DDarks: folds 
Paker 3: folds 
Uncalled bet ($1) returned to ReKych
ReKych collected $1.38 from pot
ReKych: doesn't show hand 
*** SUMMARY ***
Total pot $1.45 | Rake $0.07 
Board [Tc Js 7h]
Seat 1: togl63amg (small blind) folded before Flop
Seat 2: lillelars888 (big blind) folded before Flop
Seat 3: ReKych collected ($1.38)
Seat 4: DDarks folded on the Flop
Seat 5: Paker 3 (button) folded on the Flop



PokerStars Hand #201508629742:  Hold'em No Limit ($0.05/$0.10 USD) - 2019/06/18 10:59:58 ET
Table 'Moreau III' 6-max Seat #1 is the button
Seat 1: togl63amg ($15.39 in chips) 
Seat 2: lillelars888 ($9.62 in chips) 
Seat 3: ReKych ($14.19 in chips) 
Seat 4: DDarks ($8.02 in chips) 
Seat 5: Paker 3 ($28.18 in chips) 
lillelars888: posts small blind $0.05
ReKych: posts big blind $0.10
ale9030: sits out 
togl63amg: posts the ante $0.02
lillelars888: posts the ante $0.02
ReKych: posts the ante $0.02
DDarks: posts the ante $0.02
Paker 3: posts the ante $0.02
*** HOLE CARDS ***
DDarks: raises $0.40 to $0.50
Paker 3: calls $0.50
togl63amg: calls $0.50
lillelars888: folds 
ReKych: folds 
*** FLOP *** [2c 5s Kc]
DDarks: bets $0.50
Paker 3: folds 
togl63amg: calls $0.50
*** TURN *** [2c 5s Kc] [5c]
DDarks: bets $1
togl63amg: folds 
Uncalled bet ($1) returned to DDarks
DDarks collected $2.63 from pot
DDarks: doesn't show hand 
*** SUMMARY ***
Total pot $2.75 | Rake $0.12 
Board [2c 5s Kc 5c]
Seat 1: togl63amg (button) folded on the Turn
Seat 2: lillelars888 (small blind) folded before Flop
Seat 3: ReKych (big blind) folded before Flop
Seat 4: DDarks collected ($2.63)
Seat 5: Paker 3 folded on the Flop



PokerStars Hand #201508766370:  Hold'em No Limit ($0.05/$0.10 USD) - 2019/06/18 11:05:48 ET
Table 'Moreau III' 6-max Seat #4 is the button
Seat 1: togl63amg ($17.88 in chips) 
Seat 3: ReKych ($13.05 in chips) 
Seat 4: DDarks ($9.45 in chips) 
Seat 5: Paker 3 ($24.31 in chips) 
Seat 6: ale9030 ($12.92 in chips) 
Paker 3: posts small blind $0.05
ale9030: posts big blind $0.10
togl63amg: posts the ante $0.02
ReKych: posts the ante $0.02
DDarks: posts the ante $0.02
Paker 3: posts the ante $0.02
ale9030: posts the ante $0.02
*** HOLE CARDS ***
togl63amg: folds 
ReKych: raises $0.40 to $0.50
DDarks: raises $0.40 to $0.90
Paker 3: calls $0.85
ale9030: folds 
ReKych: raises $2.60 to $3.50
DDarks: raises $2.60 to $6.10
Paker 3: raises $18.19 to $24.29 and is all-in
ReKych: calls $9.53 and is all-in
DDarks: calls $3.33 and is all-in
Uncalled bet ($11.26) returned to Paker 3
*** FLOP *** [5s Ts 3c]
*** TURN *** [5s Ts 3c] [3d]
*** RIVER *** [5s Ts 3c 3d] [4c]
*** SHOW DOWN ***
Paker 3: shows [As Kd] (a pair of Threes)
ReKych: shows [Ks Ah] (a pair of Threes)
Paker 3 collected $3.49 from side pot
ReKych collected $3.49 from side pot
DDarks: shows [Qd Kc] (a pair of Threes - lower kicker)
jext leaves the table
Paker 3 collected $13.61 from main pot
ReKych collected $13.60 from main pot
*** SUMMARY ***
Total pot $35.69 Main pot $27.21. Side pot $6.98. | Rake $1.50 
Board [5s Ts 3c 3d 4c]
Seat 1: togl63amg folded before Flop (didn't bet)
Seat 3: ReKych showed [Ks Ah] and won ($17.09) with a pair of Threes
Seat 4: DDarks (button) showed [Qd Kc] and lost with a pair of Threes
Seat 5: Paker 3 (small blind) showed [As Kd] and won ($17.10) with a pair of Threes
Seat 6: ale9030 (big blind) folded before Flop



PokerStars Hand #201508782424:  Hold'em No Limit ($0.05/$0.10 USD) - 2019/06/18 11:06:27 ET
Table 'Moreau III' 6-max Seat #5 is the button
Seat 1: togl63amg ($17.86 in chips) 
Seat 3: ReKych ($17.09 in chips) 
Seat 5: Paker 3 ($28.36 in chips) 
Seat 6: ale9030 ($12.80 in chips) 
ale9030: posts small blind $0.05
togl63amg: posts big blind $0.10
togl63amg: posts the ante $0.02
ReKych: posts the ante $0.02
Paker 3: posts the ante $0.02
ale9030: posts the ante $0.02
*** HOLE CARDS ***
ReKych: raises $0.20 to $0.30
Paker 3: raises $0.80 to $1.10
ale9030: folds 
togl63amg: folds 
ReKych: folds 
Uncalled bet ($0.80) returned to Paker 3
Paker 3 collected $0.83 from pot
*** SUMMARY ***
Total pot $0.83 | Rake $0 
Seat 1: togl63amg (big blind) folded before Flop
Seat 3: ReKych folded before Flop
Seat 5: Paker 3 (button) collected ($0.83)
Seat 6: ale9030 (small blind) folded before Flop



PokerStars Hand #201508791974:  Hold'em No Limit ($0.05/$0.10 USD) - 2019/06/18 11:06:50 ET
Table 'Moreau III' 6-max Seat #6 is the button
Seat 1: togl63amg ($17.74 in chips) 
Seat 3: ReKych ($16.77 in chips) 
Seat 4: DDarks ($10 in chips) 
Seat 5: Paker 3 ($28.87 in chips) 
Seat 6: ale9030 ($12.73 in chips) 
togl63amg: posts small blind $0.05
ReKych: posts big blind $0.10
togl63amg: posts the ante $0.02
ReKych: posts the ante $0.02
DDarks: posts the ante $0.02
Paker 3: posts the ante $0.02
ale9030: posts the ante $0.02
*** HOLE CARDS ***
DDarks: raises $0.40 to $0.50
Paker 3: calls $0.50
ale9030: folds 
togl63amg: folds 
ReKych: folds 
*** FLOP *** [Ah 5d Jc]
DDarks: checks 
Paker 3: bets $0.25
DDarks: folds 
Uncalled bet ($0.25) returned to Paker 3
Paker 3 collected $1.19 from pot
*** SUMMARY ***
Total pot $1.25 | Rake $0.06 
Board [Ah 5d Jc]
Seat 1: togl63amg (small blind) folded before Flop
Seat 3: ReKych (big blind) folded before Flop
Seat 4: DDarks folded on the Flop
Seat 5: Paker 3 collected ($1.19)
Seat 6: ale9030 (button) folded before Flop (didn't bet)



PokerStars Hand #201508807130:  Hold'em No Limit ($0.05/$0.10 USD) - 2019/06/18 11:07:26 ET
Table 'Moreau III' 6-max Seat #1 is the button
Seat 1: togl63amg ($17.67 in chips) 
Seat 3: ReKych ($16.65 in chips) 
Seat 4: DDarks ($9.48 in chips) 
Seat 5: Paker 3 ($29.54 in chips) 
Seat 6: ale9030 ($12.71 in chips) 
ReKych: posts small blind $0.05
DDarks: posts big blind $0.10
togl63amg: posts the ante $0.02
ReKych: posts the ante $0.02
DDarks: posts the ante $0.02
Paker 3: posts the ante $0.02
ale9030: posts the ante $0.02
*** HOLE CARDS ***
Paker 3: calls $0.10
ale9030: folds 
togl63amg: folds 
ReKych: calls $0.05
DDarks: checks 
*** FLOP *** [Ks Kd 3h]
ReKych: checks 
DDarks: bets $0.10
Paker 3: raises $0.15 to $0.25
ReKych: folds 
DDarks: raises $0.15 to $0.40
Paker 3: calls $0.15
*** TURN *** [Ks Kd 3h] [9d]
DDarks: checks 
Paker 3: checks 
*** RIVER *** [Ks Kd 3h 9d] [8h]
DDarks: checks 
Paker 3: checks 
*** SHOW DOWN ***
DDarks: shows [Js 4c] (a pair of Kings)
Paker 3: shows [4s 4d] (two pair, Kings and Fours)
Paker 3 collected $1.15 from pot
*** SUMMARY ***
Total pot $1.20 | Rake $0.05 
Board [Ks Kd 3h 9d 8h]
Seat 1: togl63amg (button) folded before Flop (didn't bet)
Seat 3: ReKych (small blind) folded on the Flop
Seat 4: DDarks (big blind) showed [Js 4c] and lost with a pair of Kings
Seat 5: Paker 3 showed [4s 4d] and won ($1.15) with two pair, Kings and Fours
Seat 6: ale9030 folded before Flop (didn't bet)



PokerStars Hand #201508827432:  Hold'em No Limit ($0.05/$0.10 USD) - 2019/06/18 11:08:14 ET
Table 'Moreau III' 6-max Seat #3 is the button
Seat 1: togl63amg ($17.65 in chips) 
Seat 3: ReKych ($16.53 in chips) 
Seat 4: DDarks ($8.96 in chips) 
Seat 5: Paker 3 ($30.17 in chips) 
Seat 6: ale9030 ($12.69 in chips) 
DDarks: posts small blind $0.05
Paker 3: posts big blind $0.10
togl63amg: posts the ante $0.02
ReKych: posts the ante $0.02
DDarks: posts the ante $0.02
Paker 3: posts the ante $0.02
ale9030: posts the ante $0.02
*** HOLE CARDS ***
ale9030: raises $0.20 to $0.30
togl63amg: raises $0.60 to $0.90
ReKych: folds 
DDarks: calls $0.85
Paker 3: folds 
ale9030: folds 
*** FLOP *** [9h Jc 5h]
DDarks: checks 
togl63amg: bets $1.50
DDarks: folds 
Uncalled bet ($1.50) returned to togl63amg
togl63amg collected $2.20 from pot
*** SUMMARY ***
Total pot $2.30 | Rake $0.10 
Board [9h Jc 5h]
Seat 1: togl63amg collected ($2.20)
Seat 3: ReKych (button) folded before Flop (didn't bet)
Seat 4: DDarks (small blind) folded on the Flop
Seat 5: Paker 3 (big blind) folded before Flop
Seat 6: ale9030 folded before Flop



PokerStars Hand #201508842613:  Hold'em No Limit ($0.05/$0.10 USD) - 2019/06/18 11:08:50 ET
Table 'Moreau III' 6-max Seat #4 is the button
Seat 1: togl63amg ($18.93 in chips) 
Seat 3: ReKych ($16.51 in chips) 
Seat 4: DDarks ($8.04 in chips) 
Seat 5: Paker 3 ($30.05 in chips) 
Seat 6: ale9030 ($12.37 in chips) 
Paker 3: posts small blind $0.05
ale9030: posts big blind $0.10
togl63amg: posts the ante $0.02
ReKych: posts the ante $0.02
DDarks: posts the ante $0.02
Paker 3: posts the ante $0.02
ale9030: posts the ante $0.02
*** HOLE CARDS ***
togl63amg: folds 
ReKych: folds 
DDarks: folds 
Paker 3: calls $0.05
ale9030: raises $0.30 to $0.40
Paker 3: folds 
Uncalled bet ($0.30) returned to ale9030
ale9030 collected $0.30 from pot
*** SUMMARY ***
Total pot $0.30 | Rake $0 
Seat 1: togl63amg folded before Flop (didn't bet)
Seat 3: ReKych folded before Flop (didn't bet)
Seat 4: DDarks (button) folded before Flop (didn't bet)
Seat 5: Paker 3 (small blind) folded before Flop
Seat 6: ale9030 (big blind) collected ($0.30)



PokerStars Hand #201508851147:  Hold'em No Limit ($0.05/$0.10 USD) - 2019/06/18 11:09:10 ET
Table 'Moreau III' 6-max Seat #5 is the button
Seat 3: ReKych ($16.49 in chips) 
Seat 4: DDarks ($8.02 in chips) 
Seat 5: Paker 3 ($29.93 in chips) 
Seat 6: ale9030 ($12.55 in chips) 
ale9030: posts small blind $0.05
ReKych: posts big blind $0.10
ReKych: posts the ante $0.02
DDarks: posts the ante $0.02
Paker 3: posts the ante $0.02
ale9030: posts the ante $0.02
*** HOLE CARDS ***
DDarks: folds 
Paker 3: raises $0.30 to $0.40
ale9030: folds 
ReKych: folds 
Uncalled bet ($0.30) returned to Paker 3
Paker 3 collected $0.33 from pot
*** SUMMARY ***
Total pot $0.33 | Rake $0 
Seat 3: ReKych (big blind) folded before Flop
Seat 4: DDarks folded before Flop (didn't bet)
Seat 5: Paker 3 (button) collected ($0.33)
Seat 6: ale9030 (small blind) folded before Flop



PokerStars Hand #201508860114:  Hold'em No Limit ($0.05/$0.10 USD) - 2019/06/18 11:09:31 ET
Table 'Moreau III' 6-max Seat #6 is the button
Seat 3: ReKych ($16.37 in chips) 
Seat 4: DDarks ($8 in chips) 
Seat 5: Paker 3 ($30.14 in chips) 
Seat 6: ale9030 ($12.48 in chips) 
ReKych: posts small blind $0.05
DDarks: posts big blind $0.10
ReKych: posts the ante $0.02
DDarks: posts the ante $0.02
Paker 3: posts the ante $0.02
ale9030: posts the ante $0.02
*** HOLE CARDS ***
Paker 3: folds 
ale9030: raises $0.15 to $0.25
ReKych: folds 
DDarks: raises $0.75 to $1
ale9030: folds 
Uncalled bet ($0.75) returned to DDarks
DDarks collected $0.63 from pot
DDarks: doesn't show hand 
*** SUMMARY ***
Total pot $0.63 | Rake $0 
Seat 3: ReKych (small blind) folded before Flop
Seat 4: DDarks (big blind) collected ($0.63)
Seat 5: Paker 3 folded before Flop (didn't bet)
Seat 6: ale9030 (button) folded before Flop



PokerStars Hand #201508873163:  Hold'em No Limit ($0.05/$0.10 USD) - 2019/06/18 11:10:01 ET
Table 'Moreau III' 6-max Seat #3 is the button
Seat 3: ReKych ($16.30 in chips) 
Seat 4: DDarks ($8.36 in chips) 
Seat 5: Paker 3 ($30.12 in chips) 
Seat 6: ale9030 ($12.21 in chips) 
DDarks: posts small blind $0.05
Paker 3: posts big blind $0.10
ReKych: posts the ante $0.02
DDarks: posts the ante $0.02
Paker 3: posts the ante $0.02
ale9030: posts the ante $0.02
*** HOLE CARDS ***
ale9030: folds 
ReKych: folds 
DDarks: calls $0.05
Paker 3: checks 
*** FLOP *** [5d Jd 3d]
DDarks: checks 
Paker 3: checks 
*** TURN *** [5d Jd 3d] [8c]
DDarks: checks 
Paker 3: checks 
*** RIVER *** [5d Jd 3d 8c] [Qs]
DDarks: bets $0.50
Paker 3: folds 
Uncalled bet ($0.50) returned to DDarks
DDarks collected $0.27 from pot
DDarks: doesn't show hand 
*** SUMMARY ***
Total pot $0.28 | Rake $0.01 
Board [5d Jd 3d 8c Qs]
Seat 3: ReKych (button) folded before Flop (didn't bet)
Seat 4: DDarks (small blind) collected ($0.27)
Seat 5: Paker 3 (big blind) folded on the River
Seat 6: ale9030 folded before Flop (didn't bet)



PokerStars Hand #201508889520:  Hold'em No Limit ($0.05/$0.10 USD) - 2019/06/18 11:10:40 ET
Table 'Moreau III' 6-max Seat #4 is the button
Seat 3: ReKych ($16.28 in chips) 
Seat 4: DDarks ($8.51 in chips) 
Seat 5: Paker 3 ($30 in chips) 
Seat 6: ale9030 ($12.19 in chips) 
Paker 3: posts small blind $0.05
ale9030: posts big blind $0.10
ReKych: posts the ante $0.02
DDarks: posts the ante $0.02
Paker 3: posts the ante $0.02
ale9030: posts the ante $0.02
*** HOLE CARDS ***
ReKych: folds 
DDarks: raises $0.10 to $0.20
Paker 3: calls $0.15
ale9030: folds 
*** FLOP *** [Th 7d 3h]
Paker 3: checks 
DDarks: checks 
*** TURN *** [Th 7d 3h] [Qd]
Paker 3: checks 
DDarks: checks 
*** RIVER *** [Th 7d 3h Qd] [3c]
Paker 3: checks 
DDarks: bets $0.50
Paker 3: calls $0.50
*** SHOW DOWN ***
DDarks: shows [4d Ac] (a pair of Threes)
Paker 3: shows [Ad Kc] (a pair of Threes - Ace+King kicker)
Paker 3 collected $1.51 from pot
*** SUMMARY ***
Total pot $1.58 | Rake $0.07 
Board [Th 7d 3h Qd 3c]
Seat 3: ReKych folded before Flop (didn't bet)
Seat 4: DDarks (button) showed [4d Ac] and lost with a pair of Threes
Seat 5: Paker 3 (small blind) showed [Ad Kc] and won ($1.51) with a pair of Threes
Seat 6: ale9030 (big blind) folded before Flop



PokerStars Hand #201508643882:  Hold'em No Limit ($0.05/$0.10 USD) - 2019/06/18 11:00:38 ET
Table 'Moreau III' 6-max Seat #2 is the button
Seat 1: togl63amg ($14.37 in chips) 
Seat 2: lillelars888 ($9.55 in chips) 
Seat 3: ReKych ($14.07 in chips) 
Seat 4: DDarks ($9.63 in chips) 
Seat 5: Paker 3 ($27.66 in chips) 
ReKych: posts small blind $0.05
DDarks: posts big blind $0.10
ale9030: sits out 
togl63amg: posts the ante $0.02
lillelars888: posts the ante $0.02
ReKych: posts the ante $0.02
DDarks: posts the ante $0.02
Paker 3: posts the ante $0.02
*** HOLE CARDS ***
Paker 3: folds 
togl63amg: raises $0.20 to $0.30
lillelars888: calls $0.30
ReKych: folds 
DDarks: calls $0.20
*** FLOP *** [5d 4s 3c]
DDarks: checks 
togl63amg: bets $0.70
lillelars888: folds 
DDarks: calls $0.70
*** TURN *** [5d 4s 3c] [7c]
DDarks: checks 
togl63amg: checks 
*** RIVER *** [5d 4s 3c 7c] [Ac]
DDarks: bets $1
togl63amg: folds 
Uncalled bet ($1) returned to DDarks
DDarks collected $2.34 from pot
DDarks: doesn't show hand 
*** SUMMARY ***
Total pot $2.45 | Rake $0.11 
Board [5d 4s 3c 7c Ac]
Seat 1: togl63amg folded on the River
Seat 2: lillelars888 (button) folded on the Flop
Seat 3: ReKych (small blind) folded before Flop
Seat 4: DDarks (big blind) collected ($2.34)
Seat 5: Paker 3 folded before Flop (didn't bet)



PokerStars Hand #201508661156:  Hold'em No Limit ($0.05/$0.10 USD) - 2019/06/18 11:01:24 ET
Table 'Moreau III' 6-max Seat #3 is the button
Seat 1: togl63amg ($13.35 in chips) 
Seat 2: lillelars888 ($9.23 in chips) 
Seat 3: ReKych ($14 in chips) 
Seat 4: DDarks ($10.95 in chips) 
Seat 5: Paker 3 ($27.64 in chips) 
DDarks: posts small blind $0.05
Paker 3: posts big blind $0.10
ale9030: sits out 
togl63amg: posts the ante $0.02
lillelars888: posts the ante $0.02
ReKych: posts the ante $0.02
DDarks: posts the ante $0.02
Paker 3: posts the ante $0.02
*** HOLE CARDS ***
togl63amg: folds 
lillelars888: calls $0.10
ReKych: raises $0.40 to $0.50
DDarks: calls $0.45
Paker 3: folds 
lillelars888: calls $0.40
*** FLOP *** [Ah 2s Js]
DDarks: checks 
lillelars888: checks 
ReKych: checks 
*** TURN *** [Ah 2s Js] [8s]
DDarks: bets $1
lillelars888: folds 
ReKych: folds 
Uncalled bet ($1) returned to DDarks
DDarks collected $1.62 from pot
DDarks: doesn't show hand 
*** SUMMARY ***
Total pot $1.70 | Rake $0.08 
Board [Ah 2s Js 8s]
Seat 1: togl63amg folded before Flop (didn't bet)
Seat 2: lillelars888 folded on the Turn
Seat 3: ReKych (button) folded on the Turn
Seat 4: DDarks (small blind) collected ($1.62)
Seat 5: Paker 3 (big blind) folded before Flop



PokerStars Hand #201508685178:  Hold'em No Limit ($0.05/$0.10 USD) - 2019/06/18 11:02:26 ET
Table 'Moreau III' 6-max Seat #4 is the button
Seat 1: togl63amg ($13.33 in chips) 
Seat 2: lillelars888 ($8.71 in chips) 
Seat 3: ReKych ($13.48 in chips) 
Seat 4: DDarks ($12.05 in chips) 
Seat 5: Paker 3 ($27.52 in chips) 
Seat 6: ale9030 ($10 in chips) 
Paker 3: posts small blind $0.05
ale9030: posts big blind $0.10
togl63amg: posts the ante $0.02
lillelars888: posts the ante $0.02
ReKych: posts the ante $0.02
DDarks: posts the ante $0.02
Paker 3: posts the ante $0.02
ale9030: posts the ante $0.02
*** HOLE CARDS ***
togl63amg: raises $0.20 to $0.30
lillelars888: folds 
ReKych: folds 
DDarks: folds 
Paker 3: raises $0.50 to $0.80
ale9030: folds 
togl63amg: calls $0.50
*** FLOP *** [Qs 6c 9d]
Paker 3: checks 
togl63amg: checks 
*** TURN *** [Qs 6c 9d] [Jh]
Paker 3: bets $0.87
togl63amg: calls $0.87
*** RIVER *** [Qs 6c 9d Jh] [Kd]
Paker 3: checks 
togl63amg: bets $3.70
Paker 3: calls $3.70
*** SHOW DOWN ***
togl63amg: shows [Ts Ad] (a straight, Ten to Ace)
Paker 3: mucks hand 
togl63amg collected $10.47 from pot
*** SUMMARY ***
Total pot $10.96 | Rake $0.49 
Board [Qs 6c 9d Jh Kd]
Seat 1: togl63amg showed [Ts Ad] and won ($10.47) with a straight, Ten to Ace
Seat 2: lillelars888 folded before Flop (didn't bet)
Seat 3: ReKych folded before Flop (didn't bet)
Seat 4: DDarks (button) folded before Flop (didn't bet)
Seat 5: Paker 3 (small blind) mucked
Seat 6: ale9030 (big blind) folded before Flop



PokerStars Hand #201508704616:  Hold'em No Limit ($0.05/$0.10 USD) - 2019/06/18 11:03:15 ET
Table 'Moreau III' 6-max Seat #5 is the button
Seat 1: togl63amg ($18.41 in chips) 
Seat 2: lillelars888 ($8.69 in chips) 
Seat 3: ReKych ($13.46 in chips) 
Seat 4: DDarks ($12.03 in chips) 
Seat 5: Paker 3 ($22.13 in chips) 
Seat 6: ale9030 ($10 in chips) 
ale9030: posts small blind $0.05
togl63amg: posts big blind $0.10
togl63amg: posts the ante $0.02
lillelars888: posts the ante $0.02
ReKych: posts the ante $0.02
DDarks: posts the ante $0.02
Paker 3: posts the ante $0.02
ale9030: posts the ante $0.02
*** HOLE CARDS ***
lillelars888: raises $0.30 to $0.40
ReKych: folds 
DDarks: folds 
Paker 3: calls $0.40
ale9030: folds 
togl63amg: calls $0.30
*** FLOP *** [2d Tc 7h]
togl63amg: checks 
lillelars888: bets $0.66
Paker 3: raises $0.66 to $1.32
togl63amg: folds 
lillelars888: calls $0.66
*** TURN *** [2d Tc 7h] [Jd]
lillelars888: checks 
Paker 3: bets $0.40
lillelars888: folds 
Uncalled bet ($0.40) returned to Paker 3
Paker 3 collected $3.83 from pot
*** SUMMARY ***
Total pot $4.01 | Rake $0.18 
Board [2d Tc 7h Jd]
Seat 1: togl63amg (big blind) folded on the Flop
Seat 2: lillelars888 folded on the Turn
Seat 3: ReKych folded before Flop (didn't bet)
Seat 4: DDarks folded before Flop (didn't bet)
Seat 5: Paker 3 (button) collected ($3.83)
Seat 6: ale9030 (small blind) folded before Flop



PokerStars Hand #201508722592:  Hold'em No Limit ($0.05/$0.10 USD) - 2019/06/18 11:04:00 ET
Table 'Moreau III' 6-max Seat #6 is the button
Seat 1: togl63amg ($17.99 in chips) 
Seat 2: lillelars888 ($6.95 in chips) 
Seat 3: ReKych ($13.44 in chips) 
Seat 4: DDarks ($12.01 in chips) 
Seat 5: Paker 3 ($24.22 in chips) 
Seat 6: ale9030 ($10 in chips) 
togl63amg: posts small blind $0.05
lillelars888: posts big blind $0.10
togl63amg: posts the ante $0.02
lillelars888: posts the ante $0.02
ReKych: posts the ante $0.02
DDarks: posts the ante $0.02
Paker 3: posts the ante $0.02
ale9030: posts the ante $0.02
*** HOLE CARDS ***
ReKych: folds 
DDarks: folds 
Paker 3: calls $0.10
ale9030: folds 
togl63amg: folds 
lillelars888: checks 
*** FLOP *** [Qs 6h Ac]
lillelars888: checks 
Paker 3: bets $0.10
lillelars888: folds 
Uncalled bet ($0.10) returned to Paker 3
Paker 3 collected $0.35 from pot
*** SUMMARY ***
Total pot $0.37 | Rake $0.02 
Board [Qs 6h Ac]
Seat 1: togl63amg (small blind) folded before Flop
Seat 2: lillelars888 (big blind) folded on the Flop
Seat 3: ReKych folded before Flop (didn't bet)
Seat 4: DDarks folded before Flop (didn't bet)
Seat 5: Paker 3 collected ($0.35)
Seat 6: ale9030 (button) folded before Flop (didn't bet)



PokerStars Hand #201508738046:  Hold'em No Limit ($0.05/$0.10 USD) - 2019/06/18 11:04:38 ET
Table 'Moreau III' 6-max Seat #1 is the button
Seat 1: togl63amg ($17.92 in chips) 
Seat 2: lillelars888 ($6.83 in chips) 
Seat 3: ReKych ($13.42 in chips) 
Seat 4: DDarks ($11.99 in chips) 
Seat 5: Paker 3 ($24.45 in chips) 
Seat 6: ale9030 ($10 in chips) 
lillelars888: posts small blind $0.05
ReKych: posts big blind $0.10
togl63amg: posts the ante $0.02
lillelars888: posts the ante $0.02
ReKych: posts the ante $0.02
DDarks: posts the ante $0.02
Paker 3: posts the ante $0.02
ale9030: posts the ante $0.02
*** HOLE CARDS ***
DDarks: folds 
Paker 3: folds 
ale9030: folds 
togl63amg: folds 
lillelars888: folds 
Uncalled bet ($0.05) returned to ReKych
ReKych collected $0.22 from pot
ReKych: doesn't show hand 
*** SUMMARY ***
Total pot $0.22 | Rake $0 
Seat 1: togl63amg (button) folded before Flop (didn't bet)
Seat 2: lillelars888 (small blind) folded before Flop
Seat 3: ReKych (big blind) collected ($0.22)
Seat 4: DDarks folded before Flop (didn't bet)
Seat 5: Paker 3 folded before Flop (didn't bet)
Seat 6: ale9030 folded before Flop (didn't bet)



PokerStars Hand #201508742505:  Hold'em No Limit ($0.05/$0.10 USD) - 2019/06/18 11:04:50 ET
Table 'Moreau III' 6-max Seat #3 is the button
Seat 1: togl63amg ($17.90 in chips) 
Seat 3: ReKych ($13.57 in chips) 
Seat 4: DDarks ($11.97 in chips) 
Seat 5: Paker 3 ($24.43 in chips) 
Seat 6: ale9030 ($10 in chips) 
DDarks: posts small blind $0.05
Paker 3: posts big blind $0.10
togl63amg: posts the ante $0.02
ReKych: posts the ante $0.02
DDarks: posts the ante $0.02
Paker 3: posts the ante $0.02
ale9030: posts the ante $0.02
*** HOLE CARDS ***
lillelars888 leaves the table
ale9030: raises $0.20 to $0.30
jext joins the table at seat #2 
togl63amg: folds 
ReKych: calls $0.30
DDarks: raises $0.20 to $0.50
Paker 3: folds 
ale9030: calls $0.20
ReKych: calls $0.20
*** FLOP *** [As 6c Jh]
DDarks: bets $1
ale9030: calls $1
ReKych: folds 
*** TURN *** [As 6c Jh] [6d]
DDarks: bets $1
ale9030: calls $1
*** RIVER *** [As 6c Jh 6d] [Kh]
DDarks: checks 
ale9030: checks 
*** SHOW DOWN ***
DDarks: shows [Qc Qh] (two pair, Queens and Sixes)
ale9030: shows [Qs Ac] (two pair, Aces and Sixes)
ale9030 collected $5.44 from pot
*** SUMMARY ***
Total pot $5.70 | Rake $0.26 
Board [As 6c Jh 6d Kh]
Seat 1: togl63amg folded before Flop (didn't bet)
Seat 3: ReKych (button) folded on the Flop
Seat 4: DDarks (small blind) showed [Qc Qh] and lost with two pair, Queens and Sixes
Seat 5: Paker 3 (big blind) folded before Flop
Seat 6: ale9030 showed [Qs Ac] and won ($5.44) with two pair, Aces and Sixes



PokerStars Hand #201508900769:  Hold'em No Limit ($0.05/$0.10 USD) - 2019/06/18 11:11:06 ET
Table 'Moreau III' 6-max Seat #5 is the button
Seat 3: ReKych ($16.26 in chips) 
Seat 4: DDarks ($7.79 in chips) 
Seat 5: Paker 3 ($30.79 in chips) 
Seat 6: ale9030 ($12.07 in chips) 
ale9030: posts small blind $0.05
ReKych: posts big blind $0.10
ReKych: posts the ante $0.02
DDarks: posts the ante $0.02
Paker 3: posts the ante $0.02
ale9030: posts the ante $0.02
*** HOLE CARDS ***
DDarks: folds 
Paker 3: raises $0.10 to $0.20
ale9030: folds 
ReKych: folds 
Uncalled bet ($0.10) returned to Paker 3
Paker 3 collected $0.33 from pot
*** SUMMARY ***
Total pot $0.33 | Rake $0 
Seat 3: ReKych (big blind) folded before Flop
Seat 4: DDarks folded before Flop (didn't bet)
Seat 5: Paker 3 (button) collected ($0.33)
Seat 6: ale9030 (small blind) folded before Flop



PokerStars Hand #201508905455:  Hold'em No Limit ($0.05/$0.10 USD) - 2019/06/18 11:11:17 ET
Table 'Moreau III' 6-max Seat #6 is the button
Seat 3: ReKych ($16.14 in chips) 
Seat 4: DDarks ($7.77 in chips) 
Seat 5: Paker 3 ($31 in chips) 
Seat 6: ale9030 ($12 in chips) 
ReKych: posts small blind $0.05
DDarks: posts big blind $0.10
ReKych: posts the ante $0.02
DDarks: posts the ante $0.02
Paker 3: posts the ante $0.02
ale9030: posts the ante $0.02
*** HOLE CARDS ***
Paker 3: folds 
ale9030: folds 
ReKych: folds 
Uncalled bet ($0.05) returned to DDarks
DDarks collected $0.18 from pot
DDarks: doesn't show hand 
*** SUMMARY ***
Total pot $0.18 | Rake $0 
Seat 3: ReKych (small blind) folded before Flop
Seat 4: DDarks (big blind) collected ($0.18)
Seat 5: Paker 3 folded before Flop (didn't bet)
Seat 6: ale9030 (button) folded before Flop (didn't bet)



PokerStars Hand #201508910480:  Hold'em No Limit ($0.05/$0.10 USD) - 2019/06/18 11:11:29 ET
Table 'Moreau III' 6-max Seat #3 is the button
Seat 3: ReKych ($16.07 in chips) 
Seat 4: DDarks ($7.88 in chips) 
Seat 5: Paker 3 ($30.98 in chips) 
Seat 6: ale9030 ($11.98 in chips) 
DDarks: posts small blind $0.05
Paker 3: posts big blind $0.10
ReKych: posts the ante $0.02
DDarks: posts the ante $0.02
Paker 3: posts the ante $0.02
ale9030: posts the ante $0.02
*** HOLE CARDS ***
ale9030: folds 
ReKych: raises $0.20 to $0.30
DDarks: raises $0.20 to $0.50
Paker 3: folds 
ReKych: calls $0.20
*** FLOP *** [7c 6d 4c]
DDarks: bets $1
ReKych: folds 
Uncalled bet ($1) returned to DDarks
DDarks collected $1.13 from pot
DDarks: doesn't show hand 
*** SUMMARY ***
Total pot $1.18 | Rake $0.05 
Board [7c 6d 4c]
Seat 3: ReKych (button) folded on the Flop
Seat 4: DDarks (small blind) collected ($1.13)
Seat 5: Paker 3 (big blind) folded before Flop
Seat 6: ale9030 folded before Flop (didn't bet)



PokerStars Hand #201508919984:  Hold'em No Limit ($0.05/$0.10 USD) - 2019/06/18 11:11:52 ET
Table 'Moreau III' 6-max Seat #4 is the button
Seat 3: ReKych ($15.55 in chips) 
Seat 4: DDarks ($8.49 in chips) 
Seat 5: Paker 3 ($30.86 in chips) 
Seat 6: ale9030 ($11.96 in chips) 
Paker 3: posts small blind $0.05
ale9030: posts big blind $0.10
ReKych: posts the ante $0.02
DDarks: posts the ante $0.02
Paker 3: posts the ante $0.02
ale9030: posts the ante $0.02
*** HOLE CARDS ***
ReKych: folds 
DDarks: folds 
Paker 3: calls $0.05
ale9030: raises $0.30 to $0.40
Paker 3: calls $0.30
*** FLOP *** [Kc Th Kd]
Paker 3: checks 
ale9030: bets $0.42
Paker 3: folds 
Uncalled bet ($0.42) returned to ale9030
ale9030 collected $0.84 from pot
*** SUMMARY ***
Total pot $0.88 | Rake $0.04 
Board [Kc Th Kd]
Seat 3: ReKych folded before Flop (didn't bet)
Seat 4: DDarks (button) folded before Flop (didn't bet)
Seat 5: Paker 3 (small blind) folded on the Flop
Seat 6: ale9030 (big blind) collected ($0.84)



PokerStars Hand #201508929975:  Hold'em No Limit ($0.05/$0.10 USD) - 2019/06/18 11:12:15 ET
Table 'Moreau III' 6-max Seat #5 is the button
Seat 3: ReKych ($15.53 in chips) 
Seat 4: DDarks ($8.47 in chips) 
Seat 5: Paker 3 ($30.44 in chips) 
Seat 6: ale9030 ($12.38 in chips) 
ale9030: posts small blind $0.05
ReKych: posts big blind $0.10
ReKych: posts the ante $0.02
DDarks: posts the ante $0.02
Paker 3: posts the ante $0.02
ale9030: posts the ante $0.02
*** HOLE CARDS ***
DDarks: folds 
Paker 3: folds 
ale9030: raises $0.20 to $0.30
ReKych: folds 
Uncalled bet ($0.20) returned to ale9030
ale9030 collected $0.28 from pot
*** SUMMARY ***
Total pot $0.28 | Rake $0 
Seat 3: ReKych (big blind) folded before Flop
Seat 4: DDarks folded before Flop (didn't bet)
Seat 5: Paker 3 (button) folded before Flop (didn't bet)
Seat 6: ale9030 (small blind) collected ($0.28)



PokerStars Hand #201508934423:  Hold'em No Limit ($0.05/$0.10 USD) - 2019/06/18 11:12:26 ET
Table 'Moreau III' 6-max Seat #6 is the button
Seat 3: ReKych ($15.41 in chips) 
Seat 4: DDarks ($8.45 in chips) 
Seat 5: Paker 3 ($30.42 in chips) 
Seat 6: ale9030 ($12.54 in chips) 
ReKych: posts small blind $0.05
DDarks: posts big blind $0.10
ReKych: posts the ante $0.02
DDarks: posts the ante $0.02
Paker 3: posts the ante $0.02
ale9030: posts the ante $0.02
*** HOLE CARDS ***
Paker 3: folds 
ale9030: folds 
ReKych: raises $0.20 to $0.30
DDarks: calls $0.20
*** FLOP *** [5d 2d 7c]
ReKych: bets $0.21
DDarks: calls $0.21
*** TURN *** [5d 2d 7c] [Ah]
ReKych: bets $0.75
DDarks: folds 
Uncalled bet ($0.75) returned to ReKych
ReKych collected $1.05 from pot
ReKych: doesn't show hand 
*** SUMMARY ***
Total pot $1.10 | Rake $0.05 
Board [5d 2d 7c Ah]
Seat 3: ReKych (small blind) collected ($1.05)
Seat 4: DDarks (big blind) folded on the Turn
Seat 5: Paker 3 folded before Flop (didn't bet)
Seat 6: ale9030 (button) folded before Flop (didn't bet)



PokerStars Hand #201508945321:  Hold'em No Limit ($0.05/$0.10 USD) - 2019/06/18 11:12:52 ET
Table 'Moreau III' 6-max Seat #3 is the button
Seat 3: ReKych ($15.93 in chips) 
Seat 4: DDarks ($7.92 in chips) 
Seat 5: Paker 3 ($30.40 in chips) 
Seat 6: ale9030 ($12.52 in chips) 
DDarks: posts small blind $0.05
Paker 3: posts big blind $0.10
ReKych: posts the ante $0.02
DDarks: posts the ante $0.02
Paker 3: posts the ante $0.02
ale9030: posts the ante $0.02
*** HOLE CARDS ***
ale9030: raises $0.20 to $0.30
ReKych: folds 
DDarks: folds 
Paker 3: calls $0.20
*** FLOP *** [2d 3c 7s]
Paker 3: checks 
ale9030: bets $0.53
Paker 3: raises $0.53 to $1.06
ale9030: folds 
Uncalled bet ($0.53) returned to Paker 3
Paker 3 collected $1.71 from pot
*** SUMMARY ***
Total pot $1.79 | Rake $0.08 
Board [2d 3c 7s]
Seat 3: ReKych (button) folded before Flop (didn't bet)
Seat 4: DDarks (small blind) folded before Flop
Seat 5: Paker 3 (big blind) collected ($1.71)
Seat 6: ale9030 folded on the Flop



PokerStars Hand #201508957442:  Hold'em No Limit ($0.05/$0.10 USD) - 2019/06/18 11:13:21 ET
Table 'Moreau III' 6-max Seat #4 is the button
Seat 3: ReKych ($15.91 in chips) 
Seat 4: DDarks ($7.85 in chips) 
Seat 5: Paker 3 ($31.26 in chips) 
Seat 6: ale9030 ($11.67 in chips) 
Paker 3: posts small blind $0.05
ale9030: posts big blind $0.10
togl63amg: sits out 
ReKych: posts the ante $0.02
DDarks: posts the ante $0.02
Paker 3: posts the ante $0.02
ale9030: posts the ante $0.02
*** HOLE CARDS ***
ReKych: folds 
DDarks: folds 
Paker 3: calls $0.05
ale9030: raises $0.30 to $0.40
Paker 3: calls $0.30
*** FLOP *** [Qh 3c 9c]
Paker 3: bets $0.25
ale9030: calls $0.25
*** TURN *** [Qh 3c 9c] [9h]
Paker 3: checks 
ale9030: checks 
*** RIVER *** [Qh 3c 9c 9h] [Kc]
Paker 3: checks 
ale9030: bets $0.99
Paker 3: folds 
Uncalled bet ($0.99) returned to ale9030
ale9030 collected $1.32 from pot
*** SUMMARY ***
Total pot $1.38 | Rake $0.06 
Board [Qh 3c 9c 9h Kc]
Seat 3: ReKych folded before Flop (didn't bet)
Seat 4: DDarks (button) folded before Flop (didn't bet)
Seat 5: Paker 3 (small blind) folded on the River
Seat 6: ale9030 (big blind) collected ($1.32)



PokerStars Hand #201508981592:  Hold'em No Limit ($0.05/$0.10 USD) - 2019/06/18 11:14:18 ET
Table 'Moreau III' 6-max Seat #5 is the button
Seat 1: togl63amg ($18.91 in chips) 
Seat 3: ReKych ($15.89 in chips) 
Seat 4: DDarks ($7.83 in chips) 
Seat 5: Paker 3 ($30.59 in chips) 
Seat 6: ale9030 ($12.32 in chips) 
ale9030: posts small blind $0.05
togl63amg: posts big blind $0.10
togl63amg: posts the ante $0.02
ReKych: posts the ante $0.02
DDarks: posts the ante $0.02
Paker 3: posts the ante $0.02
ale9030: posts the ante $0.02
*** HOLE CARDS ***
ReKych: folds 
DDarks: calls $0.10
Paker 3: folds 
ale9030: folds 
togl63amg: raises $0.30 to $0.40
DDarks: calls $0.30
*** FLOP *** [7s 7d 2c]
togl63amg: bets $0.36
DDarks: folds 
Uncalled bet ($0.36) returned to togl63amg
togl63amg collected $0.91 from pot
*** SUMMARY ***
Total pot $0.95 | Rake $0.04 
Board [7s 7d 2c]
Seat 1: togl63amg (big blind) collected ($0.91)
Seat 3: ReKych folded before Flop (didn't bet)
Seat 4: DDarks folded on the Flop
Seat 5: Paker 3 (button) folded before Flop (didn't bet)
Seat 6: ale9030 (small blind) folded before Flop



PokerStars Hand #201508991073:  Hold'em No Limit ($0.05/$0.10 USD) - 2019/06/18 11:14:40 ET
Table 'Moreau III' 6-max Seat #6 is the button
Seat 1: togl63amg ($19.40 in chips) 
Seat 3: ReKych ($15.87 in chips) 
Seat 4: DDarks ($7.41 in chips) 
Seat 5: Paker 3 ($30.57 in chips) 
Seat 6: ale9030 ($12.25 in chips) 
togl63amg: posts small blind $0.05
ReKych: posts big blind $0.10
togl63amg: posts the ante $0.02
ReKych: posts the ante $0.02
DDarks: posts the ante $0.02
Paker 3: posts the ante $0.02
ale9030: posts the ante $0.02
*** HOLE CARDS ***
DDarks: raises $0.40 to $0.50
Paker 3: calls $0.50
ale9030: folds 
togl63amg: folds 
ReKych: calls $0.40
*** FLOP *** [2d 9c 8h]
ReKych: checks 
DDarks: bets $1
Paker 3: raises $1.10 to $2.10
ReKych: folds 
DDarks: raises $4.79 to $6.89 and is all-in
Paker 3: calls $4.79
*** TURN *** [2d 9c 8h] [6h]
*** RIVER *** [2d 9c 8h 6h] [3d]
*** SHOW DOWN ***
DDarks: shows [Ks Kh] (a pair of Kings)
Paker 3: shows [Ts Js] (high card Jack)
DDarks collected $14.74 from pot
*** SUMMARY ***
Total pot $15.43 | Rake $0.69 
Board [2d 9c 8h 6h 3d]
Seat 1: togl63amg (small blind) folded before Flop
Seat 3: ReKych (big blind) folded on the Flop
Seat 4: DDarks showed [Ks Kh] and won ($14.74) with a pair of Kings
Seat 5: Paker 3 showed [Ts Js] and lost with high card Jack
Seat 6: ale9030 (button) folded before Flop (didn't bet)



PokerStars Hand #201509014327:  Hold'em No Limit ($0.05/$0.10 USD) - 2019/06/18 11:15:35 ET
Table 'Moreau III' 6-max Seat #1 is the button
Seat 1: togl63amg ($19.33 in chips) 
Seat 3: ReKych ($15.35 in chips) 
Seat 4: DDarks ($14.74 in chips) 
Seat 5: Paker 3 ($23.16 in chips) 
Seat 6: ale9030 ($12.23 in chips) 
ReKych: posts small blind $0.05
DDarks: posts big blind $0.10
togl63amg: posts the ante $0.02
ReKych: posts the ante $0.02
DDarks: posts the ante $0.02
Paker 3: posts the ante $0.02
ale9030: posts the ante $0.02
*** HOLE CARDS ***
Paker 3: folds 
ale9030: folds 
togl63amg: folds 
ReKych: folds 
Uncalled bet ($0.05) returned to DDarks
DDarks collected $0.20 from pot
DDarks: doesn't show hand 
*** SUMMARY ***
Total pot $0.20 | Rake $0 
Seat 1: togl63amg (button) folded before Flop (didn't bet)
Seat 3: ReKych (small blind) folded before Flop
Seat 4: DDarks (big blind) collected ($0.20)
Seat 5: Paker 3 folded before Flop (didn't bet)
Seat 6: ale9030 folded before Flop (didn't bet)



PokerStars Hand #201509154347:  Hold'em No Limit ($0.05/$0.10 USD) - 2019/06/18 11:21:01 ET
Table 'Moreau III' 6-max Seat #5 is the button
Seat 1: togl63amg ($24.62 in chips) 
Seat 2: Old Benji ($9.88 in chips) 
Seat 3: ReKych ($13.43 in chips) 
Seat 4: DDarks ($14.75 in chips) 
Seat 5: Paker 3 ($19.61 in chips) 
Seat 6: ale9030 ($11.82 in chips) 
ale9030: posts small blind $0.05
togl63amg: posts big blind $0.10
togl63amg: posts the ante $0.02
Old Benji: posts the ante $0.02
ReKych: posts the ante $0.02
DDarks: posts the ante $0.02
Paker 3: posts the ante $0.02
ale9030: posts the ante $0.02
*** HOLE CARDS ***
Old Benji: raises $0.10 to $0.20
ReKych: folds 
DDarks: raises $0.40 to $0.60
Paker 3: calls $0.60
ale9030: folds 
togl63amg: folds 
Old Benji: calls $0.40
*** FLOP *** [As Jh 5s]
Old Benji: checks 
DDarks: bets $1
Paker 3: folds 
Old Benji: folds 
Uncalled bet ($1) returned to DDarks
DDarks collected $1.98 from pot
DDarks: doesn't show hand 
*** SUMMARY ***
Total pot $2.07 | Rake $0.09 
Board [As Jh 5s]
Seat 1: togl63amg (big blind) folded before Flop
Seat 2: Old Benji folded on the Flop
Seat 3: ReKych folded before Flop (didn't bet)
Seat 4: DDarks collected ($1.98)
Seat 5: Paker 3 (button) folded on the Flop
Seat 6: ale9030 (small blind) folded before Flop



PokerStars Hand #201509172025:  Hold'em No Limit ($0.05/$0.10 USD) - 2019/06/18 11:21:42 ET
Table 'Moreau III' 6-max Seat #6 is the button
Seat 1: togl63amg ($24.50 in chips) 
Seat 2: Old Benji ($9.26 in chips) 
Seat 3: ReKych ($13.41 in chips) 
Seat 4: DDarks ($16.11 in chips) 
Seat 5: Paker 3 ($18.99 in chips) 
Seat 6: ale9030 ($11.75 in chips) 
togl63amg: posts small blind $0.05
Old Benji: posts big blind $0.10
togl63amg: posts the ante $0.02
Old Benji: posts the ante $0.02
ReKych: posts the ante $0.02
DDarks: posts the ante $0.02
Paker 3: posts the ante $0.02
ale9030: posts the ante $0.02
*** HOLE CARDS ***
ReKych: folds 
DDarks: raises $0.40 to $0.50
Paker 3: folds 
ale9030: folds 
togl63amg: calls $0.45
Old Benji: folds 
*** FLOP *** [7d 6d 2c]
togl63amg: checks 
DDarks: bets $1
togl63amg: calls $1
*** TURN *** [7d 6d 2c] [3d]
togl63amg: checks 
DDarks: bets $2
togl63amg: calls $2
*** RIVER *** [7d 6d 2c 3d] [Ks]
togl63amg: checks 
DDarks: checks 
*** SHOW DOWN ***
togl63amg: shows [7h 9h] (a pair of Sevens)
DDarks: shows [8c 8h] (a pair of Eights)
DDarks collected $6.90 from pot
*** SUMMARY ***
Total pot $7.22 | Rake $0.32 
Board [7d 6d 2c 3d Ks]
Seat 1: togl63amg (small blind) showed [7h 9h] and lost with a pair of Sevens
Seat 2: Old Benji (big blind) folded before Flop
Seat 3: ReKych folded before Flop (didn't bet)
Seat 4: DDarks showed [8c 8h] and won ($6.90) with a pair of Eights
Seat 5: Paker 3 folded before Flop (didn't bet)
Seat 6: ale9030 (button) folded before Flop (didn't bet)



PokerStars Hand #201509188003:  Hold'em No Limit ($0.05/$0.10 USD) - 2019/06/18 11:22:19 ET
Table 'Moreau III' 6-max Seat #1 is the button
Seat 1: togl63amg ($20.98 in chips) 
Seat 2: Old Benji ($9.14 in chips) 
Seat 3: ReKych ($13.39 in chips) 
Seat 4: DDarks ($19.49 in chips) 
Seat 5: Paker 3 ($18.97 in chips) 
Seat 6: ale9030 ($11.73 in chips) 
Old Benji: posts small blind $0.05
ReKych: posts big blind $0.10
togl63amg: posts the ante $0.02
Old Benji: posts the ante $0.02
ReKych: posts the ante $0.02
DDarks: posts the ante $0.02
Paker 3: posts the ante $0.02
ale9030: posts the ante $0.02
*** HOLE CARDS ***
DDarks: raises $0.10 to $0.20
Paker 3: folds 
ale9030: folds 
togl63amg: raises $0.67 to $0.87
Old Benji: folds 
ReKych: folds 
DDarks: calls $0.67
*** FLOP *** [Kd 8h 9s]
DDarks: bets $1
togl63amg: calls $1
*** TURN *** [Kd 8h 9s] [6h]
DDarks: bets $1
togl63amg: calls $1
*** RIVER *** [Kd 8h 9s 6h] [6d]
DDarks: bets $5
togl63amg: folds 
Uncalled bet ($5) returned to DDarks
DDarks collected $5.74 from pot
DDarks: doesn't show hand 
*** SUMMARY ***
Total pot $6.01 | Rake $0.27 
Board [Kd 8h 9s 6h 6d]
Seat 1: togl63amg (button) folded on the River
Seat 2: Old Benji (small blind) folded before Flop
Seat 3: ReKych (big blind) folded before Flop
Seat 4: DDarks collected ($5.74)
Seat 5: Paker 3 folded before Flop (didn't bet)
Seat 6: ale9030 folded before Flop (didn't bet)



PokerStars Hand #201509227786:  Hold'em No Limit ($0.05/$0.10 USD) - 2019/06/18 11:23:51 ET
Table 'Moreau III' 6-max Seat #2 is the button
Seat 1: togl63amg ($18.09 in chips) 
Seat 2: Old Benji ($9.07 in chips) 
Seat 3: ReKych ($13.27 in chips) 
Seat 4: DDarks ($22.34 in chips) 
Seat 5: Paker 3 ($18.95 in chips) 
Seat 6: ale9030 ($11.71 in chips) 
ReKych: posts small blind $0.05
DDarks: posts big blind $0.10
togl63amg: posts the ante $0.02
Old Benji: posts the ante $0.02
ReKych: posts the ante $0.02
DDarks: posts the ante $0.02
Paker 3: posts the ante $0.02
ale9030: posts the ante $0.02
*** HOLE CARDS ***
Paker 3: calls $0.10
ale9030: folds 
togl63amg: folds 
Old Benji: folds 
ReKych: calls $0.05
DDarks: checks 
*** FLOP *** [Kh Td 6d]
ReKych: checks 
DDarks: checks 
Paker 3: checks 
*** TURN *** [Kh Td 6d] [Qh]
ReKych: bets $0.30
DDarks: folds 
Paker 3: calls $0.30
*** RIVER *** [Kh Td 6d Qh] [2c]
ReKych: bets $0.80
Paker 3: folds 
Uncalled bet ($0.80) returned to ReKych
ReKych collected $0.97 from pot
ReKych: doesn't show hand 
*** SUMMARY ***
Total pot $1.02 | Rake $0.05 
Board [Kh Td 6d Qh 2c]
Seat 1: togl63amg folded before Flop (didn't bet)
Seat 2: Old Benji (button) folded before Flop (didn't bet)
Seat 3: ReKych (small blind) collected ($0.97)
Seat 4: DDarks (big blind) folded on the Turn
Seat 5: Paker 3 folded on the River
Seat 6: ale9030 folded before Flop (didn't bet)



PokerStars Hand #201509249853:  Hold'em No Limit ($0.05/$0.10 USD) - 2019/06/18 11:24:42 ET
Table 'Moreau III' 6-max Seat #3 is the button
Seat 1: togl63amg ($18.07 in chips) 
Seat 2: Old Benji ($9.05 in chips) 
Seat 3: ReKych ($13.82 in chips) 
Seat 4: DDarks ($22.22 in chips) 
Seat 5: Paker 3 ($18.53 in chips) 
Seat 6: ale9030 ($11.69 in chips) 
DDarks: posts small blind $0.05
Paker 3: posts big blind $0.10
togl63amg: posts the ante $0.02
Old Benji: posts the ante $0.02
ReKych: posts the ante $0.02
DDarks: posts the ante $0.02
Paker 3: posts the ante $0.02
ale9030: posts the ante $0.02
*** HOLE CARDS ***
ale9030: folds 
togl63amg: raises $0.20 to $0.30
Old Benji: raises $0.20 to $0.50
ReKych: folds 
DDarks: folds 
Paker 3: folds 
togl63amg: calls $0.20
*** FLOP *** [6d 2h Qc]
togl63amg: checks 
Old Benji: checks 
*** TURN *** [6d 2h Qc] [Ah]
togl63amg: checks 
Old Benji: checks 
*** RIVER *** [6d 2h Qc Ah] [2d]
togl63amg: checks 
Old Benji: bets $1.21
togl63amg: folds 
Uncalled bet ($1.21) returned to Old Benji
Old Benji collected $1.21 from pot
Old Benji: doesn't show hand 
*** SUMMARY ***
Total pot $1.27 | Rake $0.06 
Board [6d 2h Qc Ah 2d]
Seat 1: togl63amg folded on the River
Seat 2: Old Benji collected ($1.21)
Seat 3: ReKych (button) folded before Flop (didn't bet)
Seat 4: DDarks (small blind) folded before Flop
Seat 5: Paker 3 (big blind) folded before Flop
Seat 6: ale9030 folded before Flop (didn't bet)



PokerStars Hand #201509267518:  Hold'em No Limit ($0.05/$0.10 USD) - 2019/06/18 11:25:23 ET
Table 'Moreau III' 6-max Seat #4 is the button
Seat 1: togl63amg ($17.55 in chips) 
Seat 2: Old Benji ($9.74 in chips) 
Seat 3: ReKych ($13.80 in chips) 
Seat 4: DDarks ($22.15 in chips) 
Seat 5: Paker 3 ($18.41 in chips) 
Seat 6: ale9030 ($11.67 in chips) 
Paker 3: posts small blind $0.05
ale9030: posts big blind $0.10
togl63amg: posts the ante $0.02
Old Benji: posts the ante $0.02
ReKych: posts the ante $0.02
DDarks: posts the ante $0.02
Paker 3: posts the ante $0.02
ale9030: posts the ante $0.02
*** HOLE CARDS ***
togl63amg: folds 
Old Benji: folds 
ReKych: folds 
DDarks: folds 
Paker 3: raises $0.10 to $0.20
ale9030: folds 
Uncalled bet ($0.10) returned to Paker 3
Paker 3 collected $0.32 from pot
*** SUMMARY ***
Total pot $0.32 | Rake $0 
Seat 1: togl63amg folded before Flop (didn't bet)
Seat 2: Old Benji folded before Flop (didn't bet)
Seat 3: ReKych folded before Flop (didn't bet)
Seat 4: DDarks (button) folded before Flop (didn't bet)
Seat 5: Paker 3 (small blind) collected ($0.32)
Seat 6: ale9030 (big blind) folded before Flop



PokerStars Hand #201509274189:  Hold'em No Limit ($0.05/$0.10 USD) - 2019/06/18 11:25:38 ET
Table 'Moreau III' 6-max Seat #5 is the button
Seat 1: togl63amg ($17.53 in chips) 
Seat 2: Old Benji ($9.72 in chips) 
Seat 3: ReKych ($13.78 in chips) 
Seat 4: DDarks ($22.13 in chips) 
Seat 5: Paker 3 ($18.61 in chips) 
Seat 6: ale9030 ($11.55 in chips) 
ale9030: posts small blind $0.05
togl63amg: posts big blind $0.10
togl63amg: posts the ante $0.02
Old Benji: posts the ante $0.02
ReKych: posts the ante $0.02
DDarks: posts the ante $0.02
Paker 3: posts the ante $0.02
ale9030: posts the ante $0.02
*** HOLE CARDS ***
Old Benji: folds 
ReKych: folds 
DDarks: folds 
Paker 3: folds 
ale9030: raises $0.20 to $0.30
togl63amg: folds 
Uncalled bet ($0.20) returned to ale9030
ale9030 collected $0.32 from pot
*** SUMMARY ***
Total pot $0.32 | Rake $0 
Seat 1: togl63amg (big blind) folded before Flop
Seat 2: Old Benji folded before Flop (didn't bet)
Seat 3: ReKych folded before Flop (didn't bet)
Seat 4: DDarks folded before Flop (didn't bet)
Seat 5: Paker 3 (button) folded before Flop (didn't bet)
Seat 6: ale9030 (small blind) collected ($0.32)



PokerStars Hand #201509281326:  Hold'em No Limit ($0.05/$0.10 USD) - 2019/06/18 11:25:54 ET
Table 'Moreau III' 6-max Seat #6 is the button
Seat 1: togl63amg ($17.41 in chips) 
Seat 2: Old Benji ($9.70 in chips) 
Seat 3: ReKych ($13.76 in chips) 
Seat 4: DDarks ($22.11 in chips) 
Seat 5: Paker 3 ($18.59 in chips) 
Seat 6: ale9030 ($11.75 in chips) 
togl63amg: posts small blind $0.05
Old Benji: posts big blind $0.10
togl63amg: posts the ante $0.02
Old Benji: posts the ante $0.02
ReKych: posts the ante $0.02
DDarks: posts the ante $0.02
Paker 3: posts the ante $0.02
ale9030: posts the ante $0.02
*** HOLE CARDS ***
ReKych: folds 
DDarks: raises $0.40 to $0.50
Paker 3: folds 
ale9030: folds 
togl63amg: folds 
Old Benji: folds 
Uncalled bet ($0.40) returned to DDarks
DDarks collected $0.37 from pot
DDarks: doesn't show hand 
*** SUMMARY ***
Total pot $0.37 | Rake $0 
Seat 1: togl63amg (small blind) folded before Flop
Seat 2: Old Benji (big blind) folded before Flop
Seat 3: ReKych folded before Flop (didn't bet)
Seat 4: DDarks collected ($0.37)
Seat 5: Paker 3 folded before Flop (didn't bet)
Seat 6: ale9030 (button) folded before Flop (didn't bet)



PokerStars Hand #201509018937:  Hold'em No Limit ($0.05/$0.10 USD) - 2019/06/18 11:15:46 ET
Table 'Moreau III' 6-max Seat #3 is the button
Seat 1: togl63amg ($19.31 in chips) 
Seat 3: ReKych ($15.28 in chips) 
Seat 4: DDarks ($14.87 in chips) 
Seat 5: Paker 3 ($23.14 in chips) 
Seat 6: ale9030 ($12.21 in chips) 
DDarks: posts small blind $0.05
Paker 3: posts big blind $0.10
togl63amg: posts the ante $0.02
ReKych: posts the ante $0.02
DDarks: posts the ante $0.02
Paker 3: posts the ante $0.02
ale9030: posts the ante $0.02
*** HOLE CARDS ***
ale9030: folds 
togl63amg: folds 
ReKych: folds 
DDarks: raises $0.10 to $0.20
Paker 3: calls $0.10
*** FLOP *** [6c 5s 7s]
DDarks: bets $0.20
Paker 3: raises $0.20 to $0.40
DDarks: calls $0.20
*** TURN *** [6c 5s 7s] [9c]
DDarks: bets $1
Paker 3: calls $1
*** RIVER *** [6c 5s 7s 9c] [8d]
DDarks: bets $13.25 and is all-in
Paker 3: folds 
Uncalled bet ($13.25) returned to DDarks
DDarks collected $3.15 from pot
DDarks: doesn't show hand 
*** SUMMARY ***
Total pot $3.30 | Rake $0.15 
Board [6c 5s 7s 9c 8d]
Seat 1: togl63amg folded before Flop (didn't bet)
Seat 3: ReKych (button) folded before Flop (didn't bet)
Seat 4: DDarks (small blind) collected ($3.15)
Seat 5: Paker 3 (big blind) folded on the River
Seat 6: ale9030 folded before Flop (didn't bet)



PokerStars Hand #201509050980:  Hold'em No Limit ($0.05/$0.10 USD) - 2019/06/18 11:17:02 ET
Table 'Moreau III' 6-max Seat #4 is the button
Seat 1: togl63amg ($19.29 in chips) 
Seat 3: ReKych ($15.26 in chips) 
Seat 4: DDarks ($16.40 in chips) 
Seat 5: Paker 3 ($21.52 in chips) 
Seat 6: ale9030 ($12.19 in chips) 
Paker 3: posts small blind $0.05
ale9030: posts big blind $0.10
togl63amg: posts the ante $0.02
ReKych: posts the ante $0.02
DDarks: posts the ante $0.02
Paker 3: posts the ante $0.02
ale9030: posts the ante $0.02
*** HOLE CARDS ***
togl63amg: folds 
ReKych: raises $0.20 to $0.30
DDarks: calls $0.30
Paker 3: calls $0.25
ale9030: folds 
*** FLOP *** [5s Qs Kh]
Paker 3: checks 
ReKych: checks 
DDarks: checks 
*** TURN *** [5s Qs Kh] [4s]
Paker 3: checks 
ReKych: checks 
DDarks: bets $0.50
Paker 3: calls $0.50
ReKych: folds 
*** RIVER *** [5s Qs Kh 4s] [2d]
Paker 3: checks 
DDarks: checks 
*** SHOW DOWN ***
Paker 3: shows [6s Ks] (a flush, King high)
DDarks: mucks hand 
Paker 3 collected $2.01 from pot
*** SUMMARY ***
Total pot $2.10 | Rake $0.09 
Board [5s Qs Kh 4s 2d]
Seat 1: togl63amg folded before Flop (didn't bet)
Seat 3: ReKych folded on the Turn
Seat 4: DDarks (button) mucked
Seat 5: Paker 3 (small blind) showed [6s Ks] and won ($2.01) with a flush, King high
Seat 6: ale9030 (big blind) folded before Flop



PokerStars Hand #201509074068:  Hold'em No Limit ($0.05/$0.10 USD) - 2019/06/18 11:17:55 ET
Table 'Moreau III' 6-max Seat #5 is the button
Seat 1: togl63amg ($19.27 in chips) 
Seat 3: ReKych ($14.94 in chips) 
Seat 4: DDarks ($15.58 in chips) 
Seat 5: Paker 3 ($22.71 in chips) 
Seat 6: ale9030 ($12.07 in chips) 
ale9030: posts small blind $0.05
togl63amg: posts big blind $0.10
togl63amg: posts the ante $0.02
ReKych: posts the ante $0.02
DDarks: posts the ante $0.02
Paker 3: posts the ante $0.02
ale9030: posts the ante $0.02
*** HOLE CARDS ***
ReKych: folds 
DDarks: calls $0.10
Paker 3: folds 
ale9030: folds 
togl63amg: raises $0.40 to $0.50
DDarks: calls $0.40
*** FLOP *** [Th 2c 4s]
togl63amg: checks 
DDarks: checks 
*** TURN *** [Th 2c 4s] [Jd]
togl63amg: bets $0.70
DDarks: folds 
Uncalled bet ($0.70) returned to togl63amg
togl63amg collected $1.10 from pot
*** SUMMARY ***
Total pot $1.15 | Rake $0.05 
Board [Th 2c 4s Jd]
Seat 1: togl63amg (big blind) collected ($1.10)
Seat 3: ReKych folded before Flop (didn't bet)
Seat 4: DDarks folded on the Turn
Seat 5: Paker 3 (button) folded before Flop (didn't bet)
Seat 6: ale9030 (small blind) folded before Flop



PokerStars Hand #201509089082:  Hold'em No Limit ($0.05/$0.10 USD) - 2019/06/18 11:18:29 ET
Table 'Moreau III' 6-max Seat #6 is the button
Seat 1: togl63amg ($19.85 in chips) 
Seat 3: ReKych ($14.92 in chips) 
Seat 4: DDarks ($15.06 in chips) 
Seat 5: Paker 3 ($22.69 in chips) 
Seat 6: ale9030 ($12 in chips) 
togl63amg: posts small blind $0.05
ReKych: posts big blind $0.10
togl63amg: posts the ante $0.02
ReKych: posts the ante $0.02
DDarks: posts the ante $0.02
Paker 3: posts the ante $0.02
ale9030: posts the ante $0.02
*** HOLE CARDS ***
DDarks: folds 
Paker 3: raises $0.10 to $0.20
Old Benji joins the table at seat #2 
ale9030: folds 
togl63amg: folds 
ReKych: calls $0.10
*** FLOP *** [7h Js 5d]
ReKych: checks 
Paker 3: checks 
*** TURN *** [7h Js 5d] [Td]
ReKych: bets $0.53
Paker 3: calls $0.53
*** RIVER *** [7h Js 5d Td] [2c]
ReKych: bets $2.50
Paker 3: folds 
Uncalled bet ($2.50) returned to ReKych
ReKych collected $1.54 from pot
ReKych: doesn't show hand 
*** SUMMARY ***
Total pot $1.61 | Rake $0.07 
Board [7h Js 5d Td 2c]
Seat 1: togl63amg (small blind) folded before Flop
Seat 3: ReKych (big blind) collected ($1.54)
Seat 4: DDarks folded before Flop (didn't bet)
Seat 5: Paker 3 folded on the River
Seat 6: ale9030 (button) folded before Flop (didn't bet)



PokerStars Hand #201509104613:  Hold'em No Limit ($0.05/$0.10 USD) - 2019/06/18 11:19:05 ET
Table 'Moreau III' 6-max Seat #1 is the button
Seat 1: togl63amg ($19.78 in chips) 
Seat 3: ReKych ($15.71 in chips) 
Seat 4: DDarks ($15.04 in chips) 
Seat 5: Paker 3 ($21.94 in chips) 
Seat 6: ale9030 ($11.98 in chips) 
ReKych: posts small blind $0.05
DDarks: posts big blind $0.10
togl63amg: posts the ante $0.02
ReKych: posts the ante $0.02
DDarks: posts the ante $0.02
Paker 3: posts the ante $0.02
ale9030: posts the ante $0.02
*** HOLE CARDS ***
Paker 3: folds 
ale9030: folds 
togl63amg: folds 
ReKych: folds 
Uncalled bet ($0.05) returned to DDarks
DDarks collected $0.20 from pot
DDarks: doesn't show hand 
*** SUMMARY ***
Total pot $0.20 | Rake $0 
Seat 1: togl63amg (button) folded before Flop (didn't bet)
Seat 3: ReKych (small blind) folded before Flop
Seat 4: DDarks (big blind) collected ($0.20)
Seat 5: Paker 3 folded before Flop (didn't bet)
Seat 6: ale9030 folded before Flop (didn't bet)



PokerStars Hand #201509110224:  Hold'em No Limit ($0.05/$0.10 USD) - 2019/06/18 11:19:18 ET
Table 'Moreau III' 6-max Seat #3 is the button
Seat 1: togl63amg ($19.76 in chips) 
Seat 3: ReKych ($15.64 in chips) 
Seat 4: DDarks ($15.17 in chips) 
Seat 5: Paker 3 ($21.92 in chips) 
Seat 6: ale9030 ($11.96 in chips) 
DDarks: posts small blind $0.05
Paker 3: posts big blind $0.10
Old Benji: sits out 
togl63amg: posts the ante $0.02
ReKych: posts the ante $0.02
DDarks: posts the ante $0.02
Paker 3: posts the ante $0.02
ale9030: posts the ante $0.02
*** HOLE CARDS ***
ale9030: folds 
togl63amg: folds 
ReKych: folds 
DDarks: calls $0.05
Paker 3: checks 
*** FLOP *** [Qh 3h Qc]
DDarks: checks 
Paker 3: checks 
*** TURN *** [Qh 3h Qc] [Td]
DDarks: bets $0.50
Paker 3: folds 
Uncalled bet ($0.50) returned to DDarks
DDarks collected $0.29 from pot
DDarks: doesn't show hand 
*** SUMMARY ***
Total pot $0.30 | Rake $0.01 
Board [Qh 3h Qc Td]
Seat 1: togl63amg folded before Flop (didn't bet)
Seat 3: ReKych (button) folded before Flop (didn't bet)
Seat 4: DDarks (small blind) collected ($0.29)
Seat 5: Paker 3 (big blind) folded on the Turn
Seat 6: ale9030 folded before Flop (didn't bet)



PokerStars Hand #201509123722:  Hold'em No Limit ($0.05/$0.10 USD) - 2019/06/18 11:19:49 ET
Table 'Moreau III' 6-max Seat #4 is the button
Seat 1: togl63amg ($19.74 in chips) 
Seat 2: Old Benji ($10 in chips) 
Seat 3: ReKych ($15.62 in chips) 
Seat 4: DDarks ($15.34 in chips) 
Seat 5: Paker 3 ($21.80 in chips) 
Seat 6: ale9030 ($11.94 in chips) 
Paker 3: posts small blind $0.05
ale9030: posts big blind $0.10
Old Benji: posts big blind $0.10
togl63amg: posts the ante $0.02
Old Benji: posts the ante $0.02
ReKych: posts the ante $0.02
DDarks: posts the ante $0.02
Paker 3: posts the ante $0.02
ale9030: posts the ante $0.02
*** HOLE CARDS ***
togl63amg: raises $0.47 to $0.57
Old Benji: folds 
ReKych: calls $0.57
DDarks: calls $0.57
Paker 3: calls $0.52
ale9030: folds 
*** FLOP *** [8s 4d 8c]
Paker 3: checks 
togl63amg: checks 
ReKych: checks 
DDarks: checks 
*** TURN *** [8s 4d 8c] [Tc]
Paker 3: checks 
togl63amg: checks 
ReKych: bets $1.60
DDarks: folds 
Paker 3: calls $1.60
togl63amg: calls $1.60
*** RIVER *** [8s 4d 8c Tc] [2c]
Paker 3: checks 
togl63amg: bets $2.33
ReKych: folds 
Paker 3: folds 
Uncalled bet ($2.33) returned to togl63amg
togl63amg collected $7.07 from pot
*** SUMMARY ***
Total pot $7.40 | Rake $0.33 
Board [8s 4d 8c Tc 2c]
Seat 1: togl63amg collected ($7.07)
Seat 2: Old Benji folded before Flop (didn't bet)
Seat 3: ReKych folded on the River
Seat 4: DDarks (button) folded on the Turn
Seat 5: Paker 3 (small blind) folded on the River
Seat 6: ale9030 (big blind) folded before Flop



PokerStars Hand #201509287443:  Hold'em No Limit ($0.05/$0.10 USD) - 2019/06/18 11:26:08 ET
Table 'Moreau III' 6-max Seat #1 is the button
Seat 1: togl63amg ($17.34 in chips) 
Seat 2: Old Benji ($9.58 in chips) 
Seat 3: ReKych ($13.74 in chips) 
Seat 4: DDarks ($22.36 in chips) 
Seat 5: Paker 3 ($18.57 in chips) 
Seat 6: ale9030 ($11.73 in chips) 
Old Benji: posts small blind $0.05
ReKych: posts big blind $0.10
togl63amg: posts the ante $0.02
Old Benji: posts the ante $0.02
ReKych: posts the ante $0.02
DDarks: posts the ante $0.02
Paker 3: posts the ante $0.02
ale9030: posts the ante $0.02
*** HOLE CARDS ***
DDarks: raises $0.10 to $0.20
Paker 3: folds 
ale9030: folds 
togl63amg: folds 
Old Benji: calls $0.15
ReKych: calls $0.10
*** FLOP *** [8h 3h 6h]
Old Benji: checks 
ReKych: checks 
DDarks: checks 
*** TURN *** [8h 3h 6h] [7d]
Old Benji: checks 
ReKych: checks 
DDarks: checks 
*** RIVER *** [8h 3h 6h 7d] [5c]
Old Benji: bets $0.35
ReKych: folds 
DDarks: raises $21.79 to $22.14 and is all-in
Old Benji: folds 
Uncalled bet ($21.79) returned to DDarks
DDarks collected $1.36 from pot
DDarks: doesn't show hand 
*** SUMMARY ***
Total pot $1.42 | Rake $0.06 
Board [8h 3h 6h 7d 5c]
Seat 1: togl63amg (button) folded before Flop (didn't bet)
Seat 2: Old Benji (small blind) folded on the River
Seat 3: ReKych (big blind) folded on the River
Seat 4: DDarks collected ($1.36)
Seat 5: Paker 3 folded before Flop (didn't bet)
Seat 6: ale9030 folded before Flop (didn't bet)



PokerStars Hand #201509313237:  Hold'em No Limit ($0.05/$0.10 USD) - 2019/06/18 11:27:08 ET
Table 'Moreau III' 6-max Seat #2 is the button
Seat 1: togl63amg ($17.32 in chips) 
Seat 2: Old Benji ($9.01 in chips) 
Seat 3: ReKych ($13.52 in chips) 
Seat 4: DDarks ($23.15 in chips) 
Seat 5: Paker 3 ($18.55 in chips) 
Seat 6: ale9030 ($11.71 in chips) 
ReKych: posts small blind $0.05
DDarks: posts big blind $0.10
togl63amg: posts the ante $0.02
Old Benji: posts the ante $0.02
ReKych: posts the ante $0.02
DDarks: posts the ante $0.02
Paker 3: posts the ante $0.02
ale9030: posts the ante $0.02
*** HOLE CARDS ***
Paker 3: raises $0.10 to $0.20
ale9030: folds 
togl63amg: calls $0.20
Old Benji: folds 
ReKych: folds 
DDarks: calls $0.10
*** FLOP *** [As Kh 5h]
DDarks: checks 
Paker 3: checks 
togl63amg: bets $0.41
DDarks: folds 
Paker 3: calls $0.41
*** TURN *** [As Kh 5h] [3d]
Paker 3: checks 
togl63amg: bets $0.85
Paker 3: calls $0.85
*** RIVER *** [As Kh 5h 3d] [8h]
Paker 3: bets $2.10
togl63amg: calls $2.10
*** SHOW DOWN ***
Paker 3: shows [Qc Qd] (a pair of Queens)
togl63amg: shows [Ah 7c] (a pair of Aces)
togl63amg collected $7.15 from pot
*** SUMMARY ***
Total pot $7.49 | Rake $0.34 
Board [As Kh 5h 3d 8h]
Seat 1: togl63amg showed [Ah 7c] and won ($7.15) with a pair of Aces
Seat 2: Old Benji (button) folded before Flop (didn't bet)
Seat 3: ReKych (small blind) folded before Flop
Seat 4: DDarks (big blind) folded on the Flop
Seat 5: Paker 3 showed [Qc Qd] and lost with a pair of Queens
Seat 6: ale9030 folded before Flop (didn't bet)



PokerStars Hand #201509335185:  Hold'em No Limit ($0.05/$0.10 USD) - 2019/06/18 11:27:59 ET
Table 'Moreau III' 6-max Seat #3 is the button
Seat 1: togl63amg ($20.89 in chips) 
Seat 2: Old Benji ($8.99 in chips) 
Seat 3: ReKych ($13.45 in chips) 
Seat 4: DDarks ($22.93 in chips) 
Seat 5: Paker 3 ($14.97 in chips) 
Seat 6: ale9030 ($11.69 in chips) 
DDarks: posts small blind $0.05
Paker 3: posts big blind $0.10
togl63amg: posts the ante $0.02
Old Benji: posts the ante $0.02
ReKych: posts the ante $0.02
DDarks: posts the ante $0.02
Paker 3: posts the ante $0.02
ale9030: posts the ante $0.02
*** HOLE CARDS ***
ale9030: folds 
togl63amg: folds 
Old Benji: folds 
ReKych: folds 
DDarks: calls $0.05
Paker 3: checks 
*** FLOP *** [Qs 9d Ts]
DDarks: bets $0.50
Paker 3: raises $0.75 to $1.25
DDarks: calls $0.75
*** TURN *** [Qs 9d Ts] [Kc]
DDarks: checks 
Paker 3: checks 
*** RIVER *** [Qs 9d Ts Kc] [3c]
DDarks: bets $1
Paker 3: calls $1
*** SHOW DOWN ***
DDarks: shows [4c Td] (a pair of Tens)
Paker 3: shows [Qc 9c] (two pair, Queens and Nines)
Paker 3 collected $4.60 from pot
*** SUMMARY ***
Total pot $4.82 | Rake $0.22 
Board [Qs 9d Ts Kc 3c]
Seat 1: togl63amg folded before Flop (didn't bet)
Seat 2: Old Benji folded before Flop (didn't bet)
Seat 3: ReKych (button) folded before Flop (didn't bet)
Seat 4: DDarks (small blind) showed [4c Td] and lost with a pair of Tens
Seat 5: Paker 3 (big blind) showed [Qc 9c] and won ($4.60) with two pair, Queens and Nines
Seat 6: ale9030 folded before Flop (didn't bet)



PokerStars Hand #201509354862:  Hold'em No Limit ($0.05/$0.10 USD) - 2019/06/18 11:28:44 ET
Table 'Moreau III' 6-max Seat #4 is the button
Seat 1: togl63amg ($20.87 in chips) 
Seat 2: Old Benji ($8.97 in chips) 
Seat 3: ReKych ($13.43 in chips) 
Seat 4: DDarks ($20.56 in chips) 
Seat 5: Paker 3 ($17.20 in chips) 
Seat 6: ale9030 ($11.67 in chips) 
Paker 3: posts small blind $0.05
ale9030: posts big blind $0.10
togl63amg: posts the ante $0.02
Old Benji: posts the ante $0.02
ReKych: posts the ante $0.02
DDarks: posts the ante $0.02
Paker 3: posts the ante $0.02
ale9030: posts the ante $0.02
*** HOLE CARDS ***
togl63amg: folds 
Old Benji: folds 
ReKych: folds 
DDarks: raises $0.10 to $0.20
Paker 3: calls $0.15
ale9030: folds 
*** FLOP *** [2d 4h 5s]
Paker 3: bets $0.30
DDarks: calls $0.30
*** TURN *** [2d 4h 5s] [7s]
Paker 3: bets $0.59
DDarks: folds 
Uncalled bet ($0.59) returned to Paker 3
Paker 3 collected $1.17 from pot
*** SUMMARY ***
Total pot $1.22 | Rake $0.05 
Board [2d 4h 5s 7s]
Seat 1: togl63amg folded before Flop (didn't bet)
Seat 2: Old Benji folded before Flop (didn't bet)
Seat 3: ReKych folded before Flop (didn't bet)
Seat 4: DDarks (button) folded on the Turn
Seat 5: Paker 3 (small blind) collected ($1.17)
Seat 6: ale9030 (big blind) folded before Flop



PokerStars Hand #201509367699:  Hold'em No Limit ($0.05/$0.10 USD) - 2019/06/18 11:29:13 ET
Table 'Moreau III' 6-max Seat #5 is the button
Seat 1: togl63amg ($20.85 in chips) 
Seat 2: Old Benji ($8.95 in chips) 
Seat 3: ReKych ($13.41 in chips) 
Seat 4: DDarks ($20.04 in chips) 
Seat 5: Paker 3 ($17.85 in chips) 
Seat 6: ale9030 ($11.55 in chips) 
ale9030: posts small blind $0.05
togl63amg: posts big blind $0.10
togl63amg: posts the ante $0.02
Old Benji: posts the ante $0.02
ReKych: posts the ante $0.02
DDarks: posts the ante $0.02
Paker 3: posts the ante $0.02
ale9030: posts the ante $0.02
*** HOLE CARDS ***
Old Benji: folds 
ReKych: folds 
DDarks: folds 
Paker 3: raises $0.15 to $0.25
ale9030: folds 
togl63amg: calls $0.15
*** FLOP *** [8s 5s Qh]
togl63amg: checks 
Paker 3: bets $0.32
togl63amg: folds 
Uncalled bet ($0.32) returned to Paker 3
Paker 3 collected $0.64 from pot
*** SUMMARY ***
Total pot $0.67 | Rake $0.03 
Board [8s 5s Qh]
Seat 1: togl63amg (big blind) folded on the Flop
Seat 2: Old Benji folded before Flop (didn't bet)
Seat 3: ReKych folded before Flop (didn't bet)
Seat 4: DDarks folded before Flop (didn't bet)
Seat 5: Paker 3 (button) collected ($0.64)
Seat 6: ale9030 (small blind) folded before Flop



PokerStars Hand #201509385999:  Hold'em No Limit ($0.05/$0.10 USD) - 2019/06/18 11:29:56 ET
Table 'Moreau III' 6-max Seat #6 is the button
Seat 1: togl63amg ($20.58 in chips) 
Seat 2: Old Benji ($8.93 in chips) 
Seat 3: ReKych ($13.39 in chips) 
Seat 4: DDarks ($20.02 in chips) 
Seat 5: Paker 3 ($18.22 in chips) 
Seat 6: ale9030 ($11.48 in chips) 
togl63amg: posts small blind $0.05
Old Benji: posts big blind $0.10
togl63amg: posts the ante $0.02
Old Benji: posts the ante $0.02
ReKych: posts the ante $0.02
DDarks: posts the ante $0.02
Paker 3: posts the ante $0.02
ale9030: posts the ante $0.02
*** HOLE CARDS ***
ReKych: raises $0.25 to $0.35
DDarks: folds 
Paker 3: folds 
ale9030: folds 
togl63amg: calls $0.30
Old Benji: folds 
*** FLOP *** [Jd 2s Qd]
togl63amg: checks 
ReKych: checks 
*** TURN *** [Jd 2s Qd] [8s]
togl63amg: checks 
ReKych: checks 
*** RIVER *** [Jd 2s Qd 8s] [Qc]
togl63amg: checks 
ReKych: checks 
*** SHOW DOWN ***
togl63amg: shows [5h 6h] (a pair of Queens)
ReKych: shows [3s 3h] (two pair, Queens and Threes)
ReKych collected $0.88 from pot
*** SUMMARY ***
Total pot $0.92 | Rake $0.04 
Board [Jd 2s Qd 8s Qc]
Seat 1: togl63amg (small blind) showed [5h 6h] and lost with a pair of Queens
Seat 2: Old Benji (big blind) folded before Flop
Seat 3: ReKych showed [3s 3h] and won ($0.88) with two pair, Queens and Threes
Seat 4: DDarks folded before Flop (didn't bet)
Seat 5: Paker 3 folded before Flop (didn't bet)
Seat 6: ale9030 (button) folded before Flop (didn't bet)



PokerStars Hand #201509525171:  Hold'em No Limit ($0.05/$0.10 USD) - 2019/06/18 11:35:16 ET
Table 'Moreau III' 6-max Seat #6 is the button
Seat 1: togl63amg ($19.78 in chips) 
Seat 2: Old Benji ($8.06 in chips) 
Seat 3: ReKych ($12.40 in chips) 
Seat 4: DDarks ($22.54 in chips) 
Seat 5: Paker 3 ($16.97 in chips) 
Seat 6: ale9030 ($12.50 in chips) 
togl63amg: posts small blind $0.05
Old Benji: posts big blind $0.10
togl63amg: posts the ante $0.02
Old Benji: posts the ante $0.02
ReKych: posts the ante $0.02
DDarks: posts the ante $0.02
Paker 3: posts the ante $0.02
ale9030: posts the ante $0.02
*** HOLE CARDS ***
ReKych: raises $0.20 to $0.30
DDarks: calls $0.30
Paker 3: raises $0.60 to $0.90
ale9030: folds 
togl63amg: folds 
Old Benji: folds 
ReKych: calls $0.60
DDarks: calls $0.60
*** FLOP *** [4c 3s 4h]
ReKych: checks 
DDarks: checks 
Paker 3: bets $1.78
ReKych: folds 
DDarks: folds 
Uncalled bet ($1.78) returned to Paker 3
Paker 3 collected $2.84 from pot
*** SUMMARY ***
Total pot $2.97 | Rake $0.13 
Board [4c 3s 4h]
Seat 1: togl63amg (small blind) folded before Flop
Seat 2: Old Benji (big blind) folded before Flop
Seat 3: ReKych folded on the Flop
Seat 4: DDarks folded on the Flop
Seat 5: Paker 3 collected ($2.84)
Seat 6: ale9030 (button) folded before Flop (didn't bet)



PokerStars Hand #201509558856:  Hold'em No Limit ($0.05/$0.10 USD) - 2019/06/18 11:36:24 ET
Table 'Moreau III' 6-max Seat #1 is the button
Seat 1: togl63amg ($19.71 in chips) 
Seat 2: Old Benji ($7.94 in chips) 
Seat 3: ReKych ($11.48 in chips) 
Seat 4: DDarks ($21.62 in chips) 
Seat 5: Paker 3 ($18.89 in chips) 
Seat 6: ale9030 ($12.48 in chips) 
Old Benji: posts small blind $0.05
ReKych: posts big blind $0.10
togl63amg: posts the ante $0.02
Old Benji: posts the ante $0.02
ReKych: posts the ante $0.02
DDarks: posts the ante $0.02
Paker 3: posts the ante $0.02
ale9030: posts the ante $0.02
*** HOLE CARDS ***
DDarks: folds 
Paker 3: folds 
ale9030: folds 
togl63amg: raises $0.20 to $0.30
Old Benji: folds 
ReKych: folds 
Uncalled bet ($0.20) returned to togl63amg
togl63amg collected $0.37 from pot
*** SUMMARY ***
Total pot $0.37 | Rake $0 
Seat 1: togl63amg (button) collected ($0.37)
Seat 2: Old Benji (small blind) folded before Flop
Seat 3: ReKych (big blind) folded before Flop
Seat 4: DDarks folded before Flop (didn't bet)
Seat 5: Paker 3 folded before Flop (didn't bet)
Seat 6: ale9030 folded before Flop (didn't bet)



PokerStars Hand #201509568236:  Hold'em No Limit ($0.05/$0.10 USD) - 2019/06/18 11:36:46 ET
Table 'Moreau III' 6-max Seat #2 is the button
Seat 1: togl63amg ($19.96 in chips) 
Seat 2: Old Benji ($7.87 in chips) 
Seat 3: ReKych ($11.36 in chips) 
Seat 4: DDarks ($21.60 in chips) 
Seat 5: Paker 3 ($18.87 in chips) 
Seat 6: ale9030 ($12.46 in chips) 
ReKych: posts small blind $0.05
DDarks: posts big blind $0.10
togl63amg: posts the ante $0.02
Old Benji: posts the ante $0.02
ReKych: posts the ante $0.02
DDarks: posts the ante $0.02
Paker 3: posts the ante $0.02
ale9030: posts the ante $0.02
*** HOLE CARDS ***
Paker 3: folds 
ale9030: folds 
togl63amg: folds 
Old Benji: folds 
ReKych: raises $0.20 to $0.30
DDarks: calls $0.20
*** FLOP *** [Ah 7d Ad]
ReKych: checks 
DDarks: bets $1
ReKych: folds 
Uncalled bet ($1) returned to DDarks
DDarks collected $0.69 from pot
DDarks: doesn't show hand 
*** SUMMARY ***
Total pot $0.72 | Rake $0.03 
Board [Ah 7d Ad]
Seat 1: togl63amg folded before Flop (didn't bet)
Seat 2: Old Benji (button) folded before Flop (didn't bet)
Seat 3: ReKych (small blind) folded on the Flop
Seat 4: DDarks (big blind) collected ($0.69)
Seat 5: Paker 3 folded before Flop (didn't bet)
Seat 6: ale9030 folded before Flop (didn't bet)



PokerStars Hand #201509587882:  Hold'em No Limit ($0.05/$0.10 USD) - 2019/06/18 11:37:31 ET
Table 'Moreau III' 6-max Seat #3 is the button
Seat 1: togl63amg ($19.94 in chips) 
Seat 2: Old Benji ($7.85 in chips) 
Seat 3: ReKych ($11.04 in chips) 
Seat 4: DDarks ($21.97 in chips) 
Seat 5: Paker 3 ($18.85 in chips) 
Seat 6: ale9030 ($12.44 in chips) 
DDarks: posts small blind $0.05
Paker 3: posts big blind $0.10
togl63amg: posts the ante $0.02
Old Benji: posts the ante $0.02
ReKych: posts the ante $0.02
DDarks: posts the ante $0.02
Paker 3: posts the ante $0.02
ale9030: posts the ante $0.02
*** HOLE CARDS ***
ale9030: folds 
togl63amg: raises $0.20 to $0.30
Old Benji: folds 
ReKych: folds 
DDarks: calls $0.25
Paker 3: folds 
*** FLOP *** [7d 7s 8c]
DDarks: checks 
togl63amg: checks 
*** TURN *** [7d 7s 8c] [Kd]
DDarks: bets $0.50
togl63amg: folds 
Uncalled bet ($0.50) returned to DDarks
DDarks collected $0.78 from pot
DDarks: doesn't show hand 
*** SUMMARY ***
Total pot $0.82 | Rake $0.04 
Board [7d 7s 8c Kd]
Seat 1: togl63amg folded on the Turn
Seat 2: Old Benji folded before Flop (didn't bet)
Seat 3: ReKych (button) folded before Flop (didn't bet)
Seat 4: DDarks (small blind) collected ($0.78)
Seat 5: Paker 3 (big blind) folded before Flop
Seat 6: ale9030 folded before Flop (didn't bet)



PokerStars Hand #201509613586:  Hold'em No Limit ($0.05/$0.10 USD) - 2019/06/18 11:38:30 ET
Table 'Moreau III' 6-max Seat #4 is the button
Seat 1: togl63amg ($19.62 in chips) 
Seat 2: Old Benji ($7.83 in chips) 
Seat 3: ReKych ($11.02 in chips) 
Seat 4: DDarks ($22.43 in chips) 
Seat 5: Paker 3 ($18.73 in chips) 
Seat 6: ale9030 ($12.42 in chips) 
Paker 3: posts small blind $0.05
ale9030: posts big blind $0.10
togl63amg: posts the ante $0.02
Old Benji: posts the ante $0.02
ReKych: posts the ante $0.02
DDarks: posts the ante $0.02
Paker 3: posts the ante $0.02
ale9030: posts the ante $0.02
*** HOLE CARDS ***
togl63amg: raises $0.20 to $0.30
Old Benji: folds 
ReKych: folds 
DDarks: raises $0.20 to $0.50
Paker 3: folds 
ale9030: folds 
togl63amg: calls $0.20
*** FLOP *** [5s 8d 8h]
togl63amg: checks 
DDarks: bets $0.50
togl63amg: folds 
Uncalled bet ($0.50) returned to DDarks
DDarks collected $1.21 from pot
DDarks: doesn't show hand 
*** SUMMARY ***
Total pot $1.27 | Rake $0.06 
Board [5s 8d 8h]
Seat 1: togl63amg folded on the Flop
Seat 2: Old Benji folded before Flop (didn't bet)
Seat 3: ReKych folded before Flop (didn't bet)
Seat 4: DDarks (button) collected ($1.21)
Seat 5: Paker 3 (small blind) folded before Flop
Seat 6: ale9030 (big blind) folded before Flop



PokerStars Hand #201509629702:  Hold'em No Limit ($0.05/$0.10 USD) - 2019/06/18 11:39:06 ET
Table 'Moreau III' 6-max Seat #5 is the button
Seat 1: togl63amg ($19.10 in chips) 
Seat 2: Old Benji ($7.81 in chips) 
Seat 3: ReKych ($11 in chips) 
Seat 4: DDarks ($23.12 in chips) 
Seat 5: Paker 3 ($18.66 in chips) 
Seat 6: ale9030 ($12.30 in chips) 
ale9030: posts small blind $0.05
togl63amg: posts big blind $0.10
togl63amg: posts the ante $0.02
Old Benji: posts the ante $0.02
ReKych: posts the ante $0.02
DDarks: posts the ante $0.02
Paker 3: posts the ante $0.02
ale9030: posts the ante $0.02
*** HOLE CARDS ***
Old Benji: folds 
ReKych: folds 
DDarks: folds 
Paker 3: folds 
ale9030: raises $0.20 to $0.30
togl63amg: raises $0.60 to $0.90
ale9030: folds 
Uncalled bet ($0.60) returned to togl63amg
togl63amg collected $0.72 from pot
*** SUMMARY ***
Total pot $0.72 | Rake $0 
Seat 1: togl63amg (big blind) collected ($0.72)
Seat 2: Old Benji folded before Flop (didn't bet)
Seat 3: ReKych folded before Flop (didn't bet)
Seat 4: DDarks folded before Flop (didn't bet)
Seat 5: Paker 3 (button) folded before Flop (didn't bet)
Seat 6: ale9030 (small blind) folded before Flop



PokerStars Hand #201509650407:  Hold'em No Limit ($0.05/$0.10 USD) - 2019/06/18 11:39:54 ET
Table 'Moreau III' 6-max Seat #6 is the button
Seat 1: togl63amg ($19.50 in chips) 
Seat 2: Old Benji ($7.79 in chips) 
Seat 3: ReKych ($10.98 in chips) 
Seat 4: DDarks ($23.10 in chips) 
Seat 5: Paker 3 ($18.64 in chips) 
Seat 6: ale9030 ($11.98 in chips) 
togl63amg: posts small blind $0.05
Old Benji: posts big blind $0.10
togl63amg: posts the ante $0.02
Old Benji: posts the ante $0.02
ReKych: posts the ante $0.02
DDarks: posts the ante $0.02
Paker 3: posts the ante $0.02
ale9030: posts the ante $0.02
*** HOLE CARDS ***
ReKych: folds 
DDarks: folds 
Paker 3: raises $0.12 to $0.22
ale9030: folds 
togl63amg: folds 
Old Benji: calls $0.12
*** FLOP *** [9s 5d 6c]
Old Benji: checks 
Paker 3: bets $0.44
Old Benji: calls $0.44
*** TURN *** [9s 5d 6c] [Jd]
Old Benji: checks 
Paker 3: bets $0.33
Old Benji: calls $0.33
*** RIVER *** [9s 5d 6c Jd] [4s]
Old Benji: bets $1.03
Paker 3: calls $1.03
*** SHOW DOWN ***
Old Benji: shows [Jc Qc] (a pair of Jacks)
Paker 3: mucks hand 
Old Benji collected $4.02 from pot
*** SUMMARY ***
Total pot $4.21 | Rake $0.19 
Board [9s 5d 6c Jd 4s]
Seat 1: togl63amg (small blind) folded before Flop
Seat 2: Old Benji (big blind) showed [Jc Qc] and won ($4.02) with a pair of Jacks
Seat 3: ReKych folded before Flop (didn't bet)
Seat 4: DDarks folded before Flop (didn't bet)
Seat 5: Paker 3 mucked
Seat 6: ale9030 (button) folded before Flop (didn't bet)



PokerStars Hand #201509680047:  Hold'em No Limit ($0.05/$0.10 USD) - 2019/06/18 11:41:02 ET
Table 'Moreau III' 6-max Seat #1 is the button
Seat 1: togl63amg ($19.43 in chips) 
Seat 2: Old Benji ($9.77 in chips) 
Seat 3: ReKych ($10.96 in chips) 
Seat 4: DDarks ($23.08 in chips) 
Seat 5: Paker 3 ($16.60 in chips) 
Seat 6: ale9030 ($11.96 in chips) 
Old Benji: posts small blind $0.05
ReKych: posts big blind $0.10
togl63amg: posts the ante $0.02
Old Benji: posts the ante $0.02
ReKych: posts the ante $0.02
DDarks: posts the ante $0.02
Paker 3: posts the ante $0.02
ale9030: posts the ante $0.02
*** HOLE CARDS ***
DDarks: folds 
Paker 3: folds 
ale9030: folds 
togl63amg: folds 
Old Benji: folds 
Uncalled bet ($0.05) returned to ReKych
ReKych collected $0.22 from pot
ReKych: doesn't show hand 
*** SUMMARY ***
Total pot $0.22 | Rake $0 
Seat 1: togl63amg (button) folded before Flop (didn't bet)
Seat 2: Old Benji (small blind) folded before Flop
Seat 3: ReKych (big blind) collected ($0.22)
Seat 4: DDarks folded before Flop (didn't bet)
Seat 5: Paker 3 folded before Flop (didn't bet)
Seat 6: ale9030 folded before Flop (didn't bet)



PokerStars Hand #201509416271:  Hold'em No Limit ($0.05/$0.10 USD) - 2019/06/18 11:31:06 ET
Table 'Moreau III' 6-max Seat #1 is the button
Seat 1: togl63amg ($20.21 in chips) 
Seat 2: Old Benji ($8.81 in chips) 
Seat 3: ReKych ($13.90 in chips) 
Seat 4: DDarks ($20 in chips) 
Seat 5: Paker 3 ($18.20 in chips) 
Seat 6: ale9030 ($11.46 in chips) 
Old Benji: posts small blind $0.05
ReKych: posts big blind $0.10
togl63amg: posts the ante $0.02
Old Benji: posts the ante $0.02
ReKych: posts the ante $0.02
DDarks: posts the ante $0.02
Paker 3: posts the ante $0.02
ale9030: posts the ante $0.02
*** HOLE CARDS ***
DDarks: folds 
Paker 3: raises $0.15 to $0.25
ale9030: calls $0.25
togl63amg: folds 
Old Benji: folds 
ReKych: calls $0.15
*** FLOP *** [8s 6d 7h]
ReKych: checks 
Paker 3: bets $0.33
ale9030: calls $0.33
ReKych: folds 
*** TURN *** [8s 6d 7h] [6h]
Paker 3: bets $0.40
ale9030: calls $0.40
*** RIVER *** [8s 6d 7h 6h] [2d]
Paker 3: checks 
ale9030: checks 
*** SHOW DOWN ***
Paker 3: shows [Qh Tc] (a pair of Sixes)
ale9030: shows [9s 9d] (two pair, Nines and Sixes)
ale9030 collected $2.27 from pot
*** SUMMARY ***
Total pot $2.38 | Rake $0.11 
Board [8s 6d 7h 6h 2d]
Seat 1: togl63amg (button) folded before Flop (didn't bet)
Seat 2: Old Benji (small blind) folded before Flop
Seat 3: ReKych (big blind) folded on the Flop
Seat 4: DDarks folded before Flop (didn't bet)
Seat 5: Paker 3 showed [Qh Tc] and lost with a pair of Sixes
Seat 6: ale9030 showed [9s 9d] and won ($2.27) with two pair, Nines and Sixes



PokerStars Hand #201509450499:  Hold'em No Limit ($0.05/$0.10 USD) - 2019/06/18 11:32:24 ET
Table 'Moreau III' 6-max Seat #2 is the button
Seat 1: togl63amg ($20.19 in chips) 
Seat 2: Old Benji ($8.74 in chips) 
Seat 3: ReKych ($13.63 in chips) 
Seat 4: DDarks ($19.98 in chips) 
Seat 5: Paker 3 ($17.20 in chips) 
Seat 6: ale9030 ($12.73 in chips) 
ReKych: posts small blind $0.05
DDarks: posts big blind $0.10
togl63amg: posts the ante $0.02
Old Benji: posts the ante $0.02
ReKych: posts the ante $0.02
DDarks: posts the ante $0.02
Paker 3: posts the ante $0.02
ale9030: posts the ante $0.02
*** HOLE CARDS ***
Paker 3: folds 
ale9030: folds 
togl63amg: raises $0.20 to $0.30
Old Benji: folds 
ReKych: folds 
DDarks: raises $0.20 to $0.50
togl63amg: calls $0.20
*** FLOP *** [6d Jd 6h]
DDarks: bets $0.50
togl63amg: folds 
Uncalled bet ($0.50) returned to DDarks
DDarks collected $1.12 from pot
DDarks: doesn't show hand 
*** SUMMARY ***
Total pot $1.17 | Rake $0.05 
Board [6d Jd 6h]
Seat 1: togl63amg folded on the Flop
Seat 2: Old Benji (button) folded before Flop (didn't bet)
Seat 3: ReKych (small blind) folded before Flop
Seat 4: DDarks (big blind) collected ($1.12)
Seat 5: Paker 3 folded before Flop (didn't bet)
Seat 6: ale9030 folded before Flop (didn't bet)



PokerStars Hand #201509474443:  Hold'em No Limit ($0.05/$0.10 USD) - 2019/06/18 11:33:19 ET
Table 'Moreau III' 6-max Seat #3 is the button
Seat 1: togl63amg ($19.67 in chips) 
Seat 2: Old Benji ($8.72 in chips) 
Seat 3: ReKych ($13.56 in chips) 
Seat 4: DDarks ($20.58 in chips) 
Seat 5: Paker 3 ($17.18 in chips) 
Seat 6: ale9030 ($12.71 in chips) 
DDarks: posts small blind $0.05
Paker 3: posts big blind $0.10
togl63amg: posts the ante $0.02
Old Benji: posts the ante $0.02
ReKych: posts the ante $0.02
DDarks: posts the ante $0.02
Paker 3: posts the ante $0.02
ale9030: posts the ante $0.02
*** HOLE CARDS ***
ale9030: folds 
togl63amg: folds 
Old Benji: calls $0.10
ReKych: calls $0.10
DDarks: raises $0.50 to $0.60
Paker 3: folds 
Old Benji: calls $0.50
ReKych: folds 
*** FLOP *** [3h 5d 8s]
DDarks: bets $1
Old Benji: folds 
Uncalled bet ($1) returned to DDarks
DDarks collected $1.45 from pot
DDarks: doesn't show hand 
*** SUMMARY ***
Total pot $1.52 | Rake $0.07 
Board [3h 5d 8s]
Seat 1: togl63amg folded before Flop (didn't bet)
Seat 2: Old Benji folded on the Flop
Seat 3: ReKych (button) folded before Flop
Seat 4: DDarks (small blind) collected ($1.45)
Seat 5: Paker 3 (big blind) folded before Flop
Seat 6: ale9030 folded before Flop (didn't bet)



PokerStars Hand #201509494515:  Hold'em No Limit ($0.05/$0.10 USD) - 2019/06/18 11:34:06 ET
Table 'Moreau III' 6-max Seat #4 is the button
Seat 1: togl63amg ($19.65 in chips) 
Seat 2: Old Benji ($8.10 in chips) 
Seat 3: ReKych ($13.44 in chips) 
Seat 4: DDarks ($21.41 in chips) 
Seat 5: Paker 3 ($17.06 in chips) 
Seat 6: ale9030 ($12.69 in chips) 
Paker 3: posts small blind $0.05
ale9030: posts big blind $0.10
togl63amg: posts the ante $0.02
Old Benji: posts the ante $0.02
ReKych: posts the ante $0.02
DDarks: posts the ante $0.02
Paker 3: posts the ante $0.02
ale9030: posts the ante $0.02
*** HOLE CARDS ***
togl63amg: raises $0.20 to $0.30
Old Benji: folds 
ReKych: folds 
DDarks: folds 
Paker 3: folds 
ale9030: folds 
Uncalled bet ($0.20) returned to togl63amg
togl63amg collected $0.37 from pot
*** SUMMARY ***
Total pot $0.37 | Rake $0 
Seat 1: togl63amg collected ($0.37)
Seat 2: Old Benji folded before Flop (didn't bet)
Seat 3: ReKych folded before Flop (didn't bet)
Seat 4: DDarks (button) folded before Flop (didn't bet)
Seat 5: Paker 3 (small blind) folded before Flop
Seat 6: ale9030 (big blind) folded before Flop



PokerStars Hand #201509508031:  Hold'em No Limit ($0.05/$0.10 USD) - 2019/06/18 11:34:37 ET
Table 'Moreau III' 6-max Seat #5 is the button
Seat 1: togl63amg ($19.90 in chips) 
Seat 2: Old Benji ($8.08 in chips) 
Seat 3: ReKych ($13.42 in chips) 
Seat 4: DDarks ($21.39 in chips) 
Seat 5: Paker 3 ($16.99 in chips) 
Seat 6: ale9030 ($12.57 in chips) 
ale9030: posts small blind $0.05
togl63amg: posts big blind $0.10
togl63amg: posts the ante $0.02
Old Benji: posts the ante $0.02
ReKych: posts the ante $0.02
DDarks: posts the ante $0.02
Paker 3: posts the ante $0.02
ale9030: posts the ante $0.02
*** HOLE CARDS ***
Old Benji: folds 
ReKych: raises $0.30 to $0.40
DDarks: raises $0.60 to $1
Paker 3: folds 
ale9030: folds 
togl63amg: folds 
ReKych: calls $0.60
*** FLOP *** [6h 8s Ah]
ReKych: checks 
DDarks: bets $1
ReKych: folds 
Uncalled bet ($1) returned to DDarks
DDarks collected $2.17 from pot
DDarks: doesn't show hand 
*** SUMMARY ***
Total pot $2.27 | Rake $0.10 
Board [6h 8s Ah]
Seat 1: togl63amg (big blind) folded before Flop
Seat 2: Old Benji folded before Flop (didn't bet)
Seat 3: ReKych folded on the Flop
Seat 4: DDarks collected ($2.17)
Seat 5: Paker 3 (button) folded before Flop (didn't bet)
Seat 6: ale9030 (small blind) folded before Flop



PokerStars Hand #201509684972:  Hold'em No Limit ($0.05/$0.10 USD) - 2019/06/18 11:41:13 ET
Table 'Moreau III' 6-max Seat #2 is the button
Seat 1: togl63amg ($19.41 in chips) 
Seat 2: Old Benji ($9.70 in chips) 
Seat 3: ReKych ($11.11 in chips) 
Seat 4: DDarks ($23.06 in chips) 
Seat 5: Paker 3 ($16.58 in chips) 
Seat 6: ale9030 ($11.94 in chips) 
ReKych: posts small blind $0.05
DDarks: posts big blind $0.10
togl63amg: posts the ante $0.02
Old Benji: posts the ante $0.02
ReKych: posts the ante $0.02
DDarks: posts the ante $0.02
Paker 3: posts the ante $0.02
ale9030: posts the ante $0.02
*** HOLE CARDS ***
Paker 3: folds 
ale9030: folds 
togl63amg: folds 
Old Benji: folds 
ReKych: folds 
Uncalled bet ($0.05) returned to DDarks
DDarks collected $0.22 from pot
DDarks: doesn't show hand 
*** SUMMARY ***
Total pot $0.22 | Rake $0 
Seat 1: togl63amg folded before Flop (didn't bet)
Seat 2: Old Benji (button) folded before Flop (didn't bet)
Seat 3: ReKych (small blind) folded before Flop
Seat 4: DDarks (big blind) collected ($0.22)
Seat 5: Paker 3 folded before Flop (didn't bet)
Seat 6: ale9030 folded before Flop (didn't bet)



PokerStars Hand #201509693259:  Hold'em No Limit ($0.05/$0.10 USD) - 2019/06/18 11:41:32 ET
Table 'Moreau III' 6-max Seat #3 is the button
Seat 1: togl63amg ($19.39 in chips) 
Seat 2: Old Benji ($9.68 in chips) 
Seat 3: ReKych ($11.04 in chips) 
Seat 4: DDarks ($23.21 in chips) 
Seat 5: Paker 3 ($16.56 in chips) 
Seat 6: ale9030 ($11.92 in chips) 
DDarks: posts small blind $0.05
Paker 3: posts big blind $0.10
togl63amg: posts the ante $0.02
Old Benji: posts the ante $0.02
ReKych: posts the ante $0.02
DDarks: posts the ante $0.02
Paker 3: posts the ante $0.02
ale9030: posts the ante $0.02
*** HOLE CARDS ***
ale9030: folds 
togl63amg: raises $0.20 to $0.30
Old Benji: folds 
ReKych: folds 
DDarks: folds 
Paker 3: raises $0.20 to $0.50
togl63amg: calls $0.20
*** FLOP *** [Js 5s Kh]
Paker 3: checks 
togl63amg: checks 
*** TURN *** [Js 5s Kh] [8s]
Paker 3: bets $0.33
togl63amg: calls $0.33
*** RIVER *** [Js 5s Kh 8s] [9d]
Paker 3: checks 
togl63amg: bets $2.90
Paker 3: folds 
Uncalled bet ($2.90) returned to togl63amg
togl63amg collected $1.75 from pot
*** SUMMARY ***
Total pot $1.83 | Rake $0.08 
Board [Js 5s Kh 8s 9d]
Seat 1: togl63amg collected ($1.75)
Seat 2: Old Benji folded before Flop (didn't bet)
Seat 3: ReKych (button) folded before Flop (didn't bet)
Seat 4: DDarks (small blind) folded before Flop
Seat 5: Paker 3 (big blind) folded on the River
Seat 6: ale9030 folded before Flop (didn't bet)



PokerStars Hand #201509726808:  Hold'em No Limit ($0.05/$0.10 USD) - 2019/06/18 11:42:49 ET
Table 'Moreau III' 6-max Seat #4 is the button
Seat 1: togl63amg ($20.29 in chips) 
Seat 2: Old Benji ($9.66 in chips) 
Seat 3: ReKych ($11.02 in chips) 
Seat 4: DDarks ($23.14 in chips) 
Seat 5: Paker 3 ($15.71 in chips) 
Seat 6: ale9030 ($11.90 in chips) 
Paker 3: posts small blind $0.05
ale9030: posts big blind $0.10
togl63amg: posts the ante $0.02
Old Benji: posts the ante $0.02
ReKych: posts the ante $0.02
DDarks: posts the ante $0.02
Paker 3: posts the ante $0.02
ale9030: posts the ante $0.02
*** HOLE CARDS ***
togl63amg: folds 
Old Benji: folds 
ReKych: folds 
DDarks: calls $0.10
Paker 3: folds 
ale9030: checks 
*** FLOP *** [As Tc 4c]
ale9030: checks 
DDarks: checks 
*** TURN *** [As Tc 4c] [2c]
ale9030: bets $0.35
DDarks: folds 
Uncalled bet ($0.35) returned to ale9030
ale9030 collected $0.35 from pot
*** SUMMARY ***
Total pot $0.37 | Rake $0.02 
Board [As Tc 4c 2c]
Seat 1: togl63amg folded before Flop (didn't bet)
Seat 2: Old Benji folded before Flop (didn't bet)
Seat 3: ReKych folded before Flop (didn't bet)
Seat 4: DDarks (button) folded on the Turn
Seat 5: Paker 3 (small blind) folded before Flop
Seat 6: ale9030 (big blind) collected ($0.35)



PokerStars Hand #201509749898:  Hold'em No Limit ($0.05/$0.10 USD) - 2019/06/18 11:43:41 ET
Table 'Moreau III' 6-max Seat #5 is the button
Seat 1: togl63amg ($20.27 in chips) 
Seat 2: Old Benji ($9.64 in chips) 
Seat 3: ReKych ($11 in chips) 
Seat 4: DDarks ($23.02 in chips) 
Seat 5: Paker 3 ($15.64 in chips) 
Seat 6: ale9030 ($12.13 in chips) 
ale9030: posts small blind $0.05
togl63amg: posts big blind $0.10
togl63amg: posts the ante $0.02
Old Benji: posts the ante $0.02
ReKych: posts the ante $0.02
DDarks: posts the ante $0.02
Paker 3: posts the ante $0.02
ale9030: posts the ante $0.02
*** HOLE CARDS ***
Old Benji: folds 
ReKych: raises $0.30 to $0.40
DDarks: calls $0.40
Paker 3: raises $0.80 to $1.20
ale9030: folds 
togl63amg: calls $1.10
ReKych: calls $0.80
DDarks: folds 
*** FLOP *** [9s 5s 7d]
togl63amg: checks 
ReKych: checks 
Paker 3: bets $2.40
togl63amg: calls $2.40
ReKych: folds 
*** TURN *** [9s 5s 7d] [7c]
togl63amg: checks 
Paker 3: checks 
*** RIVER *** [9s 5s 7d 7c] [Ks]
togl63amg: bets $16.65 and is all-in
Paker 3: calls $12.02 and is all-in
Uncalled bet ($4.63) returned to togl63amg
*** SHOW DOWN ***
togl63amg: shows [Js As] (a flush, Ace high)
Paker 3: shows [Kc Jh] (two pair, Kings and Sevens)
togl63amg collected $31.52 from pot
*** SUMMARY ***
Total pot $33.01 | Rake $1.49 
Board [9s 5s 7d 7c Ks]
Seat 1: togl63amg (big blind) showed [Js As] and won ($31.52) with a flush, Ace high
Seat 2: Old Benji folded before Flop (didn't bet)
Seat 3: ReKych folded on the Flop
Seat 4: DDarks folded before Flop
Seat 5: Paker 3 (button) showed [Kc Jh] and lost with two pair, Kings and Sevens
Seat 6: ale9030 (small blind) folded before Flop



PokerStars Hand #201509794776:  Hold'em No Limit ($0.05/$0.10 USD) - 2019/06/18 11:45:24 ET
Table 'Moreau III' 6-max Seat #6 is the button
Seat 1: togl63amg ($36.15 in chips) 
Seat 2: Old Benji ($9.62 in chips) 
Seat 3: ReKych ($10 in chips) 
Seat 4: DDarks ($22.60 in chips) 
Seat 6: ale9030 ($12.06 in chips) 
togl63amg: posts small blind $0.05
Old Benji: posts big blind $0.10
togl63amg: posts the ante $0.02
Old Benji: posts the ante $0.02
ReKych: posts the ante $0.02
DDarks: posts the ante $0.02
ale9030: posts the ante $0.02
*** HOLE CARDS ***
Paker 3 leaves the table
ReKych: raises $0.20 to $0.30
DDarks: folds 
jext joins the table at seat #5 
ale9030: folds 
togl63amg: folds 
Old Benji: folds 
Uncalled bet ($0.20) returned to ReKych
ReKych collected $0.35 from pot
ReKych: doesn't show hand 
*** SUMMARY ***
Total pot $0.35 | Rake $0 
Seat 1: togl63amg (small blind) folded before Flop
Seat 2: Old Benji (big blind) folded before Flop
Seat 3: ReKych collected ($0.35)
Seat 4: DDarks folded before Flop (didn't bet)
Seat 6: ale9030 (button) folded before Flop (didn't bet)



PokerStars Hand #201509803366:  Hold'em No Limit ($0.05/$0.10 USD) - 2019/06/18 11:45:44 ET
Table 'Moreau III' 6-max Seat #1 is the button
Seat 1: togl63amg ($36.08 in chips) 
Seat 2: Old Benji ($9.50 in chips) 
Seat 4: DDarks ($22.58 in chips) 
Seat 6: ale9030 ($12.04 in chips) 
Old Benji: posts small blind $0.05
ReKych: is sitting out 
DDarks: posts big blind $0.10
togl63amg: posts the ante $0.02
Old Benji: posts the ante $0.02
DDarks: posts the ante $0.02
ale9030: posts the ante $0.02
*** HOLE CARDS ***
ReKych leaves the table
MrBigFish001 joins the table at seat #3 
MrBigFish001 leaves the table
ale9030: folds 
togl63amg: folds 
Old Benji: folds 
Uncalled bet ($0.05) returned to DDarks
Kreayshawn joins the table at seat #3 
DDarks collected $0.18 from pot
DDarks: doesn't show hand 
*** SUMMARY ***
Total pot $0.18 | Rake $0 
Seat 1: togl63amg (button) folded before Flop (didn't bet)
Seat 2: Old Benji (small blind) folded before Flop
Seat 4: DDarks (big blind) collected ($0.18)
Seat 6: ale9030 folded before Flop (didn't bet)



PokerStars Hand #201509806724:  Hold'em No Limit ($0.05/$0.10 USD) - 2019/06/18 11:45:51 ET
Table 'Moreau III' 6-max Seat #2 is the button
Seat 1: togl63amg ($36.06 in chips) 
Seat 2: Old Benji ($9.43 in chips) 
Seat 4: DDarks ($22.69 in chips) 
Seat 6: ale9030 ($12.02 in chips) 
DDarks: posts small blind $0.05
ale9030: posts big blind $0.10
togl63amg: posts the ante $0.02
Old Benji: posts the ante $0.02
DDarks: posts the ante $0.02
ale9030: posts the ante $0.02
*** HOLE CARDS ***
togl63amg: folds 
Old Benji: folds 
DDarks: calls $0.05
ale9030: checks 
*** FLOP *** [Qh Jd 9d]
DDarks: bets $0.20
ale9030: folds 
Uncalled bet ($0.20) returned to DDarks
DDarks collected $0.27 from pot
DDarks: doesn't show hand 
*** SUMMARY ***
Total pot $0.28 | Rake $0.01 
Board [Qh Jd 9d]
Seat 1: togl63amg folded before Flop (didn't bet)
Seat 2: Old Benji (button) folded before Flop (didn't bet)
Seat 4: DDarks (small blind) collected ($0.27)
Seat 6: ale9030 (big blind) folded on the Flop



PokerStars Hand #201509816924:  Hold'em No Limit ($0.05/$0.10 USD) - 2019/06/18 11:46:14 ET
Table 'Moreau III' 6-max Seat #4 is the button
Seat 1: togl63amg ($36.04 in chips) 
Seat 2: Old Benji ($9.41 in chips) 
Seat 4: DDarks ($22.84 in chips) 
Seat 6: ale9030 ($11.90 in chips) 
ale9030: posts small blind $0.05
togl63amg: posts big blind $0.10
Kreayshawn: sits out 
togl63amg: posts the ante $0.02
Old Benji: posts the ante $0.02
DDarks: posts the ante $0.02
ale9030: posts the ante $0.02
*** HOLE CARDS ***
Old Benji: folds 
DDarks: raises $0.40 to $0.50
ale9030: folds 
togl63amg: raises $1.60 to $2.10
DDarks: calls $1.60
*** FLOP *** [5h Jd Qc]
jext leaves the table
togl63amg: bets $2.90
DDarks: raises $17.82 to $20.72 and is all-in
togl63amg: calls $17.82
*** TURN *** [5h Jd Qc] [Qs]
*** RIVER *** [5h Jd Qc Qs] [4d]
*** SHOW DOWN ***
togl63amg: shows [Ac Ad] (two pair, Aces and Queens)
DDarks: shows [9h Qh] (three of a kind, Queens)
DDarks collected $44.77 from pot
*** SUMMARY ***
Total pot $45.77 | Rake $1 
Board [5h Jd Qc Qs 4d]
Seat 1: togl63amg (big blind) showed [Ac Ad] and lost with two pair, Aces and Queens
Seat 2: Old Benji folded before Flop (didn't bet)
Seat 4: DDarks (button) showed [9h Qh] and won ($44.77) with three of a kind, Queens
Seat 6: ale9030 (small blind) folded before Flop



PokerStars Hand #201509835201:  Hold'em No Limit ($0.05/$0.10 USD) - 2019/06/18 11:46:56 ET
Table 'Moreau III' 6-max Seat #6 is the button
Seat 1: togl63amg ($13.20 in chips) 
Seat 2: Old Benji ($9.39 in chips) 
Seat 4: DDarks ($44.77 in chips) 
Seat 6: ale9030 ($11.83 in chips) 
togl63amg: posts small blind $0.05
Old Benji: posts big blind $0.10
Kreayshawn: sits out 
togl63amg: posts the ante $0.02
Old Benji: posts the ante $0.02
DDarks: posts the ante $0.02
ale9030: posts the ante $0.02
*** HOLE CARDS ***
DDarks: raises $0.90 to $1
ale9030: folds 
togl63amg: folds 
Old Benji: folds 
Uncalled bet ($0.90) returned to DDarks
DDarks collected $0.33 from pot
DDarks: doesn't show hand 
*** SUMMARY ***
Total pot $0.33 | Rake $0 
Seat 1: togl63amg (small blind) folded before Flop
Seat 2: Old Benji (big blind) folded before Flop
Seat 4: DDarks collected ($0.33)
Seat 6: ale9030 (button) folded before Flop (didn't bet)



PokerStars Hand #201509844665:  Hold'em No Limit ($0.05/$0.10 USD) - 2019/06/18 11:47:18 ET
Table 'Moreau III' 6-max Seat #1 is the button
Seat 1: togl63amg ($13.13 in chips) 
Seat 2: Old Benji ($9.27 in chips) 
Seat 3: Kreayshawn ($10 in chips) 
Seat 4: DDarks ($44.98 in chips) 
Seat 6: ale9030 ($11.81 in chips) 
Old Benji: posts small blind $0.05
Kreayshawn: posts big blind $0.10
togl63amg: posts the ante $0.02
Old Benji: posts the ante $0.02
Kreayshawn: posts the ante $0.02
DDarks: posts the ante $0.02
ale9030: posts the ante $0.02
*** HOLE CARDS ***
DDarks: raises $0.90 to $1
ale9030: folds 
togl63amg: folds 
Old Benji: folds 
Kreayshawn: folds 
Uncalled bet ($0.90) returned to DDarks
DDarks collected $0.35 from pot
DDarks: doesn't show hand 
*** SUMMARY ***
Total pot $0.35 | Rake $0 
Seat 1: togl63amg (button) folded before Flop (didn't bet)
Seat 2: Old Benji (small blind) folded before Flop
Seat 3: Kreayshawn (big blind) folded before Flop
Seat 4: DDarks collected ($0.35)
Seat 6: ale9030 folded before Flop (didn't bet)



PokerStars Hand #201509853976:  Hold'em No Limit ($0.05/$0.10 USD) - 2019/06/18 11:47:38 ET
Table 'Moreau III' 6-max Seat #2 is the button
Seat 1: togl63amg ($13.11 in chips) 
Seat 2: Old Benji ($9.20 in chips) 
Seat 3: Kreayshawn ($10 in chips) 
Seat 4: DDarks ($45.21 in chips) 
Seat 6: ale9030 ($11.79 in chips) 
Kreayshawn: posts small blind $0.05
DDarks: posts big blind $0.10
togl63amg: posts the ante $0.02
Old Benji: posts the ante $0.02
Kreayshawn: posts the ante $0.02
DDarks: posts the ante $0.02
ale9030: posts the ante $0.02
*** HOLE CARDS ***
ale9030: folds 
togl63amg: raises $0.20 to $0.30
Old Benji: folds 
Kreayshawn: folds 
DDarks: calls $0.20
*** FLOP *** [8d Qc 3s]
Kreayshawn leaves the table
DDarks: checks 
togl63amg: bets $0.40
DDarks: folds 
Uncalled bet ($0.40) returned to togl63amg
togl63amg collected $0.72 from pot
Kreayshawn joins the table at seat #5 
*** SUMMARY ***
Total pot $0.75 | Rake $0.03 
Board [8d Qc 3s]
Seat 1: togl63amg collected ($0.72)
Seat 2: Old Benji (button) folded before Flop (didn't bet)
Seat 3: Kreayshawn (small blind) folded before Flop
Seat 4: DDarks (big blind) folded on the Flop
Seat 6: ale9030 folded before Flop (didn't bet)



PokerStars Hand #201509864782:  Hold'em No Limit ($0.05/$0.10 USD) - 2019/06/18 11:48:03 ET
Table 'Moreau III' 6-max Seat #4 is the button
Seat 1: togl63amg ($13.51 in chips) 
Seat 2: Old Benji ($9.18 in chips) 
Seat 4: DDarks ($44.89 in chips) 
Seat 6: ale9030 ($11.77 in chips) 
ale9030: posts small blind $0.05
togl63amg: posts big blind $0.10
togl63amg: posts the ante $0.02
Old Benji: posts the ante $0.02
DDarks: posts the ante $0.02
ale9030: posts the ante $0.02
*** HOLE CARDS ***
Old Benji: calls $0.10
DDarks: folds 
DDarks leaves the table
ale9030: folds 
togl63amg: checks 
*** FLOP *** [7h Ks Qh]
togl63amg: checks 
Old Benji: bets $0.16
togl63amg: folds 
Uncalled bet ($0.16) returned to Old Benji
Old Benji collected $0.32 from pot
Old Benji: doesn't show hand 
*** SUMMARY ***
Total pot $0.33 | Rake $0.01 
Board [7h Ks Qh]
Seat 1: togl63amg (big blind) folded on the Flop
Seat 2: Old Benji collected ($0.32)
Seat 4: DDarks (button) folded before Flop (didn't bet)
Seat 6: ale9030 (small blind) folded before Flop



PokerStars Hand #201509876901:  Hold'em No Limit ($0.05/$0.10 USD) - 2019/06/18 11:48:31 ET
Table 'Moreau III' 6-max Seat #6 is the button
Seat 1: togl63amg ($13.39 in chips) 
Seat 2: Old Benji ($9.38 in chips) 
Seat 6: ale9030 ($11.70 in chips) 
togl63amg: posts small blind $0.05
Old Benji: posts big blind $0.10
Kreayshawn: sits out 
togl63amg: posts the ante $0.02
Old Benji: posts the ante $0.02
ale9030: posts the ante $0.02
*** HOLE CARDS ***
ale9030: folds 
togl63amg: folds 
Uncalled bet ($0.05) returned to Old Benji
Old Benji collected $0.16 from pot
Old Benji: doesn't show hand 
*** SUMMARY ***
Total pot $0.16 | Rake $0 
Seat 1: togl63amg (small blind) folded before Flop
Seat 2: Old Benji (big blind) collected ($0.16)
Seat 6: ale9030 (button) folded before Flop (didn't bet)



PokerStars Hand #201511748883:  Hold'em No Limit ($0.05/$0.10 USD) - 2019/06/18 12:57:14 ET
Table 'Moreau III' 6-max Seat #5 is the button
Seat 1: Fantom979 ($11.32 in chips) 
Seat 2: potsos2012 ($8.87 in chips) 
Seat 3: Kreayshawn ($11.14 in chips) 
Seat 4: Kalaboush ($10 in chips) 
Seat 5: nemabob85 ($8.25 in chips) 
Seat 6: coolisses111 ($8.58 in chips) 
coolisses111: posts small blind $0.05
Fantom979: posts big blind $0.10
Fantom979: posts the ante $0.02
potsos2012: posts the ante $0.02
Kreayshawn: posts the ante $0.02
Kalaboush: posts the ante $0.02
nemabob85: posts the ante $0.02
coolisses111: posts the ante $0.02
*** HOLE CARDS ***
potsos2012: raises $0.20 to $0.30
Kreayshawn: raises $0.80 to $1.10
Kalaboush: calls $1.10
nemabob85: folds 
coolisses111: folds 
Fantom979: folds 
potsos2012: calls $0.80
*** FLOP *** [2c As 7c]
potsos2012: bets $0.60
Kreayshawn: calls $0.60
Kalaboush: folds 
*** TURN *** [2c As 7c] [8d]
potsos2012: checks 
Kreayshawn: checks 
*** RIVER *** [2c As 7c 8d] [3h]
potsos2012: bets $1.50
Kreayshawn: raises $2 to $3.50
potsos2012: folds 
Uncalled bet ($2) returned to Kreayshawn
Kreayshawn collected $7.42 from pot
Kreayshawn: doesn't show hand 
*** SUMMARY ***
Total pot $7.77 | Rake $0.35 
Board [2c As 7c 8d 3h]
Seat 1: Fantom979 (big blind) folded before Flop
Seat 2: potsos2012 folded on the River
Seat 3: Kreayshawn collected ($7.42)
Seat 4: Kalaboush folded on the Flop
Seat 5: nemabob85 (button) folded before Flop (didn't bet)
Seat 6: coolisses111 (small blind) folded before Flop



PokerStars Hand #201511778864:  Hold'em No Limit ($0.05/$0.10 USD) - 2019/06/18 12:58:32 ET
Table 'Moreau III' 6-max Seat #6 is the button
Seat 1: Fantom979 ($11.20 in chips) 
Seat 2: potsos2012 ($5.65 in chips) 
Seat 3: Kreayshawn ($15.34 in chips) 
Seat 4: Kalaboush ($10 in chips) 
Seat 5: nemabob85 ($8.23 in chips) 
Seat 6: coolisses111 ($8.51 in chips) 
Fantom979: posts small blind $0.05
potsos2012: posts big blind $0.10
Fantom979: posts the ante $0.02
potsos2012: posts the ante $0.02
Kreayshawn: posts the ante $0.02
Kalaboush: posts the ante $0.02
nemabob85: posts the ante $0.02
coolisses111: posts the ante $0.02
*** HOLE CARDS ***
Kreayshawn: folds 
Kalaboush: folds 
nemabob85: raises $0.10 to $0.20
coolisses111: folds 
Fantom979: folds 
potsos2012: calls $0.10
*** FLOP *** [5c 9c Kd]
potsos2012: bets $0.30
nemabob85: folds 
Uncalled bet ($0.30) returned to potsos2012
potsos2012 collected $0.54 from pot
*** SUMMARY ***
Total pot $0.57 | Rake $0.03 
Board [5c 9c Kd]
Seat 1: Fantom979 (small blind) folded before Flop
Seat 2: potsos2012 (big blind) collected ($0.54)
Seat 3: Kreayshawn folded before Flop (didn't bet)
Seat 4: Kalaboush folded before Flop (didn't bet)
Seat 5: nemabob85 folded on the Flop
Seat 6: coolisses111 (button) folded before Flop (didn't bet)



PokerStars Hand #201511791241:  Hold'em No Limit ($0.05/$0.10 USD) - 2019/06/18 12:59:04 ET
Table 'Moreau III' 6-max Seat #1 is the button
Seat 1: Fantom979 ($11.13 in chips) 
Seat 2: potsos2012 ($5.97 in chips) 
Seat 3: Kreayshawn ($15.32 in chips) 
Seat 4: Kalaboush ($10 in chips) 
Seat 5: nemabob85 ($8.01 in chips) 
Seat 6: coolisses111 ($8.49 in chips) 
potsos2012: posts small blind $0.05
Kreayshawn: posts big blind $0.10
Fantom979: posts the ante $0.02
potsos2012: posts the ante $0.02
Kreayshawn: posts the ante $0.02
Kalaboush: posts the ante $0.02
nemabob85: posts the ante $0.02
coolisses111: posts the ante $0.02
*** HOLE CARDS ***
Kalaboush: raises $0.20 to $0.30
nemabob85: folds 
coolisses111: folds 
Fantom979: folds 
potsos2012: folds 
Kreayshawn: folds 
Uncalled bet ($0.20) returned to Kalaboush
Kalaboush collected $0.37 from pot
Kalaboush: doesn't show hand 
*** SUMMARY ***
Total pot $0.37 | Rake $0 
Seat 1: Fantom979 (button) folded before Flop (didn't bet)
Seat 2: potsos2012 (small blind) folded before Flop
Seat 3: Kreayshawn (big blind) folded before Flop
Seat 4: Kalaboush collected ($0.37)
Seat 5: nemabob85 folded before Flop (didn't bet)
Seat 6: coolisses111 folded before Flop (didn't bet)



PokerStars Hand #201511799340:  Hold'em No Limit ($0.05/$0.10 USD) - 2019/06/18 12:59:25 ET
Table 'Moreau III' 6-max Seat #2 is the button
Seat 1: Fantom979 ($11.11 in chips) 
Seat 2: potsos2012 ($5.90 in chips) 
Seat 3: Kreayshawn ($15.20 in chips) 
Seat 4: Kalaboush ($10.25 in chips) 
Seat 5: nemabob85 ($7.99 in chips) 
Seat 6: coolisses111 ($8.47 in chips) 
Kreayshawn: posts small blind $0.05
Kalaboush: posts big blind $0.10
Fantom979: posts the ante $0.02
potsos2012: posts the ante $0.02
Kreayshawn: posts the ante $0.02
Kalaboush: posts the ante $0.02
nemabob85: posts the ante $0.02
coolisses111: posts the ante $0.02
*** HOLE CARDS ***
nemabob85: folds 
coolisses111: folds 
Fantom979: raises $0.20 to $0.30
potsos2012: raises $0.30 to $0.60
Kreayshawn: calls $0.55
Kalaboush: calls $0.50
Fantom979: calls $0.30
*** FLOP *** [Kd 5h 5c]
Kreayshawn: checks 
Kalaboush: checks 
Fantom979: checks 
potsos2012: bets $1.10
Kreayshawn: calls $1.10
Kalaboush: folds 
Fantom979: calls $1.10
*** TURN *** [Kd 5h 5c] [4s]
Kreayshawn: checks 
Fantom979: checks 
potsos2012: checks 
*** RIVER *** [Kd 5h 5c 4s] [5s]
Kreayshawn: bets $3.80
Fantom979: folds 
potsos2012: folds 
Uncalled bet ($3.80) returned to Kreayshawn
Kreayshawn collected $5.56 from pot
Kreayshawn: doesn't show hand 
*** SUMMARY ***
Total pot $5.82 | Rake $0.26 
Board [Kd 5h 5c 4s 5s]
Seat 1: Fantom979 folded on the River
Seat 2: potsos2012 (button) folded on the River
Seat 3: Kreayshawn (small blind) collected ($5.56)
Seat 4: Kalaboush (big blind) folded on the Flop
Seat 5: nemabob85 folded before Flop (didn't bet)
Seat 6: coolisses111 folded before Flop (didn't bet)



PokerStars Hand #201511719312:  Hold'em No Limit ($0.05/$0.10 USD) - 2019/06/18 12:55:56 ET
Table 'Moreau III' 6-max Seat #3 is the button
Seat 1: Fantom979 ($10 in chips) 
Seat 2: potsos2012 ($9.86 in chips) 
Seat 3: Kreayshawn ($10.74 in chips) 
Seat 4: Kalaboush ($10 in chips) 
Seat 5: nemabob85 ($8.44 in chips) 
Seat 6: coolisses111 ($8.92 in chips) 
Kalaboush: posts small blind $0.05
nemabob85: posts big blind $0.10
Fantom979: posts the ante $0.02
potsos2012: posts the ante $0.02
Kreayshawn: posts the ante $0.02
Kalaboush: posts the ante $0.02
nemabob85: posts the ante $0.02
coolisses111: posts the ante $0.02
*** HOLE CARDS ***
coolisses111: folds 
Fantom979: raises $0.20 to $0.30
potsos2012: calls $0.30
Kreayshawn: folds 
Kalaboush: calls $0.25
nemabob85: folds 
*** FLOP *** [4h Kh Qd]
Kalaboush: checks 
Fantom979: bets $0.65
potsos2012: calls $0.65
Kalaboush: folds 
*** TURN *** [4h Kh Qd] [8c]
Fantom979: checks 
potsos2012: checks 
*** RIVER *** [4h Kh Qd 8c] [Ad]
Fantom979: checks 
potsos2012: checks 
*** SHOW DOWN ***
Fantom979: shows [Kd Js] (a pair of Kings)
potsos2012: mucks hand 
Fantom979 collected $2.31 from pot
*** SUMMARY ***
Total pot $2.42 | Rake $0.11 
Board [4h Kh Qd 8c Ad]
Seat 1: Fantom979 showed [Kd Js] and won ($2.31) with a pair of Kings
Seat 2: potsos2012 mucked
Seat 3: Kreayshawn (button) folded before Flop (didn't bet)
Seat 4: Kalaboush (small blind) folded on the Flop
Seat 5: nemabob85 (big blind) folded before Flop
Seat 6: coolisses111 folded before Flop (didn't bet)



PokerStars Hand #201511738155:  Hold'em No Limit ($0.05/$0.10 USD) - 2019/06/18 12:56:45 ET
Table 'Moreau III' 6-max Seat #4 is the button
Seat 1: Fantom979 ($11.34 in chips) 
Seat 2: potsos2012 ($8.89 in chips) 
Seat 3: Kreayshawn ($10.72 in chips) 
Seat 4: Kalaboush ($10 in chips) 
Seat 5: nemabob85 ($8.32 in chips) 
Seat 6: coolisses111 ($8.90 in chips) 
nemabob85: posts small blind $0.05
coolisses111: posts big blind $0.10
Fantom979: posts the ante $0.02
potsos2012: posts the ante $0.02
Kreayshawn: posts the ante $0.02
Kalaboush: posts the ante $0.02
nemabob85: posts the ante $0.02
coolisses111: posts the ante $0.02
*** HOLE CARDS ***
Fantom979: folds 
potsos2012: folds 
Kreayshawn: raises $0.20 to $0.30
Kalaboush: folds 
nemabob85: folds 
coolisses111: calls $0.20
*** FLOP *** [6s 9h 5d]
coolisses111: checks 
Kreayshawn: bets $0.58
coolisses111: folds 
Uncalled bet ($0.58) returned to Kreayshawn
Kreayshawn collected $0.74 from pot
Kreayshawn: doesn't show hand 
*** SUMMARY ***
Total pot $0.77 | Rake $0.03 
Board [6s 9h 5d]
Seat 1: Fantom979 folded before Flop (didn't bet)
Seat 2: potsos2012 folded before Flop (didn't bet)
Seat 3: Kreayshawn collected ($0.74)
Seat 4: Kalaboush (button) folded before Flop (didn't bet)
Seat 5: nemabob85 (small blind) folded before Flop
Seat 6: coolisses111 (big blind) folded on the Flop



PokerStars Hand #201511838097:  Hold'em No Limit ($0.05/$0.10 USD) - 2019/06/18 13:01:01 ET
Table 'Moreau III' 6-max Seat #3 is the button
Seat 1: Fantom979 ($10 in chips) 
Seat 2: potsos2012 ($4.18 in chips) 
Seat 3: Kreayshawn ($19.04 in chips) 
Seat 4: Kalaboush ($10 in chips) 
Seat 5: nemabob85 ($7.97 in chips) 
Seat 6: coolisses111 ($8.45 in chips) 
Kalaboush: posts small blind $0.05
nemabob85: posts big blind $0.10
Fantom979: posts the ante $0.02
potsos2012: posts the ante $0.02
Kreayshawn: posts the ante $0.02
Kalaboush: posts the ante $0.02
nemabob85: posts the ante $0.02
coolisses111: posts the ante $0.02
*** HOLE CARDS ***
coolisses111: folds 
Fantom979: folds 
potsos2012: raises $0.30 to $0.40
Kreayshawn: folds 
Kalaboush: folds 
nemabob85: calls $0.30
*** FLOP *** [Qd 2h Ts]
nemabob85: checks 
potsos2012: bets $0.30
nemabob85: calls $0.30
*** TURN *** [Qd 2h Ts] [Th]
nemabob85: checks 
coolisses111 leaves the table
potsos2012: bets $0.30
Alexandr.mh joins the table at seat #6 
nemabob85: calls $0.30
*** RIVER *** [Qd 2h Ts Th] [9d]
nemabob85: checks 
potsos2012: bets $3.16 and is all-in
nemabob85: folds 
Uncalled bet ($3.16) returned to potsos2012
potsos2012 collected $2.07 from pot
*** SUMMARY ***
Total pot $2.17 | Rake $0.10 
Board [Qd 2h Ts Th 9d]
Seat 1: Fantom979 folded before Flop (didn't bet)
Seat 2: potsos2012 collected ($2.07)
Seat 3: Kreayshawn (button) folded before Flop (didn't bet)
Seat 4: Kalaboush (small blind) folded before Flop
Seat 5: nemabob85 (big blind) folded on the River
Seat 6: coolisses111 folded before Flop (didn't bet)



PokerStars Hand #201511871184:  Hold'em No Limit ($0.05/$0.10 USD) - 2019/06/18 13:02:13 ET
Table 'Moreau III' 6-max Seat #4 is the button
Seat 1: Fantom979 ($10 in chips) 
Seat 2: potsos2012 ($5.23 in chips) 
Seat 3: Kreayshawn ($19.02 in chips) 
Seat 4: Kalaboush ($10 in chips) 
Seat 5: nemabob85 ($6.95 in chips) 
nemabob85: posts small blind $0.05
Fantom979: posts big blind $0.10
Fantom979: posts the ante $0.02
potsos2012: posts the ante $0.02
Kreayshawn: posts the ante $0.02
Kalaboush: posts the ante $0.02
nemabob85: posts the ante $0.02
*** HOLE CARDS ***
potsos2012: raises $0.20 to $0.30
Kreayshawn: folds 
Kalaboush: raises $0.85 to $1.15
nemabob85: folds 
Fantom979: raises $1.65 to $2.80
potsos2012: folds 
Kalaboush: calls $1.65
*** FLOP *** [Kh Ac 9c]
Fantom979: bets $1.65
Kalaboush: calls $1.65
*** TURN *** [Kh Ac 9c] [Qs]
Fantom979: bets $5.53 and is all-in
Kalaboush: calls $5.53 and is all-in
*** RIVER *** [Kh Ac 9c Qs] [9s]
*** SHOW DOWN ***
Fantom979: shows [Kc Ad] (two pair, Aces and Kings)
Kalaboush: shows [Kd Qc] (two pair, Kings and Queens)
Fantom979 collected $19.49 from pot
*** SUMMARY ***
Total pot $20.41 | Rake $0.92 
Board [Kh Ac 9c Qs 9s]
Seat 1: Fantom979 (big blind) showed [Kc Ad] and won ($19.49) with two pair, Aces and Kings
Seat 2: potsos2012 folded before Flop
Seat 3: Kreayshawn folded before Flop (didn't bet)
Seat 4: Kalaboush (button) showed [Kd Qc] and lost with two pair, Kings and Queens
Seat 5: nemabob85 (small blind) folded before Flop



PokerStars Hand #201511902038:  Hold'em No Limit ($0.05/$0.10 USD) - 2019/06/18 13:03:15 ET
Table 'Moreau III' 6-max Seat #5 is the button
Seat 1: Fantom979 ($19.49 in chips) 
Seat 2: potsos2012 ($4.91 in chips) 
Seat 3: Kreayshawn ($19 in chips) 
Seat 4: Kalaboush ($10 in chips) 
Seat 5: nemabob85 ($6.88 in chips) 
Fantom979: posts small blind $0.05
potsos2012: posts big blind $0.10
Fantom979: posts the ante $0.02
potsos2012: posts the ante $0.02
Kreayshawn: posts the ante $0.02
Kalaboush: posts the ante $0.02
nemabob85: posts the ante $0.02
*** HOLE CARDS ***
Kreayshawn: folds 
Kalaboush: raises $0.35 to $0.45
nemabob85: folds 
Fantom979: folds 
potsos2012: calls $0.35
*** FLOP *** [8s 3d 9c]
potsos2012: bets $0.30
Kalaboush: calls $0.30
*** TURN *** [8s 3d 9c] [2h]
potsos2012: bets $0.90
Kalaboush: calls $0.90
*** RIVER *** [8s 3d 9c 2h] [Qd]
potsos2012: bets $3.24 and is all-in
Kalaboush: folds 
Uncalled bet ($3.24) returned to potsos2012
potsos2012 collected $3.29 from pot
*** SUMMARY ***
Total pot $3.45 | Rake $0.16 
Board [8s 3d 9c 2h Qd]
Seat 1: Fantom979 (small blind) folded before Flop
Seat 2: potsos2012 (big blind) collected ($3.29)
Seat 3: Kreayshawn folded before Flop (didn't bet)
Seat 4: Kalaboush folded on the River
Seat 5: nemabob85 (button) folded before Flop (didn't bet)



PokerStars Hand #201511923997:  Hold'em No Limit ($0.05/$0.10 USD) - 2019/06/18 13:04:00 ET
Table 'Moreau III' 6-max Seat #1 is the button
Seat 1: Fantom979 ($19.42 in chips) 
Seat 2: potsos2012 ($6.53 in chips) 
Seat 3: Kreayshawn ($18.98 in chips) 
Seat 4: Kalaboush ($10 in chips) 
Seat 5: nemabob85 ($6.86 in chips) 
potsos2012: posts small blind $0.05
Kreayshawn: posts big blind $0.10
Fantom979: posts the ante $0.02
potsos2012: posts the ante $0.02
Kreayshawn: posts the ante $0.02
Kalaboush: posts the ante $0.02
nemabob85: posts the ante $0.02
*** HOLE CARDS ***
Kalaboush: calls $0.10
nemabob85: folds 
Fantom979: folds 
nemabob85 leaves the table
potsos2012: raises $0.20 to $0.30
19vityok91 joins the table at seat #5 
Kreayshawn: raises $0.90 to $1.20
Kalaboush: calls $1.10
potsos2012: calls $0.90
*** FLOP *** [Ad Jd As]
potsos2012: checks 
Kreayshawn: bets $1.16
Kalaboush: folds 
potsos2012: folds 
Uncalled bet ($1.16) returned to Kreayshawn
Kreayshawn collected $3.53 from pot
Kreayshawn: doesn't show hand 
*** SUMMARY ***
Total pot $3.70 | Rake $0.17 
Board [Ad Jd As]
Seat 1: Fantom979 (button) folded before Flop (didn't bet)
Seat 2: potsos2012 (small blind) folded on the Flop
Seat 3: Kreayshawn (big blind) collected ($3.53)
Seat 4: Kalaboush folded on the Flop
Seat 5: nemabob85 folded before Flop (didn't bet)



PokerStars Hand #201511942396:  Hold'em No Limit ($0.05/$0.10 USD) - 2019/06/18 13:04:37 ET
Table 'Moreau III' 6-max Seat #2 is the button
Seat 1: Fantom979 ($19.40 in chips) 
Seat 2: potsos2012 ($5.31 in chips) 
Seat 3: Kreayshawn ($21.29 in chips) 
Seat 4: Kalaboush ($10 in chips) 
Kreayshawn: posts small blind $0.05
Kalaboush: posts big blind $0.10
19vityok91: sits out 
Fantom979: posts the ante $0.02
potsos2012: posts the ante $0.02
Kreayshawn: posts the ante $0.02
Kalaboush: posts the ante $0.02
*** HOLE CARDS ***
Fantom979: folds 
potsos2012: folds 
Kreayshawn: raises $0.20 to $0.30
Kalaboush: raises $0.68 to $0.98
Kreayshawn: folds 
Uncalled bet ($0.68) returned to Kalaboush
Kalaboush collected $0.68 from pot
Kalaboush: doesn't show hand 
*** SUMMARY ***
Total pot $0.68 | Rake $0 
Seat 1: Fantom979 folded before Flop (didn't bet)
Seat 2: potsos2012 (button) folded before Flop (didn't bet)
Seat 3: Kreayshawn (small blind) folded before Flop
Seat 4: Kalaboush (big blind) collected ($0.68)



PokerStars Hand #201511950760:  Hold'em No Limit ($0.05/$0.10 USD) - 2019/06/18 13:04:54 ET
Table 'Moreau III' 6-max Seat #3 is the button
Seat 1: Fantom979 ($19.38 in chips) 
Seat 2: potsos2012 ($5.29 in chips) 
Seat 3: Kreayshawn ($20.97 in chips) 
Seat 4: Kalaboush ($10.36 in chips) 
Seat 5: 19vityok91 ($10 in chips) 
Kalaboush: posts small blind $0.05
19vityok91: posts big blind $0.10
Fantom979: posts the ante $0.02
potsos2012: posts the ante $0.02
Kreayshawn: posts the ante $0.02
Kalaboush: posts the ante $0.02
19vityok91: posts the ante $0.02
*** HOLE CARDS ***
Fantom979: folds 
potsos2012: raises $0.20 to $0.30
Kreayshawn: folds 
Kalaboush: folds 
19vityok91: folds 
Uncalled bet ($0.20) returned to potsos2012
potsos2012 collected $0.35 from pot
*** SUMMARY ***
Total pot $0.35 | Rake $0 
Seat 1: Fantom979 folded before Flop (didn't bet)
Seat 2: potsos2012 collected ($0.35)
Seat 3: Kreayshawn (button) folded before Flop (didn't bet)
Seat 4: Kalaboush (small blind) folded before Flop
Seat 5: 19vityok91 (big blind) folded before Flop



PokerStars Hand #201511962923:  Hold'em No Limit ($0.05/$0.10 USD) - 2019/06/18 13:05:18 ET
Table 'Moreau III' 6-max Seat #4 is the button
Seat 1: Fantom979 ($19.36 in chips) 
Seat 2: potsos2012 ($5.52 in chips) 
Seat 3: Kreayshawn ($20.95 in chips) 
Seat 4: Kalaboush ($10.29 in chips) 
Seat 5: 19vityok91 ($10 in chips) 
19vityok91: posts small blind $0.05
Fantom979: posts big blind $0.10
Fantom979: posts the ante $0.02
potsos2012: posts the ante $0.02
Kreayshawn: posts the ante $0.02
Kalaboush: posts the ante $0.02
19vityok91: posts the ante $0.02
*** HOLE CARDS ***
potsos2012: raises $0.20 to $0.30
Kreayshawn: folds 
Kalaboush: folds 
19vityok91: folds 
Fantom979: calls $0.20
*** FLOP *** [9c 7c Td]
Fantom979: checks 
potsos2012: bets $0.40
Fantom979: calls $0.40
*** TURN *** [9c 7c Td] [7d]
Fantom979: checks 
potsos2012: bets $0.80
Fantom979: calls $0.80
*** RIVER *** [9c 7c Td 7d] [6s]
Fantom979: checks 
potsos2012: bets $1.40
Fantom979: calls $1.40
*** SHOW DOWN ***
potsos2012: shows [3c 8c] (a straight, Six to Ten)
Fantom979: mucks hand 
potsos2012 collected $5.68 from pot
*** SUMMARY ***
Total pot $5.95 | Rake $0.27 
Board [9c 7c Td 7d 6s]
Seat 1: Fantom979 (big blind) mucked
Seat 2: potsos2012 showed [3c 8c] and won ($5.68) with a straight, Six to Ten
Seat 3: Kreayshawn folded before Flop (didn't bet)
Seat 4: Kalaboush (button) folded before Flop (didn't bet)
Seat 5: 19vityok91 (small blind) folded before Flop



PokerStars Hand #201511997850:  Hold'em No Limit ($0.05/$0.10 USD) - 2019/06/18 13:06:28 ET
Table 'Moreau III' 6-max Seat #5 is the button
Seat 1: Fantom979 ($16.44 in chips) 
Seat 2: potsos2012 ($8.28 in chips) 
Seat 3: Kreayshawn ($20.93 in chips) 
Seat 4: Kalaboush ($10.27 in chips) 
Seat 5: 19vityok91 ($10 in chips) 
Fantom979: posts small blind $0.05
potsos2012: posts big blind $0.10
Fantom979: posts the ante $0.02
potsos2012: posts the ante $0.02
Kreayshawn: posts the ante $0.02
Kalaboush: posts the ante $0.02
19vityok91: posts the ante $0.02
*** HOLE CARDS ***
Kreayshawn: folds 
Kalaboush: folds 
19vityok91: folds 
Fantom979: folds 
Uncalled bet ($0.05) returned to potsos2012
potsos2012 collected $0.20 from pot
*** SUMMARY ***
Total pot $0.20 | Rake $0 
Seat 1: Fantom979 (small blind) folded before Flop
Seat 2: potsos2012 (big blind) collected ($0.20)
Seat 3: Kreayshawn folded before Flop (didn't bet)
Seat 4: Kalaboush folded before Flop (didn't bet)
Seat 5: 19vityok91 (button) folded before Flop (didn't bet)



PokerStars Hand #201512006664:  Hold'em No Limit ($0.05/$0.10 USD) - 2019/06/18 13:06:46 ET
Table 'Moreau III' 6-max Seat #1 is the button
Seat 1: Fantom979 ($16.37 in chips) 
Seat 2: potsos2012 ($8.41 in chips) 
Seat 3: Kreayshawn ($20.91 in chips) 
Seat 4: Kalaboush ($10.25 in chips) 
Seat 5: 19vityok91 ($10 in chips) 
potsos2012: posts small blind $0.05
Kreayshawn: posts big blind $0.10
Alexandr.mh: sits out 
Fantom979: posts the ante $0.02
potsos2012: posts the ante $0.02
Kreayshawn: posts the ante $0.02
Kalaboush: posts the ante $0.02
19vityok91: posts the ante $0.02
*** HOLE CARDS ***
Kalaboush: folds 
19vityok91: folds 
Fantom979: folds 
potsos2012: raises $0.20 to $0.30
Kreayshawn: calls $0.20
*** FLOP *** [6c Ad 8h]
potsos2012: bets $0.30
Kreayshawn: folds 
Uncalled bet ($0.30) returned to potsos2012
potsos2012 collected $0.67 from pot
*** SUMMARY ***
Total pot $0.70 | Rake $0.03 
Board [6c Ad 8h]
Seat 1: Fantom979 (button) folded before Flop (didn't bet)
Seat 2: potsos2012 (small blind) collected ($0.67)
Seat 3: Kreayshawn (big blind) folded on the Flop
Seat 4: Kalaboush folded before Flop (didn't bet)
Seat 5: 19vityok91 folded before Flop (didn't bet)



PokerStars Hand #201512021422:  Hold'em No Limit ($0.05/$0.10 USD) - 2019/06/18 13:07:15 ET
Table 'Moreau III' 6-max Seat #2 is the button
Seat 1: Fantom979 ($16.35 in chips) 
Seat 2: potsos2012 ($8.76 in chips) 
Seat 3: Kreayshawn ($20.59 in chips) 
Seat 4: Kalaboush ($10.23 in chips) 
Seat 5: 19vityok91 ($10 in chips) 
Kreayshawn: posts small blind $0.05
Kalaboush: posts big blind $0.10
Alexandr.mh: sits out 
Fantom979: posts the ante $0.02
potsos2012: posts the ante $0.02
Kreayshawn: posts the ante $0.02
Kalaboush: posts the ante $0.02
19vityok91: posts the ante $0.02
*** HOLE CARDS ***
19vityok91: folds 
Fantom979: folds 
potsos2012: raises $0.30 to $0.40
Kreayshawn: calls $0.35
Kalaboush: folds 
*** FLOP *** [6c 8c Jd]
Kreayshawn: checks 
potsos2012: bets $0.90
Kreayshawn: folds 
Uncalled bet ($0.90) returned to potsos2012
potsos2012 collected $0.96 from pot
*** SUMMARY ***
Total pot $1 | Rake $0.04 
Board [6c 8c Jd]
Seat 1: Fantom979 folded before Flop (didn't bet)
Seat 2: potsos2012 (button) collected ($0.96)
Seat 3: Kreayshawn (small blind) folded on the Flop
Seat 4: Kalaboush (big blind) folded before Flop
Seat 5: 19vityok91 folded before Flop (didn't bet)



PokerStars Hand #201512050911:  Hold'em No Limit ($0.05/$0.10 USD) - 2019/06/18 13:08:14 ET
Table 'Moreau III' 6-max Seat #3 is the button
Seat 1: Fantom979 ($16.33 in chips) 
Seat 2: potsos2012 ($9.30 in chips) 
Seat 3: Kreayshawn ($20.17 in chips) 
Seat 4: Kalaboush ($10.11 in chips) 
Seat 5: 19vityok91 ($10 in chips) 
Kalaboush: posts small blind $0.05
19vityok91: posts big blind $0.10
Alexandr.mh: sits out 
Fantom979: posts the ante $0.02
potsos2012: posts the ante $0.02
Kreayshawn: posts the ante $0.02
Kalaboush: posts the ante $0.02
19vityok91: posts the ante $0.02
*** HOLE CARDS ***
Fantom979: folds 
potsos2012: folds 
Kreayshawn: raises $0.20 to $0.30
Kalaboush: folds 
19vityok91: folds 
Uncalled bet ($0.20) returned to Kreayshawn
Kreayshawn collected $0.35 from pot
Kreayshawn: doesn't show hand 
*** SUMMARY ***
Total pot $0.35 | Rake $0 
Seat 1: Fantom979 folded before Flop (didn't bet)
Seat 2: potsos2012 folded before Flop (didn't bet)
Seat 3: Kreayshawn (button) collected ($0.35)
Seat 4: Kalaboush (small blind) folded before Flop
Seat 5: 19vityok91 (big blind) folded before Flop



PokerStars Hand #201512061392:  Hold'em No Limit ($0.05/$0.10 USD) - 2019/06/18 13:08:35 ET
Table 'Moreau III' 6-max Seat #4 is the button
Seat 1: Fantom979 ($16.31 in chips) 
Seat 2: potsos2012 ($9.28 in chips) 
Seat 3: Kreayshawn ($20.40 in chips) 
Seat 4: Kalaboush ($10.04 in chips) 
Seat 5: 19vityok91 ($10 in chips) 
Seat 6: Alexandr.mh ($10 in chips) 
19vityok91: posts small blind $0.05
Alexandr.mh: posts big blind $0.10
Fantom979: posts the ante $0.02
potsos2012: posts the ante $0.02
Kreayshawn: posts the ante $0.02
Kalaboush: posts the ante $0.02
19vityok91: posts the ante $0.02
Alexandr.mh: posts the ante $0.02
*** HOLE CARDS ***
Fantom979: folds 
potsos2012: folds 
Kreayshawn: folds 
Kalaboush: raises $0.10 to $0.20
19vityok91: folds 
Alexandr.mh: folds 
Uncalled bet ($0.10) returned to Kalaboush
Kalaboush collected $0.37 from pot
Kalaboush: doesn't show hand 
*** SUMMARY ***
Total pot $0.37 | Rake $0 
Seat 1: Fantom979 folded before Flop (didn't bet)
Seat 2: potsos2012 folded before Flop (didn't bet)
Seat 3: Kreayshawn folded before Flop (didn't bet)
Seat 4: Kalaboush (button) collected ($0.37)
Seat 5: 19vityok91 (small blind) folded before Flop
Seat 6: Alexandr.mh (big blind) folded before Flop



PokerStars Hand #201512071878:  Hold'em No Limit ($0.05/$0.10 USD) - 2019/06/18 13:08:56 ET
Table 'Moreau III' 6-max Seat #5 is the button
Seat 1: Fantom979 ($16.29 in chips) 
Seat 2: potsos2012 ($9.26 in chips) 
Seat 3: Kreayshawn ($20.38 in chips) 
Seat 4: Kalaboush ($10.29 in chips) 
Seat 5: 19vityok91 ($10 in chips) 
Seat 6: Alexandr.mh ($10 in chips) 
Alexandr.mh: posts small blind $0.05
Fantom979: posts big blind $0.10
Fantom979: posts the ante $0.02
potsos2012: posts the ante $0.02
Kreayshawn: posts the ante $0.02
Kalaboush: posts the ante $0.02
19vityok91: posts the ante $0.02
Alexandr.mh: posts the ante $0.02
*** HOLE CARDS ***
potsos2012: folds 
Kreayshawn: folds 
Kalaboush: folds 
19vityok91: raises $0.15 to $0.25
Alexandr.mh: folds 
Fantom979: folds 
Uncalled bet ($0.15) returned to 19vityok91
19vityok91 collected $0.37 from pot
*** SUMMARY ***
Total pot $0.37 | Rake $0 
Seat 1: Fantom979 (big blind) folded before Flop
Seat 2: potsos2012 folded before Flop (didn't bet)
Seat 3: Kreayshawn folded before Flop (didn't bet)
Seat 4: Kalaboush folded before Flop (didn't bet)
Seat 5: 19vityok91 (button) collected ($0.37)
Seat 6: Alexandr.mh (small blind) folded before Flop



PokerStars Hand #201512085863:  Hold'em No Limit ($0.05/$0.10 USD) - 2019/06/18 13:09:24 ET
Table 'Moreau III' 6-max Seat #6 is the button
Seat 1: Fantom979 ($16.17 in chips) 
Seat 2: potsos2012 ($9.24 in chips) 
Seat 3: Kreayshawn ($20.36 in chips) 
Seat 4: Kalaboush ($10.27 in chips) 
Seat 5: 19vityok91 ($10.25 in chips) 
Seat 6: Alexandr.mh ($10 in chips) 
Fantom979: posts small blind $0.05
potsos2012: posts big blind $0.10
Fantom979: posts the ante $0.02
potsos2012: posts the ante $0.02
Kreayshawn: posts the ante $0.02
Kalaboush: posts the ante $0.02
19vityok91: posts the ante $0.02
Alexandr.mh: posts the ante $0.02
*** HOLE CARDS ***
Kreayshawn: folds 
Kalaboush: folds 
19vityok91: folds 
Alexandr.mh has timed out
Alexandr.mh: folds 
Fantom979: raises $0.18 to $0.28
potsos2012: calls $0.18
*** FLOP *** [5d Ac Kh]
Fantom979: bets $0.35
potsos2012: calls $0.35
*** TURN *** [5d Ac Kh] [Td]
Fantom979: bets $1.32
potsos2012: folds 
Uncalled bet ($1.32) returned to Fantom979
Fantom979 collected $1.32 from pot
Fantom979: doesn't show hand 
*** SUMMARY ***
Total pot $1.38 | Rake $0.06 
Board [5d Ac Kh Td]
Seat 1: Fantom979 (small blind) collected ($1.32)
Seat 2: potsos2012 (big blind) folded on the Turn
Seat 3: Kreayshawn folded before Flop (didn't bet)
Seat 4: Kalaboush folded before Flop (didn't bet)
Seat 5: 19vityok91 folded before Flop (didn't bet)
Seat 6: Alexandr.mh (button) folded before Flop (didn't bet)



PokerStars Hand #201512120943:  Hold'em No Limit ($0.05/$0.10 USD) - 2019/06/18 13:10:34 ET
Table 'Moreau III' 6-max Seat #1 is the button
Seat 1: Fantom979 ($16.84 in chips) 
Seat 2: potsos2012 ($8.59 in chips) 
Seat 3: Kreayshawn ($20.34 in chips) 
Seat 4: Kalaboush ($10.25 in chips) 
Seat 5: 19vityok91 ($10.23 in chips) 
potsos2012: posts small blind $0.05
Kreayshawn: posts big blind $0.10
Fantom979: posts the ante $0.02
potsos2012: posts the ante $0.02
Kreayshawn: posts the ante $0.02
Kalaboush: posts the ante $0.02
19vityok91: posts the ante $0.02
*** HOLE CARDS ***
Kalaboush: raises $0.35 to $0.45
19vityok91: folds 
Fantom979: folds 
potsos2012: folds 
Kreayshawn: folds 
Uncalled bet ($0.35) returned to Kalaboush
Kalaboush collected $0.35 from pot
Kalaboush: doesn't show hand 
*** SUMMARY ***
Total pot $0.35 | Rake $0 
Seat 1: Fantom979 (button) folded before Flop (didn't bet)
Seat 2: potsos2012 (small blind) folded before Flop
Seat 3: Kreayshawn (big blind) folded before Flop
Seat 4: Kalaboush collected ($0.35)
Seat 5: 19vityok91 folded before Flop (didn't bet)



PokerStars Hand #201512127189:  Hold'em No Limit ($0.05/$0.10 USD) - 2019/06/18 13:10:47 ET
Table 'Moreau III' 6-max Seat #2 is the button
Seat 1: Fantom979 ($16.82 in chips) 
Seat 2: potsos2012 ($8.52 in chips) 
Seat 3: Kreayshawn ($20.22 in chips) 
Seat 5: 19vityok91 ($10.21 in chips) 
Seat 6: Alexandr.mh ($10 in chips) 
Kreayshawn: posts small blind $0.05
Kalaboush: is sitting out 
19vityok91: posts big blind $0.10
Fantom979: posts the ante $0.02
potsos2012: posts the ante $0.02
Kreayshawn: posts the ante $0.02
19vityok91: posts the ante $0.02
Alexandr.mh: posts the ante $0.02
*** HOLE CARDS ***
Alexandr.mh: folds 
Kalaboush leaves the table
Fantom979: folds 
potsos2012: raises $0.20 to $0.30
Kreayshawn: folds 
19vityok91: folds 
Uncalled bet ($0.20) returned to potsos2012
potsos2012 collected $0.35 from pot
*** SUMMARY ***
Total pot $0.35 | Rake $0 
Seat 1: Fantom979 folded before Flop (didn't bet)
Seat 2: potsos2012 (button) collected ($0.35)
Seat 3: Kreayshawn (small blind) folded before Flop
Seat 5: 19vityok91 (big blind) folded before Flop
Seat 6: Alexandr.mh folded before Flop (didn't bet)



PokerStars Hand #201512135251:  Hold'em No Limit ($0.05/$0.10 USD) - 2019/06/18 13:11:02 ET
Table 'Moreau III' 6-max Seat #3 is the button
Seat 2: potsos2012 ($8.75 in chips) 
Seat 3: Kreayshawn ($20.15 in chips) 
Seat 5: 19vityok91 ($10.09 in chips) 
Seat 6: Alexandr.mh ($10 in chips) 
19vityok91: posts small blind $0.05
Alexandr.mh: posts big blind $0.10
potsos2012: posts the ante $0.02
Kreayshawn: posts the ante $0.02
19vityok91: posts the ante $0.02
Alexandr.mh: posts the ante $0.02
*** HOLE CARDS ***
potsos2012: raises $0.20 to $0.30
Kreayshawn: folds 
19vityok91: calls $0.25
Alexandr.mh: folds 
*** FLOP *** [6d 6h Ts]
19vityok91: checks 
potsos2012: checks 
*** TURN *** [6d 6h Ts] [7h]
19vityok91: checks 
potsos2012: checks 
*** RIVER *** [6d 6h Ts 7h] [9s]
19vityok91: bets $0.56
potsos2012: folds 
Uncalled bet ($0.56) returned to 19vityok91
19vityok91 collected $0.74 from pot
*** SUMMARY ***
Total pot $0.78 | Rake $0.04 
Board [6d 6h Ts 7h 9s]
Seat 2: potsos2012 folded on the River
Seat 3: Kreayshawn (button) folded before Flop (didn't bet)
Seat 5: 19vityok91 (small blind) collected ($0.74)
Seat 6: Alexandr.mh (big blind) folded before Flop



PokerStars Hand #201512151028:  Hold'em No Limit ($0.05/$0.10 USD) - 2019/06/18 13:11:34 ET
Table 'Moreau III' 6-max Seat #5 is the button
Seat 2: potsos2012 ($8.43 in chips) 
Seat 3: Kreayshawn ($20.13 in chips) 
Seat 5: 19vityok91 ($10.51 in chips) 
Seat 6: Alexandr.mh ($10 in chips) 
Alexandr.mh: posts small blind $0.05
potsos2012: posts big blind $0.10
potsos2012: posts the ante $0.02
Kreayshawn: posts the ante $0.02
19vityok91: posts the ante $0.02
Alexandr.mh: posts the ante $0.02
*** HOLE CARDS ***
Kreayshawn: folds 
19vityok91: raises $0.15 to $0.25
Alexandr.mh: raises $0.65 to $0.90
potsos2012: calls $0.80
19vityok91: calls $0.65
*** FLOP *** [Th 6s Jd]
Alexandr.mh: checks 
potsos2012 is disconnected 
potsos2012 has timed out while disconnected
potsos2012: checks 
19vityok91: checks 
*** TURN *** [Th 6s Jd] [Ts]
Alexandr.mh: checks 
potsos2012 has timed out while disconnected
potsos2012: checks 
19vityok91: checks 
*** RIVER *** [Th 6s Jd Ts] [4h]
Alexandr.mh: checks 
potsos2012 has timed out while disconnected
potsos2012: checks 
19vityok91: bets $0.87
Alexandr.mh: folds 
ale9030 joins the table at seat #4 
potsos2012 has timed out while disconnected
potsos2012: folds 
Uncalled bet ($0.87) returned to 19vityok91
19vityok91 collected $2.65 from pot
*** SUMMARY ***
Total pot $2.78 | Rake $0.13 
Board [Th 6s Jd Ts 4h]
Seat 2: potsos2012 (big blind) folded on the River
Seat 3: Kreayshawn folded before Flop (didn't bet)
Seat 5: 19vityok91 (button) collected ($2.65)
Seat 6: Alexandr.mh (small blind) folded on the River



PokerStars Hand #201512342074:  Hold'em No Limit ($0.05/$0.10 USD) - 2019/06/18 13:17:53 ET
Table 'Moreau III' 6-max Seat #6 is the button
Seat 3: Kreayshawn ($20.11 in chips) 
Seat 5: 19vityok91 ($12.24 in chips) 
Seat 6: Alexandr.mh ($10 in chips) 
Kreayshawn: posts small blind $0.05
19vityok91: posts big blind $0.10
Kreayshawn: posts the ante $0.02
19vityok91: posts the ante $0.02
Alexandr.mh: posts the ante $0.02
*** HOLE CARDS ***
Alexandr.mh: raises $0.15 to $0.25
Kreayshawn: raises $0.85 to $1.10
19vityok91: folds 
Alexandr.mh: folds 
Uncalled bet ($0.85) returned to Kreayshawn
Kreayshawn collected $0.66 from pot
Kreayshawn: doesn't show hand 
*** SUMMARY ***
Total pot $0.66 | Rake $0 
Seat 3: Kreayshawn (small blind) collected ($0.66)
Seat 5: 19vityok91 (big blind) folded before Flop
Seat 6: Alexandr.mh (button) folded before Flop



PokerStars Hand #201512352303:  Hold'em No Limit ($0.05/$0.10 USD) - 2019/06/18 13:18:13 ET
Table 'Moreau III' 6-max Seat #3 is the button
Seat 3: Kreayshawn ($20.50 in chips) 
Seat 5: 19vityok91 ($12.12 in chips) 
Seat 6: Alexandr.mh ($10 in chips) 
19vityok91: posts small blind $0.05
Alexandr.mh: posts big blind $0.10
Fantom979: sits out 
Kreayshawn: posts the ante $0.02
19vityok91: posts the ante $0.02
Alexandr.mh: posts the ante $0.02
*** HOLE CARDS ***
Kreayshawn: raises $0.20 to $0.30
19vityok91: folds 
Alexandr.mh: folds 
Uncalled bet ($0.20) returned to Kreayshawn
Kreayshawn collected $0.31 from pot
Kreayshawn: doesn't show hand 
*** SUMMARY ***
Total pot $0.31 | Rake $0 
Seat 3: Kreayshawn (button) collected ($0.31)
Seat 5: 19vityok91 (small blind) folded before Flop
Seat 6: Alexandr.mh (big blind) folded before Flop



PokerStars Hand #201512357107:  Hold'em No Limit ($0.05/$0.10 USD) - 2019/06/18 13:18:22 ET
Table 'Moreau III' 6-max Seat #5 is the button
Seat 1: Fantom979 ($16.80 in chips) 
Seat 3: Kreayshawn ($20.69 in chips) 
Seat 5: 19vityok91 ($12.05 in chips) 
Seat 6: Alexandr.mh ($10 in chips) 
Alexandr.mh: posts small blind $0.05
Fantom979: posts big blind $0.10
Fantom979: posts the ante $0.02
Kreayshawn: posts the ante $0.02
19vityok91: posts the ante $0.02
Alexandr.mh: posts the ante $0.02
*** HOLE CARDS ***
Kreayshawn: raises $0.20 to $0.30
19vityok91: calls $0.30
Alexandr.mh: folds 
Fantom979: calls $0.20
*** FLOP *** [3d 3h 5h]
Fantom979: checks 
Kreayshawn: bets $0.76
19vityok91: folds 
Fantom979: folds 
Uncalled bet ($0.76) returned to Kreayshawn
Kreayshawn collected $0.98 from pot
Kreayshawn: doesn't show hand 
*** SUMMARY ***
Total pot $1.03 | Rake $0.05 
Board [3d 3h 5h]
Seat 1: Fantom979 (big blind) folded on the Flop
Seat 3: Kreayshawn collected ($0.98)
Seat 5: 19vityok91 (button) folded on the Flop
Seat 6: Alexandr.mh (small blind) folded before Flop



PokerStars Hand #201512371300:  Hold'em No Limit ($0.05/$0.10 USD) - 2019/06/18 13:18:51 ET
Table 'Moreau III' 6-max Seat #6 is the button
Seat 1: Fantom979 ($16.48 in chips) 
Seat 5: 19vityok91 ($11.73 in chips) 
Seat 6: Alexandr.mh ($10 in chips) 
Fantom979: posts small blind $0.05
Kreayshawn: is sitting out 
19vityok91: posts big blind $0.10
Fantom979: posts the ante $0.02
19vityok91: posts the ante $0.02
Alexandr.mh: posts the ante $0.02
*** HOLE CARDS ***
Alexandr.mh: folds 
Fantom979: folds 
Uncalled bet ($0.05) returned to 19vityok91
19vityok91 collected $0.16 from pot
*** SUMMARY ***
Total pot $0.16 | Rake $0 
Seat 1: Fantom979 (small blind) folded before Flop
Seat 5: 19vityok91 (big blind) collected ($0.16)
Seat 6: Alexandr.mh (button) folded before Flop (didn't bet)



PokerStars Hand #201512376312:  Hold'em No Limit ($0.05/$0.10 USD) - 2019/06/18 13:19:01 ET
Table 'Moreau III' 6-max Seat #1 is the button
Seat 1: Fantom979 ($16.41 in chips) 
Seat 5: 19vityok91 ($11.82 in chips) 
Seat 6: Alexandr.mh ($10 in chips) 
19vityok91: posts small blind $0.05
Alexandr.mh: posts big blind $0.10
Fantom979: posts the ante $0.02
19vityok91: posts the ante $0.02
Alexandr.mh: posts the ante $0.02
*** HOLE CARDS ***
Fantom979: raises $0.18 to $0.28
19vityok91: folds 
Alexandr.mh: folds 
Uncalled bet ($0.18) returned to Fantom979
Fantom979 collected $0.31 from pot
Fantom979: doesn't show hand 
*** SUMMARY ***
Total pot $0.31 | Rake $0 
Seat 1: Fantom979 (button) collected ($0.31)
Seat 5: 19vityok91 (small blind) folded before Flop
Seat 6: Alexandr.mh (big blind) folded before Flop



PokerStars Hand #201512380717:  Hold'em No Limit ($0.05/$0.10 USD) - 2019/06/18 13:19:09 ET
Table 'Moreau III' 6-max Seat #5 is the button
Seat 1: Fantom979 ($16.60 in chips) 
Seat 5: 19vityok91 ($11.75 in chips) 
Seat 6: Alexandr.mh ($10 in chips) 
Alexandr.mh: posts small blind $0.05
Fantom979: posts big blind $0.10
Fantom979: posts the ante $0.02
19vityok91: posts the ante $0.02
Alexandr.mh: posts the ante $0.02
*** HOLE CARDS ***
19vityok91: folds 
Alexandr.mh: raises $0.20 to $0.30
Fantom979: calls $0.20
*** FLOP *** [8s 8d 6s]
Alexandr.mh: bets $0.40
Fantom979: calls $0.40
*** TURN *** [8s 8d 6s] [4c]
Alexandr.mh: bets $1.10
Fantom979: calls $1.10
*** RIVER *** [8s 8d 6s 4c] [Jd]
Alexandr.mh: bets $1.90
Fantom979: folds 
Uncalled bet ($1.90) returned to Alexandr.mh
Alexandr.mh collected $3.50 from pot
Alexandr.mh: doesn't show hand 
*** SUMMARY ***
Total pot $3.66 | Rake $0.16 
Board [8s 8d 6s 4c Jd]
Seat 1: Fantom979 (big blind) folded on the River
Seat 5: 19vityok91 (button) folded before Flop (didn't bet)
Seat 6: Alexandr.mh (small blind) collected ($3.50)



PokerStars Hand #201512406242:  Hold'em No Limit ($0.05/$0.10 USD) - 2019/06/18 13:20:00 ET
Table 'Moreau III' 6-max Seat #6 is the button
Seat 1: Fantom979 ($14.78 in chips) 
Seat 5: 19vityok91 ($11.73 in chips) 
Seat 6: Alexandr.mh ($11.68 in chips) 
Fantom979: posts small blind $0.05
19vityok91: posts big blind $0.10
Fantom979: posts the ante $0.02
19vityok91: posts the ante $0.02
Alexandr.mh: posts the ante $0.02
*** HOLE CARDS ***
Alexandr.mh: folds 
Fantom979: folds 
Uncalled bet ($0.05) returned to 19vityok91
19vityok91 collected $0.16 from pot
*** SUMMARY ***
Total pot $0.16 | Rake $0 
Seat 1: Fantom979 (small blind) folded before Flop
Seat 5: 19vityok91 (big blind) collected ($0.16)
Seat 6: Alexandr.mh (button) folded before Flop (didn't bet)



PokerStars Hand #201512410477:  Hold'em No Limit ($0.05/$0.10 USD) - 2019/06/18 13:20:08 ET
Table 'Moreau III' 6-max Seat #1 is the button
Seat 1: Fantom979 ($14.71 in chips) 
Seat 5: 19vityok91 ($11.82 in chips) 
Seat 6: Alexandr.mh ($11.66 in chips) 
19vityok91: posts small blind $0.05
Alexandr.mh: posts big blind $0.10
Fantom979: posts the ante $0.02
19vityok91: posts the ante $0.02
Alexandr.mh: posts the ante $0.02
*** HOLE CARDS ***
Fantom979: folds 
19vityok91: folds 
Uncalled bet ($0.05) returned to Alexandr.mh
Alexandr.mh collected $0.16 from pot
Alexandr.mh: doesn't show hand 
*** SUMMARY ***
Total pot $0.16 | Rake $0 
Seat 1: Fantom979 (button) folded before Flop (didn't bet)
Seat 5: 19vityok91 (small blind) folded before Flop
Seat 6: Alexandr.mh (big blind) collected ($0.16)



PokerStars Hand #201512414003:  Hold'em No Limit ($0.05/$0.10 USD) - 2019/06/18 13:20:15 ET
Table 'Moreau III' 6-max Seat #5 is the button
Seat 1: Fantom979 ($14.69 in chips) 
Seat 5: 19vityok91 ($11.75 in chips) 
Seat 6: Alexandr.mh ($11.75 in chips) 
Alexandr.mh: posts small blind $0.05
Fantom979: posts big blind $0.10
Fantom979: posts the ante $0.02
19vityok91: posts the ante $0.02
Alexandr.mh: posts the ante $0.02
*** HOLE CARDS ***
19vityok91: folds 
Alexandr.mh: folds 
Uncalled bet ($0.05) returned to Fantom979
Fantom979 collected $0.16 from pot
Fantom979: doesn't show hand 
*** SUMMARY ***
Total pot $0.16 | Rake $0 
Seat 1: Fantom979 (big blind) collected ($0.16)
Seat 5: 19vityok91 (button) folded before Flop (didn't bet)
Seat 6: Alexandr.mh (small blind) folded before Flop



PokerStars Hand #201512417486:  Hold'em No Limit ($0.05/$0.10 USD) - 2019/06/18 13:20:22 ET
Table 'Moreau III' 6-max Seat #6 is the button
Seat 1: Fantom979 ($14.78 in chips) 
Seat 5: 19vityok91 ($11.73 in chips) 
Seat 6: Alexandr.mh ($11.68 in chips) 
Fantom979: posts small blind $0.05
19vityok91: posts big blind $0.10
Fantom979: posts the ante $0.02
19vityok91: posts the ante $0.02
Alexandr.mh: posts the ante $0.02
*** HOLE CARDS ***
Alexandr.mh: folds 
Fantom979: raises $0.18 to $0.28
Alexandr.mh leaves the table
BackToDreams joins the table at seat #6 
19vityok91: folds 
Uncalled bet ($0.18) returned to Fantom979
Fantom979 collected $0.26 from pot
potsos2012 was removed from the table for failing to post
potsos2012 leaves the table
ale9030 was removed from the table for failing to post
ale9030 leaves the table
Fantom979: doesn't show hand 
*** SUMMARY ***
Total pot $0.26 | Rake $0 
Seat 1: Fantom979 (small blind) collected ($0.26)
Seat 5: 19vityok91 (big blind) folded before Flop
Seat 6: Alexandr.mh (button) folded before Flop (didn't bet)



PokerStars Hand #201512423719:  Hold'em No Limit ($0.05/$0.10 USD) - 2019/06/18 13:20:34 ET
Table 'Moreau III' 6-max Seat #1 is the button
Seat 1: Fantom979 ($14.92 in chips) 
Seat 5: 19vityok91 ($11.61 in chips) 
Seat 6: BackToDreams ($10 in chips) 
19vityok91: posts small blind $0.05
BackToDreams: posts big blind $0.10
Fantom979: posts the ante $0.02
19vityok91: posts the ante $0.02
BackToDreams: posts the ante $0.02
*** HOLE CARDS ***
Kreayshawn leaves the table
Fantom979: raises $0.18 to $0.28
19vityok91: folds 
BackToDreams: folds 
Uncalled bet ($0.18) returned to Fantom979
Fantom979 collected $0.31 from pot
Fantom979: doesn't show hand 
*** SUMMARY ***
Total pot $0.31 | Rake $0 
Seat 1: Fantom979 (button) collected ($0.31)
Seat 5: 19vityok91 (small blind) folded before Flop
Seat 6: BackToDreams (big blind) folded before Flop



PokerStars Hand #201512429523:  Hold'em No Limit ($0.05/$0.10 USD) - 2019/06/18 13:20:46 ET
Table 'Moreau III' 6-max Seat #5 is the button
Seat 1: Fantom979 ($15.11 in chips) 
Seat 5: 19vityok91 ($11.54 in chips) 
Seat 6: BackToDreams ($10 in chips) 
BackToDreams: posts small blind $0.05
Fantom979: posts big blind $0.10
Fantom979: posts the ante $0.02
19vityok91: posts the ante $0.02
BackToDreams: posts the ante $0.02
*** HOLE CARDS ***
19vityok91: folds 
BackToDreams: raises $0.25 to $0.35
Fantom979: folds 
Uncalled bet ($0.25) returned to BackToDreams
BackToDreams collected $0.26 from pot
BackToDreams: doesn't show hand 
*** SUMMARY ***
Total pot $0.26 | Rake $0 
Seat 1: Fantom979 (big blind) folded before Flop
Seat 5: 19vityok91 (button) folded before Flop (didn't bet)
Seat 6: BackToDreams (small blind) collected ($0.26)



PokerStars Hand #201512434868:  Hold'em No Limit ($0.05/$0.10 USD) - 2019/06/18 13:20:56 ET
Table 'Moreau III' 6-max Seat #1 is the button
Seat 1: Fantom979 ($14.99 in chips) 
Seat 6: BackToDreams ($10.14 in chips) 
Fantom979: posts small blind $0.05
19vityok91: is sitting out 
BackToDreams: posts big blind $0.10
Fantom979: posts the ante $0.02
BackToDreams: posts the ante $0.02
*** HOLE CARDS ***
Fantom979: raises $0.18 to $0.28
BackToDreams: folds 
Uncalled bet ($0.18) returned to Fantom979
Fantom979 collected $0.24 from pot
Fantom979: doesn't show hand 
BackToDreams leaves the table
19vityok91 leaves the table
*** SUMMARY ***
Total pot $0.24 | Rake $0 
Seat 1: Fantom979 (button) (small blind) collected ($0.24)
Seat 6: BackToDreams (big blind) folded before Flop



